sha,is_bug,committer_name,commit_time,parents,all_del,all_add,all_change_lines,all_lines,files_change_nums,dmm_unit_size,dmm_unit_complexity,dmm_unit_interfacing,file_nums
a68c74e9b9977435b0119368753e9a38b49150ae,0,David Reiss,2008-05-11 20:54:23+00:00,['c06bbbfe75a7181499388ed8a5f1d11b69d7cdd1'],0,0,0,0,0,,,,0
319857233b75121f357801cbdd9b5028e3057dbd,1,Mark Slee,2006-05-24 21:45:31+00:00,['a68c74e9b9977435b0119368753e9a38b49150ae'],0,1814,1814,1814,23,0.406028369,0.781914894,0.992907801,23
e8540637aaaf017f9e08e1e0d68663f814538862,1,Mark Slee,2006-05-30 09:24:40+00:00,['319857233b75121f357801cbdd9b5028e3057dbd'],275,2471,2746,4560,38,0.361041142,0.616288833,0.758186398,47
b15a68bd89428630ac1775812082a7c4a034c3b7,1,Mark Slee,2006-06-07 06:46:24+00:00,['e8540637aaaf017f9e08e1e0d68663f814538862'],335,1766,2101,6661,12,0.119371728,0.443979058,1,50
8d7e1f62a85d91b159887eb406a5855bcbd6245e,1,Mark Slee,2006-06-07 06:48:56+00:00,['b15a68bd89428630ac1775812082a7c4a034c3b7'],423,1150,1573,8234,23,0.488599349,0.664495114,0.713355049,55
83c52a8d7ab0be9215a70351b2a4d27938092d72,1,Mark Slee,2006-06-07 06:51:18+00:00,['8d7e1f62a85d91b159887eb406a5855bcbd6245e'],0,1707,1707,9941,26,0.759953162,0.804449649,0.831381733,81
9577100f3c317ed0bc5974bd8b12cc07675263a0,0,Mark Slee,2006-06-07 06:53:25+00:00,['83c52a8d7ab0be9215a70351b2a4d27938092d72'],17,665,682,10623,8,0.291666667,0.416666667,1,86
d173407b7f9198c0be7db2ec69ce0c8bed52716b,0,Mark Slee,2006-06-07 06:57:01+00:00,['9577100f3c317ed0bc5974bd8b12cc07675263a0'],3,2,5,10628,1,,,,86
f3c322b4a36ca67e77d53ae0bf337853812e4f14,0,Mark Slee,2006-06-26 23:52:22+00:00,['d173407b7f9198c0be7db2ec69ce0c8bed52716b'],61,62,123,10751,8,1,1,1,86
4e0d962693645a202bc47c0bc01b0a2c3660d70d,0,Mark Slee,2006-06-26 23:56:08+00:00,['f3c322b4a36ca67e77d53ae0bf337853812e4f14'],6,6,12,10763,19,,,,86
6e53644ce5ebbf5e3a5f1fb3df2398534b1c965e,1,Mark Slee,2006-06-30 18:28:50+00:00,['4e0d962693645a202bc47c0bc01b0a2c3660d70d'],143,2423,2566,13329,27,0.460238569,0.686878728,0.897614314,100
66949879ffaa724ff2789bd62a2b8820bf45f13f,1,Marc Slemko,2006-07-15 01:52:39+00:00,['6e53644ce5ebbf5e3a5f1fb3df2398534b1c965e'],0,1053,1053,14382,9,0.769230769,0.822742475,0.946488294,109
0e53ccdb8bf0cee0d17fed331d32dd012cec2552,0,Marc Slemko,2006-07-17 23:51:05+00:00,['66949879ffaa724ff2789bd62a2b8820bf45f13f'],182,702,884,15266,14,0.685950413,0.694214876,1,113
8a40a76b271f376a45202d1569d819d12f3940cd,1,Marc Slemko,2006-07-19 17:46:50+00:00,['0e53ccdb8bf0cee0d17fed331d32dd012cec2552'],116,560,676,15942,9,0.379487179,0.835897436,1,116
9f27a4eb7d329f80a7143b1850655f1c59bf4f46,1,Marc Slemko,2006-07-19 20:02:22+00:00,['8a40a76b271f376a45202d1569d819d12f3940cd'],46,119,165,16107,4,0,0.264705882,1,116
d466b211fdf0c357e5b29fba70099947bc493164,1,Marc Slemko,2006-07-20 00:04:18+00:00,['9f27a4eb7d329f80a7143b1850655f1c59bf4f46'],150,156,306,16413,8,0.285714286,0.342857143,1,116
525c202df48b8154c0a8b6b8d86ee825e9ae8944,0,Marc Slemko,2006-07-20 00:29:35+00:00,['d466b211fdf0c357e5b29fba70099947bc493164'],3,25,28,16441,3,,,,117
740343dad2583899a2e3751fcf568c1cc9254d48,1,Marc Slemko,2006-07-20 00:31:02+00:00,['525c202df48b8154c0a8b6b8d86ee825e9ae8944'],0,129,129,16570,1,0.142857143,0.469387755,0.326530612,118
03dedd9bd5125358d6fb21cff1b059cfe53fc984,1,Marc Slemko,2006-07-20 00:58:47+00:00,['740343dad2583899a2e3751fcf568c1cc9254d48'],12,13,25,16595,4,0,0,,118
fe5ba12e4a014935defac0464def9ad1986ad572,1,Marc Slemko,2006-07-20 21:16:27+00:00,['03dedd9bd5125358d6fb21cff1b059cfe53fc984'],117,250,367,16962,6,0.037037037,0.5,0.907407407,118
9f0ba255a9b9925dcd6e901be4ecd6b5b761830b,0,Marc Slemko,2006-07-21 03:53:13+00:00,['fe5ba12e4a014935defac0464def9ad1986ad572'],0,77,77,17039,5,,,,123
9d4a3e2a78be150513a88eb8870d9a7696acf0e9,1,Marc Slemko,2006-07-21 19:53:48+00:00,['9f0ba255a9b9925dcd6e901be4ecd6b5b761830b'],17,107,124,17163,9,0,0,1,123
e03da189af92cbc3269ebe7f818cdf0a5a4728f6,0,Marc Slemko,2006-07-21 21:32:36+00:00,['9d4a3e2a78be150513a88eb8870d9a7696acf0e9'],9,12,21,17184,4,,,,123
c778297bd0e4f468967df59555c2d3dcaf4fc6cb,1,Marc Slemko,2006-07-25 02:26:35+00:00,['e03da189af92cbc3269ebe7f818cdf0a5a4728f6'],45,189,234,17418,5,0.236111111,0,0.638888889,123
03eafbeac934f6dd52bfb7c10193b6a6d02d8630,0,Marc Slemko,2006-08-02 20:01:22+00:00,['c778297bd0e4f468967df59555c2d3dcaf4fc6cb'],0,129,129,17547,1,,,,124
6f038a7b60337c6b00ff7685db9ad4d527b68e62,1,Marc Slemko,2006-08-03 18:58:09+00:00,['03eafbeac934f6dd52bfb7c10193b6a6d02d8630'],210,558,768,18315,35,0.125,1,1,125
35452346e61ab2d75491d3cce7bcbc1ab53d90e3,0,Marc Slemko,2006-08-03 19:01:37+00:00,['6f038a7b60337c6b00ff7685db9ad4d527b68e62'],0,108,108,18423,2,1,1,0.822222222,127
16698859316cdae5ef09a907d35331e978969981,0,Marc Slemko,2006-08-04 03:16:10+00:00,['35452346e61ab2d75491d3cce7bcbc1ab53d90e3'],242,348,590,19013,16,0.3,1,0.15,127
6be374b55be1236dbe8473e3d385c768e65c1ff8,1,Marc Slemko,2006-08-04 03:16:25+00:00,['16698859316cdae5ef09a907d35331e978969981'],32,152,184,19197,3,0,0,1,127
002e6468f36f0513f61c9b51702e9454d0fbd12c,0,Marc Slemko,2006-08-04 03:16:46+00:00,['6be374b55be1236dbe8473e3d385c768e65c1ff8'],37,37,74,19271,1,,,,127
52f643df7c069228a799f19ae4b58a6ab8c05275,1,Mark Slee,2006-08-09 00:03:43+00:00,['002e6468f36f0513f61c9b51702e9454d0fbd12c'],286,668,954,20225,10,0.00625,0,0.98125,127
530fd662c015083a94526b9e4370892565409de6,0,Mark Slee,2006-08-09 00:05:18+00:00,['52f643df7c069228a799f19ae4b58a6ab8c05275'],842,226,1068,21293,15,0.19395466,0.14861461,0.080604534,127
b2039e70fe96cabd96dd29280e9fb77b8342dbaa,0,Marc Slemko,2006-08-09 01:00:17+00:00,['530fd662c015083a94526b9e4370892565409de6'],0,1523,1523,22816,3,0.794736842,0.759210526,0.734210526,130
c09a65aa4b3ada5a19e5d1256fa807ee34be9be3,0,Marc Slemko,2006-08-09 01:20:16+00:00,['b2039e70fe96cabd96dd29280e9fb77b8342dbaa'],4,1,5,22821,1,,,,130
c0e07a2d85c1c7af3368acb09d2466c89c658ba6,0,Marc Slemko,2006-08-09 23:34:57+00:00,['c09a65aa4b3ada5a19e5d1256fa807ee34be9be3'],15,32,47,22868,1,0.545454545,0.545454545,0.272727273,130
db14e17a33d23a0a179bb4cdf9269bf9824895db,0,Marc Slemko,2006-08-09 23:36:18+00:00,['c0e07a2d85c1c7af3368acb09d2466c89c658ba6'],37,298,335,23203,2,0.675925926,0.546296296,0.833333333,131
c4eb9e8889105547a693f038d6f71de54e8f57d3,0,Marc Slemko,2006-08-10 03:29:29+00:00,['db14e17a33d23a0a179bb4cdf9269bf9824895db'],54,106,160,23363,3,0,0.904761905,1,131
d42a2c2bf9630cfb4d9d49cbee1fc812e5e5777d,0,Marc Slemko,2006-08-10 03:30:18+00:00,['c4eb9e8889105547a693f038d6f71de54e8f57d3'],23,34,57,23420,16,,,,131
27340eb5cd735dcaebb0a3a83ec3fcaab2e36544,0,Marc Slemko,2006-08-10 20:45:55+00:00,['d42a2c2bf9630cfb4d9d49cbee1fc812e5e5777d'],5,34,39,23459,1,0.956521739,0.956521739,1,131
0b4ffa9d4cbdd1bd618c2c108c65c93e01f292c0,0,Marc Slemko,2006-08-11 02:49:29+00:00,['27340eb5cd735dcaebb0a3a83ec3fcaab2e36544'],239,381,620,24079,6,0.903225806,0.451612903,0.774193548,131
5b126d6c85e1c23656fb9be43aba5df9a161635d,0,Marc Slemko,2006-08-11 23:03:42+00:00,['0b4ffa9d4cbdd1bd618c2c108c65c93e01f292c0'],136,300,436,24515,5,0,1,0.070175439,131
66d67d8e1138cab81fef11ae9aef43d1ba075609,0,Marc Slemko,2006-08-11 23:33:08+00:00,['5b126d6c85e1c23656fb9be43aba5df9a161635d'],2,34,36,24551,1,1,1,1,131
91f674823a80031962265f559c9b3d3ef5bcb1df,0,Marc Slemko,2006-08-11 23:58:57+00:00,['66d67d8e1138cab81fef11ae9aef43d1ba075609'],44,53,97,24648,4,1,1,0,131
e6889de36f2be33d398e15802151690e25be24f0,1,Marc Slemko,2006-08-12 00:32:53+00:00,['91f674823a80031962265f559c9b3d3ef5bcb1df'],24,63,87,24735,7,1,1,0.571428571,131
d8b10518000bfb7b8b35551202c2bca1e60ca1c7,0,Marc Slemko,2006-08-14 23:30:37+00:00,['e6889de36f2be33d398e15802151690e25be24f0'],99,266,365,25100,3,0.111111111,0.935185185,0.87962963,131
1785985754e54f6b53d7e8caad9ac2b7d63e410b,0,Marc Slemko,2006-08-15 00:21:31+00:00,['d8b10518000bfb7b8b35551202c2bca1e60ca1c7'],49,112,161,25261,3,0.829268293,0.829268293,0.829268293,131
aeb36f840b617237dc2bac357ddcc83f19b76949,0,Marc Slemko,2006-08-15 00:21:45+00:00,['1785985754e54f6b53d7e8caad9ac2b7d63e410b'],1,1,2,25263,1,,,,131
bf4fd1996323e104b79532587b5dd392d92a83fa,0,Marc Slemko,2006-08-15 21:29:39+00:00,['aeb36f840b617237dc2bac357ddcc83f19b76949'],66,147,213,25476,6,0.283783784,0.716216216,0.864864865,131
71d4e47e81c825be6c454d60083d20f8fcbff0ae,0,Marc Slemko,2006-08-15 22:34:04+00:00,['bf4fd1996323e104b79532587b5dd392d92a83fa'],9,35,44,25520,2,0,0,1,131
3ea003377001947319cf04c0eb6351a6e5facc2e,1,Marc Slemko,2006-08-17 01:11:13+00:00,['71d4e47e81c825be6c454d60083d20f8fcbff0ae'],1,317,318,25838,4,0.106060606,0.265151515,0.946969697,134
53027fc3d3d2fc9a640f7578f012d289ddeb8d2a,0,Marc Slemko,2006-08-17 01:12:11+00:00,['3ea003377001947319cf04c0eb6351a6e5facc2e'],16,50,66,25904,3,0.413793103,1,0.586206897,135
1ab2878f0e3214cef9942348220617c9b61fa011,0,Marc Slemko,2006-08-17 01:13:44+00:00,['53027fc3d3d2fc9a640f7578f012d289ddeb8d2a'],0,0,0,25904,1,,,,135
26253b28ec88783780f1d36b3cdb47a7eacc1c78,0,Marc Slemko,2006-08-17 01:21:20+00:00,['1ab2878f0e3214cef9942348220617c9b61fa011'],0,1,1,25905,1,,,,136
e18890f8dc546d1e5bfa3a26fa0d04dfa15abd5b,0,Marc Slemko,2006-08-17 01:23:12+00:00,['26253b28ec88783780f1d36b3cdb47a7eacc1c78'],1,5,6,25911,1,,,,136
056f9ba9a0c0564cba4f90392c97a3e1a7de8c42,0,Marc Slemko,2006-08-17 02:59:05+00:00,['e18890f8dc546d1e5bfa3a26fa0d04dfa15abd5b'],14,59,73,25984,2,0,0,1,136
c6936407d1c3ba0325441d44511d2876eb4dbede,0,Marc Slemko,2006-08-23 02:15:31+00:00,['056f9ba9a0c0564cba4f90392c97a3e1a7de8c42'],30,1051,1081,27065,6,0.409345794,0.758878505,0.504672897,137
b09f58838f78e8c8ef411a6db052da8db1f9dc05,1,Marc Slemko,2006-08-23 22:03:34+00:00,['c6936407d1c3ba0325441d44511d2876eb4dbede'],139,399,538,27603,20,0.097560976,0.536585366,1,145
9de5a5cdb761a68dec2c1262c10d98c5eb0712a6,0,Marc Slemko,2006-08-23 22:34:00+00:00,['b09f58838f78e8c8ef411a6db052da8db1f9dc05'],1,70,71,27674,2,,,,146
d97eb611202c25d2210c647f32d7e780cfe319a6,0,Marc Slemko,2006-08-24 23:37:36+00:00,['9de5a5cdb761a68dec2c1262c10d98c5eb0712a6'],95,473,568,28242,9,0.564885496,0.671755725,0.954198473,146
6e1555f36e67eb6d5624ec6b2e0c6a5f23e06696,0,Mark Slee,2006-08-30 17:09:05+00:00,['d97eb611202c25d2210c647f32d7e780cfe319a6'],0,0,0,28242,38,,,,146
632f323f6cad820d622ebfbea4ab3ed54966d2d5,0,Mark Slee,2006-08-30 17:23:52+00:00,['6e1555f36e67eb6d5624ec6b2e0c6a5f23e06696'],3,3,6,28248,4,,,,146
9cb7c61b6b2c88bf41a23d1c4e9757c81d27d8ef,1,Mark Slee,2006-09-01 22:17:45+00:00,['632f323f6cad820d622ebfbea4ab3ed54966d2d5'],823,1495,2318,30566,19,0.196832579,0.513574661,0,146
cfc0193d466df7b18a0995b300a8586a462b92a1,0,Mark Slee,2006-09-01 22:18:16+00:00,['9cb7c61b6b2c88bf41a23d1c4e9757c81d27d8ef'],322,163,485,31051,8,0.213675214,0.042735043,0,146
d3d733a06100cbbb15b86c38b0702dd04a25e107,1,Mark Slee,2006-09-01 22:19:06+00:00,['cfc0193d466df7b18a0995b300a8586a462b92a1'],84,118,202,31253,8,1,1,1,147
c29613f7ada3733fdc88fc5b5c61bfc82e0f2b70,0,Mark Slee,2006-09-01 22:20:32+00:00,['d3d733a06100cbbb15b86c38b0702dd04a25e107'],2,2,4,31257,2,,,,147
78f58e25595f704c3b1e05c911b2821c824dd595,1,Mark Slee,2006-09-02 04:17:07+00:00,['c29613f7ada3733fdc88fc5b5c61bfc82e0f2b70'],646,1055,1701,32958,25,0.368243243,0.452702703,0,149
b7f58ff3468149a0a49c43bf3798aed008dc8764,1,Mark Slee,2006-09-02 21:59:28+00:00,['78f58e25595f704c3b1e05c911b2821c824dd595'],34,33,67,33025,2,0,0,0,149
dafa3cf710b21049f929500ca57957709f46b941,0,Mark Slee,2006-09-02 23:56:49+00:00,['b7f58ff3468149a0a49c43bf3798aed008dc8764'],182,244,426,33451,5,0,0.485714286,0,149
cde2b61c5e3a26fd6ad5bc1a6fcdee449696d66c,1,Mark Slee,2006-09-03 21:13:07+00:00,['dafa3cf710b21049f929500ca57957709f46b941'],0,424,424,33875,9,0.852398524,0.852398524,0.605166052,158
fc89d399179c40adbf108b041d2759e5f56ad4a9,1,Mark Slee,2006-09-04 00:04:39+00:00,['cde2b61c5e3a26fd6ad5bc1a6fcdee449696d66c'],8,72,80,33955,7,0.111111111,0.111111111,1,160
e50b309157876bb53ffaf34130f8dd4ffc47f8fd,1,Mark Slee,2006-09-04 00:06:47+00:00,['fc89d399179c40adbf108b041d2759e5f56ad4a9'],0,1238,1238,35193,2,0.223484848,0.378787879,0.536616162,162
aeac1926f24afbc066abb45917d8a14e879fb9f5,0,Mark Slee,2006-09-04 00:20:24+00:00,['e50b309157876bb53ffaf34130f8dd4ffc47f8fd'],2,6,8,35201,2,0,0,0,162
4ecbebc09989a5fccb40fcb2d3d0d1b9f540a7d4,0,Mark Slee,2006-09-05 00:14:21+00:00,['aeac1926f24afbc066abb45917d8a14e879fb9f5'],0,99,99,35300,3,0,1,1,162
c9676569adfba12a1378eec1c75c6036e7912d9e,1,Mark Slee,2006-09-05 17:34:52+00:00,['4ecbebc09989a5fccb40fcb2d3d0d1b9f540a7d4'],22,369,391,35691,12,0.333333333,0.661904762,0.985714286,165
f5f2be46a3d7c13daf6e47f0962a2e64363d825c,1,Mark Slee,2006-09-05 21:05:31+00:00,['c9676569adfba12a1378eec1c75c6036e7912d9e'],930,738,1668,37359,30,0,0.44,1,165
d2655523aba745e917bc0e3762ac11af4b2437a6,1,Mark Slee,2006-09-05 22:09:57+00:00,['f5f2be46a3d7c13daf6e47f0962a2e64363d825c'],284,290,574,37933,5,0,0.75,1,165
0cc0c0ab6c39f2d3b5e46c1d5ec34dec213f8de9,1,Aditya Agarwal,2006-09-05 22:38:13+00:00,['d2655523aba745e917bc0e3762ac11af4b2437a6'],5,5,10,37943,1,,,,165
085267d60c48379f95e838ac487bb69b61b3aa33,0,Aditya Agarwal,2006-09-05 22:49:53+00:00,['0cc0c0ab6c39f2d3b5e46c1d5ec34dec213f8de9'],1,25,26,37969,2,0.75,0.75,1,165
68db166dd44e0df21507498def340be6117be1b0,0,Aditya Agarwal,2006-09-06 00:18:29+00:00,['085267d60c48379f95e838ac487bb69b61b3aa33'],5,5,10,37979,4,,,,165
c98d050d652d08d8ce99bed5487cd7544b2b25cc,1,Mark Slee,2006-09-06 02:42:25+00:00,['68db166dd44e0df21507498def340be6117be1b0'],15,262,277,38256,30,0.426829268,0.524390244,0.695121951,165
450585b74be4d42fa47848b32ab9041d23849773,0,Aditya Agarwal,2006-09-06 04:19:47+00:00,['c98d050d652d08d8ce99bed5487cd7544b2b25cc'],1,1,2,38258,1,,,,165
ffcddd688aefb42191999d72726ef15de23fd4e3,1,Mark Slee,2006-09-06 20:37:03+00:00,['450585b74be4d42fa47848b32ab9041d23849773'],13,147,160,38418,5,0.786885246,1,0.770491803,166
d788b2e046355f7b08f821e68c6b5147b496599a,1,Mark Slee,2006-09-07 01:26:35+00:00,['ffcddd688aefb42191999d72726ef15de23fd4e3'],176,392,568,38986,22,0.523255814,0.511627907,0.511627907,170
aff9f8e3cf6e672066d8bc5db8d1970f72daba37,0,Mark Slee,2006-09-07 21:18:27+00:00,['d788b2e046355f7b08f821e68c6b5147b496599a'],18,68,86,39072,2,1,0,0,170
018b6998d61fa77aa6f7fb9a73c7e6a2360782f2,0,Mark Slee,2006-09-07 21:31:12+00:00,['aff9f8e3cf6e672066d8bc5db8d1970f72daba37'],24,27,51,39123,7,,,,170
ade2c83d11abe21523607b768b68df1e1ff8bbaf,1,Mark Slee,2006-09-08 03:41:50+00:00,['018b6998d61fa77aa6f7fb9a73c7e6a2360782f2'],21,405,426,39549,8,0.288590604,0.44966443,0.993288591,171
9e7734dada3606d54b9ca520fac4f1f93e4ffd83,0,Mark Slee,2006-09-08 03:51:34+00:00,['ade2c83d11abe21523607b768b68df1e1ff8bbaf'],28,33,61,39610,5,0,1,1,171
4e755cae58e3b6d893539eeccea0df830a696414,1,Mark Slee,2006-09-12 00:46:08+00:00,['9e7734dada3606d54b9ca520fac4f1f93e4ffd83'],8,10,18,39628,6,0,1,1,171
dc8a2a2fc716e30ebfe2fa9ce14761ba3dce4ed4,0,Mark Slee,2006-09-19 22:20:18+00:00,['4e755cae58e3b6d893539eeccea0df830a696414'],3,7,10,39638,1,,,,171
794993d278930cde40b69b61f0eac679bb5938e4,1,Mark Slee,2006-09-20 01:56:10+00:00,['dc8a2a2fc716e30ebfe2fa9ce14761ba3dce4ed4'],21,37,58,39696,10,0,0,1,171
9a89f9b7c799a66bc75c5ed35bedc90bbf489958,0,Mark Slee,2006-09-20 02:41:24+00:00,['794993d278930cde40b69b61f0eac679bb5938e4'],1,1,2,39698,1,,,,171
20c70a67be9dc7bb9ae54e3c52f14f36d75913f0,0,Mark Slee,2006-09-21 01:26:28+00:00,['9a89f9b7c799a66bc75c5ed35bedc90bbf489958'],1,1,2,39700,1,,,,171
c2e8ff5ae69840781c8853fa7a911baefdf62a0a,0,Mark Slee,2006-09-22 16:57:38+00:00,['20c70a67be9dc7bb9ae54e3c52f14f36d75913f0'],8,8,16,39716,1,1,1,1,171
1c4a559bc18eae4ae68f6922f5814441b8fc070e,0,Mark Slee,2006-09-25 21:32:05+00:00,['c2e8ff5ae69840781c8853fa7a911baefdf62a0a'],5,5,10,39726,4,,,,171
5bcde6eba9a46baad799d9a8652dffb0de87cd95,0,Mark Slee,2006-09-27 17:50:32+00:00,['1c4a559bc18eae4ae68f6922f5814441b8fc070e'],6,94,100,39826,2,1,1,0.793103448,171
fdbee8102def9c8597081b90a60cf8048a1e7835,0,Mark Slee,2006-09-27 18:50:48+00:00,['5bcde6eba9a46baad799d9a8652dffb0de87cd95'],17,24,41,39867,1,0,0,1,171
9ffe9d426ce4d605443bc401dfa739639ab47261,0,Mark Slee,2006-09-27 20:40:23+00:00,['fdbee8102def9c8597081b90a60cf8048a1e7835'],0,4,4,39871,1,1,1,1,171
845fe3da646fc87a628140c9a8fa9e33b31a68ce,0,Mark Slee,2006-09-27 20:51:11+00:00,['9ffe9d426ce4d605443bc401dfa739639ab47261'],21,36,57,39928,2,0,1,1,171
6979bdb557d48964b09db3fb8d641d18376d9e54,0,Mark Slee,2006-09-27 22:11:45+00:00,['845fe3da646fc87a628140c9a8fa9e33b31a68ce'],1,1,2,39930,1,,,,171
29f5f67e1fafdd9ef263b59f2d93c347d2209c44,1,Mark Slee,2006-09-28 03:19:03+00:00,['6979bdb557d48964b09db3fb8d641d18376d9e54'],2,2,4,39934,1,,,,171
2905078d167144a5405119f14d4ce96fa6d0ae42,1,Mark Slee,2006-09-29 00:12:30+00:00,['29f5f67e1fafdd9ef263b59f2d93c347d2209c44'],36,245,281,40215,7,0.352941176,0.308823529,0.955882353,171
f77ff06a3bad9b05aae5139c51bd85cc8d139e1a,0,Mark Slee,2006-09-29 21:33:55+00:00,['2905078d167144a5405119f14d4ce96fa6d0ae42'],4,7,11,40226,2,1,1,1,171
4f0fed6c760988ecc41c6c30895fef5a5c8cef96,1,Mark Slee,2006-10-02 17:50:08+00:00,['f77ff06a3bad9b05aae5139c51bd85cc8d139e1a'],9,48,57,40283,3,1,1,0.916666667,171
3c4d7fd053ca07701ac1dba9f0b0f6ef29b181a3,0,Mark Slee,2006-10-02 17:53:20+00:00,['4f0fed6c760988ecc41c6c30895fef5a5c8cef96'],0,1,1,40284,1,,,,171
d7cc1c4e63e5d19a567d871d21277aa1fc6fea6a,0,Mark Slee,2006-10-04 16:49:07+00:00,['3c4d7fd053ca07701ac1dba9f0b0f6ef29b181a3'],7,7,14,40298,1,,,,171
3f11b7a75d295f421c2d38e01792ec8ce462fb12,0,Mark Slee,2006-10-04 19:02:03+00:00,['d7cc1c4e63e5d19a567d871d21277aa1fc6fea6a'],37,28,65,40363,1,1,1,1,171
748e576f6cddb204c4ed2f01d09a7fb647cd30ad,1,Mark Slee,2006-10-04 21:51:05+00:00,['3f11b7a75d295f421c2d38e01792ec8ce462fb12'],7,156,163,40526,2,0,0.008130081,0.943089431,171
96a6bbec1a69292baec6e47c05225eff095b9b0d,0,Mark Slee,2006-10-06 22:43:29+00:00,['748e576f6cddb204c4ed2f01d09a7fb647cd30ad'],4,4,8,40534,1,,,,171
2f6404d9ae0e5e2b813a2cedcf96edc5c643784f,1,Mark Slee,2006-10-10 01:37:40+00:00,['96a6bbec1a69292baec6e47c05225eff095b9b0d'],311,1173,1484,42018,19,0.358247423,0.484536082,0.909793814,175
97b47dff3f365e1c804f002c96c52db2eca36585,1,Mark Slee,2006-10-10 01:38:05+00:00,['2f6404d9ae0e5e2b813a2cedcf96edc5c643784f'],0,43,43,42061,1,1,1,1,175
7d5da163624c5562f2f24d32f831d8cdde5fc75e,1,Mark Slee,2006-10-10 01:38:25+00:00,['97b47dff3f365e1c804f002c96c52db2eca36585'],0,110,110,42171,1,0.564516129,1,0.725806452,176
99e2b2639a9556685c57506459ef1c1c6bf481f8,0,Mark Slee,2006-10-10 01:42:29+00:00,['7d5da163624c5562f2f24d32f831d8cdde5fc75e'],3,182,185,42356,4,1,1,1,177
f5377b3e9947f39744831dd702e3df589bb0d30d,0,Mark Slee,2006-10-10 01:42:59+00:00,['99e2b2639a9556685c57506459ef1c1c6bf481f8'],613,1006,1619,43975,29,0.698412698,1,1,177
b9acf98b33945843c2e75a64692056b23d3f5128,1,Mark Slee,2006-10-10 01:57:32+00:00,['f5377b3e9947f39744831dd702e3df589bb0d30d'],28,58,86,44061,6,0,0,1,177
d622e966d283601cf2fb1cbf87b0fea59a3fe7b4,0,Aditya Agarwal,2006-10-11 02:42:49+00:00,['b9acf98b33945843c2e75a64692056b23d3f5128'],7,10,17,44078,5,0,0,0,177
be3f8d8c6d598cc3d4d5fd68aad54f1278ad0421,1,Aditya Agarwal,2006-10-11 02:43:25+00:00,['d622e966d283601cf2fb1cbf87b0fea59a3fe7b4'],0,134,134,44212,1,,,,178
e528c7649099d84dea57b47c58bbc5c8e65e45f8,1,Aditya Agarwal,2006-10-11 02:48:43+00:00,['be3f8d8c6d598cc3d4d5fd68aad54f1278ad0421'],2,699,701,44913,6,0.434131737,0.688622754,0.832335329,183
3950f47d6fd95ddc7e0df4563a6a53c348a7b784,1,Aditya Agarwal,2006-10-11 02:50:15+00:00,['e528c7649099d84dea57b47c58bbc5c8e65e45f8'],97,73,170,45083,4,0,0,0,183
4f8da1dfb4dc857265506e0c865fe3d9c7cdf771,0,Mark Slee,2006-10-12 02:47:27+00:00,['3950f47d6fd95ddc7e0df4563a6a53c348a7b784'],22,105,127,45210,8,0.652173913,0,1,184
65681d061ec434b7466872824ad41eacf68cd3c7,0,Mark Slee,2006-10-12 03:58:49+00:00,['4f8da1dfb4dc857265506e0c865fe3d9c7cdf771'],2,2,4,45214,1,,,,184
a6b48ea7ce9d3925b7e4715d86a5b391c50a7166,0,Mark Slee,2006-10-12 04:04:11+00:00,['65681d061ec434b7466872824ad41eacf68cd3c7'],4,4,8,45222,3,,,,184
9a079272b2defe1a488b93ffe71511ed6bc15808,1,Mark Slee,2006-10-12 04:05:23+00:00,['a6b48ea7ce9d3925b7e4715d86a5b391c50a7166'],2,2,4,45226,2,,,,184
b90aa7c104e01580b64b37521dd2698904744c64,0,Mark Slee,2006-10-24 18:49:45+00:00,['9a079272b2defe1a488b93ffe71511ed6bc15808'],0,52,52,45278,1,1,1,0.888888889,184
4ce787f238fefb62e3e4aa69eec1de1ad74ef8dd,0,Mark Slee,2006-10-24 18:54:06+00:00,['b90aa7c104e01580b64b37521dd2698904744c64'],1,1,2,45280,1,,,,184
9a695ba364831de190d7884261178124e74da1b3,0,Mark Slee,2006-10-24 18:55:36+00:00,['4ce787f238fefb62e3e4aa69eec1de1ad74ef8dd'],1,1,2,45282,1,,,,184
92f00fb022dae290c38deb41dbc6c9a254537670,0,Mark Slee,2006-10-25 01:28:17+00:00,['9a695ba364831de190d7884261178124e74da1b3'],5,47,52,45334,2,0.375,0.375,0.875,184
83303e1cf7157e5c9862feacf3994782c1540eff,0,Mark Slee,2006-10-25 01:29:37+00:00,['92f00fb022dae290c38deb41dbc6c9a254537670'],8,41,49,45383,2,0.72,1,1,184
b3bd81f4791374c347c102e2f2133841c3fafa63,0,Mark Slee,2006-10-25 01:36:44+00:00,['83303e1cf7157e5c9862feacf3994782c1540eff'],17,17,34,45417,19,,,,184
4af6ed71e16884fd2e7fbec2de241209e0dec468,1,Mark Slee,2006-10-25 19:02:49+00:00,['b3bd81f4791374c347c102e2f2133841c3fafa63'],1018,936,1954,47371,26,1,0.916666667,1,186
a330265d8232c7e095f3fb0a03e001f349b806dd,1,Mark Slee,2006-10-25 19:03:32+00:00,['4af6ed71e16884fd2e7fbec2de241209e0dec468'],71,163,234,47605,5,0,0,1,186
f0712dc994e0f78423e8b99ba69fc2e2ed827bf1,1,Mark Slee,2006-10-25 19:03:57+00:00,['a330265d8232c7e095f3fb0a03e001f349b806dd'],645,1589,2234,49839,24,0.125786164,0,0.991614256,187
d7173476bb79c899e73cc8c91ee1752f29830058,0,Mark Slee,2006-10-25 19:52:10+00:00,['f0712dc994e0f78423e8b99ba69fc2e2ed827bf1'],32,19,51,49890,2,1,1,0,187
fe30c5f3048361eef28cf99e0ea4dc3d16cd9806,1,Mark Slee,2006-10-25 19:53:36+00:00,['d7173476bb79c899e73cc8c91ee1752f29830058'],22,42,64,49954,2,1,1,0.444444444,187
60275c7a674fed08b0b1de0b463a7d0a579dcd23,1,Mark Slee,2006-10-25 19:54:20+00:00,['fe30c5f3048361eef28cf99e0ea4dc3d16cd9806'],15,39,54,50008,1,1,1,0,187
1b87070d63512f181bf397ec5ddcf57ec3a94f5c,0,Mark Slee,2006-10-25 19:58:06+00:00,['60275c7a674fed08b0b1de0b463a7d0a579dcd23'],1,1,2,50010,1,,,,187
b6f10d1fd16e3e00597bbfcb34b748c110bef220,0,Mark Slee,2006-10-25 19:58:36+00:00,['1b87070d63512f181bf397ec5ddcf57ec3a94f5c'],1,153,154,50164,2,0.790123457,1,0.691358025,188
456b7a868cc9f089693e8f3bc100545d78f7e932,1,Mark Slee,2006-10-25 20:53:37+00:00,['b6f10d1fd16e3e00597bbfcb34b748c110bef220'],247,268,515,50679,10,0,0,1,189
575fa9a0dfb0ae57d6ccade6b30b28a3b2608b8b,1,Mark Slee,2006-10-25 20:54:10+00:00,['456b7a868cc9f089693e8f3bc100545d78f7e932'],136,113,249,50928,1,1,1,0,189
5946a185968aeee39a4dc5a1aaea9a9932a4abed,1,Mark Slee,2006-10-25 21:38:39+00:00,['575fa9a0dfb0ae57d6ccade6b30b28a3b2608b8b'],91,79,170,51098,1,1,0.583333333,0,189
4ac459ff3a447786220d01402756b70eb21329a1,1,Mark Slee,2006-10-25 21:39:01+00:00,['5946a185968aeee39a4dc5a1aaea9a9932a4abed'],159,187,346,51444,4,1,1,1,189
a3f3972e3db16ada3f368eecfbda50f664a57339,0,Mark Slee,2006-10-26 02:52:47+00:00,['4ac459ff3a447786220d01402756b70eb21329a1'],1,5,6,51450,1,0,0,1,189
35ae1c784ceb8e184e4b3ebc7b0a955f426a8fc8,0,Aditya Agarwal,2006-10-26 03:31:34+00:00,['a3f3972e3db16ada3f368eecfbda50f664a57339'],44,44,88,51538,2,,,,189
1dd819cd2be36b7cf6d2ee0f729f40e676085fe4,1,Mark Slee,2006-10-26 04:56:18+00:00,['35ae1c784ceb8e184e4b3ebc7b0a955f426a8fc8'],16,14,30,51568,5,1,0,0,189
bb31d0ac43b88dbb8b154f9653c5d58011a2e93d,0,Mark Slee,2006-10-26 04:56:40+00:00,['1dd819cd2be36b7cf6d2ee0f729f40e676085fe4'],2,2,4,51572,1,,,,189
5f8237d4de71d9b0abc764f973818542211c7ed4,0,Mark Slee,2006-10-26 04:57:03+00:00,['bb31d0ac43b88dbb8b154f9653c5d58011a2e93d'],439,416,855,52427,4,1,1,0.645833333,189
63608e8017896253c9d3c11854437602e046906d,0,Mark Slee,2006-10-26 05:06:26+00:00,['5f8237d4de71d9b0abc764f973818542211c7ed4'],1,1,2,52429,1,,,,189
5ee76f8d7dc8611b58513ac80335eb20fbf62c6b,0,Mark Slee,2006-10-26 18:15:02+00:00,['63608e8017896253c9d3c11854437602e046906d'],1,1,2,52431,1,,,,189
d07ce6013b412641b6e9e331ce2d7159d7ce16c4,0,Mark Slee,2006-10-27 22:30:15+00:00,['5ee76f8d7dc8611b58513ac80335eb20fbf62c6b'],6,5,11,52442,1,,,,189
0f70d773338a108997c9ea6c8e5800a80a18d34a,0,Mark Slee,2006-10-28 00:51:14+00:00,['d07ce6013b412641b6e9e331ce2d7159d7ce16c4'],1,3,4,52446,1,,,,189
725f9e6c710d718d3763d025d34cd4ad1ce34e87,1,Mark Slee,2006-10-31 05:08:33+00:00,['0f70d773338a108997c9ea6c8e5800a80a18d34a'],5,12,17,52463,2,0.142857143,0.142857143,0,189
e2bd58da293bfefc5082d7e227b7b4244c73b497,0,Mark Slee,2006-10-31 05:09:24+00:00,['725f9e6c710d718d3763d025d34cd4ad1ce34e87'],2,12,14,52477,3,1,1,0.375,190
6b4783b96b22f336eaf2f2b024e8e835c4474172,0,Mark Slee,2006-10-31 05:43:53+00:00,['e2bd58da293bfefc5082d7e227b7b4244c73b497'],0,3,3,52480,1,0,1,1,190
bc4bc0f8f4d041cab499567f6ebc36e6da143af6,0,Mark Slee,2006-10-31 05:45:33+00:00,['6b4783b96b22f336eaf2f2b024e8e835c4474172'],1,1,2,52482,1,,,,190
b39dbc5891d11131bc48098b33983d35169de6cb,0,Mark Slee,2006-10-31 05:56:27+00:00,['bc4bc0f8f4d041cab499567f6ebc36e6da143af6'],5,5,10,52492,1,,,,190
207cb46af86e3cda525a7bbeefba6c2f2f231ef3,0,Mark Slee,2006-11-02 18:43:12+00:00,['b39dbc5891d11131bc48098b33983d35169de6cb'],26,16,42,52534,1,,,,190
8d2b238697d06f86d35b033da82379824874a1aa,0,Mark Slee,2006-11-06 21:40:11+00:00,['207cb46af86e3cda525a7bbeefba6c2f2f231ef3'],1,1,2,52536,1,,,,190
9683f77d886fbd7cca658afe51d8ab9a79596522,0,Mark Slee,2006-11-07 23:03:00+00:00,['8d2b238697d06f86d35b033da82379824874a1aa'],2,1,3,52539,1,,,,190
ae2bc3c8d6754f7e0fc6d81aae1a35af4c45af08,0,Mark Slee,2006-11-08 23:44:59+00:00,['9683f77d886fbd7cca658afe51d8ab9a79596522'],1,1,2,52541,1,,,,190
32c66e15063c221a00425a9fff07d7f0da6fe478,1,Martin Kraemer,2006-11-09 00:06:36+00:00,['ae2bc3c8d6754f7e0fc6d81aae1a35af4c45af08'],15,51,66,52607,1,0,0,1,190
2329a83701f703a26894c1fcf1bf096db77a0e88,0,Mark Slee,2006-11-09 00:23:30+00:00,['32c66e15063c221a00425a9fff07d7f0da6fe478'],24,30,54,52661,2,0,0,1,190
52cb2234de60a870a89e111e7d9adaf37f9aa1bd,0,Mark Slee,2006-11-10 22:32:07+00:00,['2329a83701f703a26894c1fcf1bf096db77a0e88'],1,1,2,52663,1,,,,190
19e71c34b190489e4ab261a69f206943a7dc56b0,0,Mark Slee,2006-11-10 23:07:35+00:00,['52cb2234de60a870a89e111e7d9adaf37f9aa1bd'],0,21,21,52684,1,0,1,0,190
5ea94d444b9c84eff42ebaeb13324d4eb3f55566,0,Mark Slee,2006-11-14 23:48:00+00:00,['19e71c34b190489e4ab261a69f206943a7dc56b0'],0,51,51,52735,2,0,1,1,190
6e81b3fb5c43504a8411784e9648634eb0fed542,0,Mark Slee,2006-11-14 23:51:27+00:00,['5ea94d444b9c84eff42ebaeb13324d4eb3f55566'],1,1,2,52737,1,,,,190
04cc605597a05f830808ed9ea81ba82d679d072e,0,Mark Slee,2006-11-15 21:25:34+00:00,['6e81b3fb5c43504a8411784e9648634eb0fed542'],1,1,2,52739,1,,,,190
588e452bc496c1c9ef3730fce15b1c9796d64c48,0,Mark Slee,2006-11-15 22:23:06+00:00,['04cc605597a05f830808ed9ea81ba82d679d072e'],2,6,8,52747,1,0,0,1,190
b9ff32ae30af5a667efa7d1d3b39687d5758c742,1,Mark Slee,2006-11-16 01:00:24+00:00,['588e452bc496c1c9ef3730fce15b1c9796d64c48'],59,188,247,52994,15,0.655172414,0.655172414,1,190
216e7d6a9a7d061cdfd91b56db4ec2985cb4096e,1,Mark Slee,2006-11-21 00:44:23+00:00,['b9ff32ae30af5a667efa7d1d3b39687d5758c742'],41,49,90,53084,5,0,0.285714286,0.714285714,190
e598d075f55af8db87ff1963c330e9ca7cc95b9e,1,Mark Slee,2006-11-21 02:01:22+00:00,['216e7d6a9a7d061cdfd91b56db4ec2985cb4096e'],2,2,4,53088,1,,,,190
d3bc1a5f528a2b56b162a135bae66139a562ff1e,0,Mark Slee,2006-11-27 20:25:43+00:00,['e598d075f55af8db87ff1963c330e9ca7cc95b9e'],3,3,6,53094,1,,,,190
301528702cb311d0bd10f7ebfc6bb63f4a9dc8bb,1,Mark Slee,2006-11-28 01:24:07+00:00,['d3bc1a5f528a2b56b162a135bae66139a562ff1e'],45,329,374,53468,12,0.152542373,0.152542373,0.152542373,191
aa7671d041f889f00a0ccc7dad2f806cf73a9a0d,1,Mark Slee,2006-11-29 03:19:31+00:00,['301528702cb311d0bd10f7ebfc6bb63f4a9dc8bb'],3,646,649,54117,11,0.014678899,0.163302752,0.576146789,191
67fc63410d0b7065e70be52834bf6a724a7b00e5,0,Mark Slee,2006-11-29 03:37:04+00:00,['aa7671d041f889f00a0ccc7dad2f806cf73a9a0d'],0,6,6,54123,1,,,,191
600cdb337e4067280c2aa3135eafbcc34da45e20,1,Mark Slee,2006-11-29 22:06:42+00:00,['67fc63410d0b7065e70be52834bf6a724a7b00e5'],4,20,24,54147,3,0,0,1,191
7657fa97475496f6e65aeb8c1ca2d5732545b733,0,Mark Slee,2006-11-29 22:07:23+00:00,['600cdb337e4067280c2aa3135eafbcc34da45e20'],1,0,1,54148,1,,,,191
807b2c601d84231a235bd20093edc6dd152c94c4,1,Mark Slee,2006-11-30 00:55:41+00:00,['7657fa97475496f6e65aeb8c1ca2d5732545b733'],0,94,94,54242,1,1,1,1,192
3860c9a2464d11f55daf983723c784f512aec530,0,Mark Slee,2006-12-06 00:13:42+00:00,['807b2c601d84231a235bd20093edc6dd152c94c4'],0,4,4,54246,1,0,0,1,192
97f9d60be8c50199e641ad8edb676c582dd7b8da,0,Martin Kraemer,2006-12-06 19:52:16+00:00,['3860c9a2464d11f55daf983723c784f512aec530'],1,1,2,54248,1,,,,192
962a8585663db144150c98e4a6adc275a2a473a7,0,Mark Slee,2006-12-08 19:15:35+00:00,['97f9d60be8c50199e641ad8edb676c582dd7b8da'],0,44,44,54292,2,0,1,1,192
e9ef8d7ce98484599730ffc0a2f17d64dc69d944,1,Aditya Agarwal,2006-12-08 23:52:57+00:00,['962a8585663db144150c98e4a6adc275a2a473a7'],180,760,940,55232,5,0.287356322,0.353448276,1,192
0c341a1332a11120e292c16b0a4dec742800518f,1,Aditya Agarwal,2006-12-09 00:47:03+00:00,['e9ef8d7ce98484599730ffc0a2f17d64dc69d944'],6,8,14,55246,1,0,0.6,0.4,192
25b293616b63fd93f588737b06970f565b6ca043,0,Aditya Agarwal,2006-12-09 00:58:15+00:00,['0c341a1332a11120e292c16b0a4dec742800518f'],5,5,10,55256,5,,,,192
8196a617453ad18c89e8898892aa748861592d81,0,Martin Kraemer,2006-12-09 01:57:58+00:00,['25b293616b63fd93f588737b06970f565b6ca043'],1,1,2,55258,1,,,,192
cbea1c7ef32c2dda2568cc6dd5a219a4e63dfa5e,0,Mark Slee,2006-12-13 01:07:33+00:00,['8196a617453ad18c89e8898892aa748861592d81'],2,0,2,55260,2,0,0,0,192
069d31e7b9ab33c6f62df0ab6b4dabb86cac84b3,0,Mark Slee,2006-12-13 01:45:26+00:00,['cbea1c7ef32c2dda2568cc6dd5a219a4e63dfa5e'],1,1,2,55262,1,,,,192
0524bcee68bc167fa9ad6223c5d7add0c3069b09,0,Mark Slee,2006-12-13 01:54:56+00:00,['069d31e7b9ab33c6f62df0ab6b4dabb86cac84b3'],1,1,2,55264,1,,,,192
971fda34b5756b2cdea87d467aa45276ab1aad8c,0,Mark Slee,2006-12-15 19:07:04+00:00,['0524bcee68bc167fa9ad6223c5d7add0c3069b09'],9,22,31,55295,2,0.545454545,0.545454545,0,192
706da402370eb6bb24a22394bd198bfcbe65dcb4,0,Mark Slee,2006-12-16 00:59:29+00:00,['971fda34b5756b2cdea87d467aa45276ab1aad8c'],0,4,4,55299,1,0,0,0,192
2abc9dfd5901bbf8cf689c1edad67567b06070aa,0,Mark Slee,2006-12-16 01:06:49+00:00,['706da402370eb6bb24a22394bd198bfcbe65dcb4'],1,1,2,55301,1,,,,192
3fa9d24bc30106349aebe9aaa814b3780928decf,0,robert,2006-12-19 22:27:54+00:00,['2abc9dfd5901bbf8cf689c1edad67567b06070aa'],1,1,2,55303,1,,,,192
79511192f15a6a68a8c5f0ad944e528c7a5ccd61,0,robert,2006-12-20 19:25:38+00:00,['3fa9d24bc30106349aebe9aaa814b3780928decf'],6,3,9,55312,1,1,1,0,192
fde62cb22319c3f2d569aaa4b4b77d7727187754,0,putnam,2006-12-22 10:35:12+00:00,['79511192f15a6a68a8c5f0ad944e528c7a5ccd61'],1,1,2,55314,1,,,,192
a09e34efb025ef9a2552deb133b5207b9dd810b4,0,Mark Slee,2007-01-03 18:45:04+00:00,['fde62cb22319c3f2d569aaa4b4b77d7727187754'],1,1,2,55316,1,,,,192
ad58f952bc0c637a203416eaaf46383f9955ef8e,0,Mark Slee,2007-01-03 19:23:50+00:00,['a09e34efb025ef9a2552deb133b5207b9dd810b4'],18,41,59,55375,2,1,1,0,192
a4713ea566a6b0a8908b558663f71aa46d4817d5,0,Mark Slee,2007-01-05 01:09:04+00:00,['ad58f952bc0c637a203416eaaf46383f9955ef8e'],0,36,36,55411,1,,,,193
e7714a6c0911a42ead7934934334b7d330b36e87,0,Mark Slee,2007-01-11 01:26:00+00:00,['a4713ea566a6b0a8908b558663f71aa46d4817d5'],8,10,18,55429,2,0,0,1,193
2f816f28e6f7344f672dc11732f32a1e445adfe8,0,Adam Nichols,2007-01-11 21:25:29+00:00,['e7714a6c0911a42ead7934934334b7d330b36e87'],2,2,4,55433,1,,,,193
f12865a33823c9c8d0b5387620c52dd45885e426,0,Mark Slee,2007-01-12 00:23:26+00:00,['2f816f28e6f7344f672dc11732f32a1e445adfe8'],0,71,71,55504,1,,,,193
e888b376add3789c7943f781199ba506d0320bc5,0,Mark Slee,2007-01-12 01:06:24+00:00,['f12865a33823c9c8d0b5387620c52dd45885e426'],27,63,90,55594,7,0.5,0.5,0,193
529bfeef9704dc03d7e209d025d7c94884e4256b,0,Mark Slee,2007-01-12 02:10:16+00:00,['e888b376add3789c7943f781199ba506d0320bc5'],5,14,19,55613,2,0,0,0,193
a45909b619b883f41ceef75a06d583c0c03669c8,1,Mark Slee,2007-01-12 21:44:14+00:00,['529bfeef9704dc03d7e209d025d7c94884e4256b'],20,74,94,55707,2,0,0.403846154,1,193
1c989f2c78356122c3e31abb8a634893a1c58634,0,robert,2007-01-15 18:29:51+00:00,['a45909b619b883f41ceef75a06d583c0c03669c8'],0,12,12,55719,1,1,1,1,193
ebc99e0e164e0ffc2053f3379d384719ff47cb6e,1,Aditya Agarwal,2007-01-15 23:14:58+00:00,['1c989f2c78356122c3e31abb8a634893a1c58634'],0,44,44,55763,2,1,1,1,193
b0fac3ee665bd369eb97d24a2079935a91e495ab,0,robert,2007-01-15 23:53:25+00:00,['ebc99e0e164e0ffc2053f3379d384719ff47cb6e'],12,3,15,55778,2,,,,193
d95abdd9183be7e0d895d19818dad8d8ad263e52,0,Marc Slemko,2007-01-16 22:20:19+00:00,['b0fac3ee665bd369eb97d24a2079935a91e495ab'],2,53,55,55833,5,,,,196
406a40cf16b597974c739b7175ce3f3977d59cd3,0,Mark Slee,2007-01-16 22:48:22+00:00,['d95abdd9183be7e0d895d19818dad8d8ad263e52'],8,10,18,55851,2,0.5,1,1,196
a340e0d6fef4601ed0e1dc12e78fddaec62eccbc,0,Mark Slee,2007-01-16 23:00:31+00:00,['406a40cf16b597974c739b7175ce3f3977d59cd3'],7,7,14,55865,1,,,,196
5ec19933cb3f125bcd0ee78b39db218fd357746a,0,Mark Slee,2007-01-16 23:53:53+00:00,['a340e0d6fef4601ed0e1dc12e78fddaec62eccbc'],0,4,4,55869,1,1,0,1,196
75c2f702c9cbc4c0dd0ff9949adb8cc4643ec360,0,Marc Slemko,2007-01-17 07:59:38+00:00,['5ec19933cb3f125bcd0ee78b39db218fd357746a'],3,19,22,55891,2,,,,196
85ca7a13e89152843efe7c75956b0e22c1c4eb3b,0,Marc Slemko,2007-01-17 08:32:16+00:00,['75c2f702c9cbc4c0dd0ff9949adb8cc4643ec360'],2,89,91,55982,4,,,,197
893ef724c351d30d73f83827147a0287ec1d6751,0,Karl Lehenbauer,2007-01-17 18:56:10+00:00,['85ca7a13e89152843efe7c75956b0e22c1c4eb3b'],1,1,2,55984,1,,,,197
12f6631735d91f05dd76b07c6be7f8277ddf8a08,0,Mark Slee,2007-01-17 19:19:21+00:00,['893ef724c351d30d73f83827147a0287ec1d6751'],4,4,8,55992,1,,,,197
7628fd74440375cc18be9037d1c27e8b297ed5e0,0,Mark Slee,2007-01-18 01:16:51+00:00,['12f6631735d91f05dd76b07c6be7f8277ddf8a08'],1,3,4,55996,1,,,,197
f3763a1fae75a7820cfec9a2d16fdaa981fadb63,1,Mark Slee,2007-01-18 02:35:27+00:00,['7628fd74440375cc18be9037d1c27e8b297ed5e0'],0,37,37,56033,2,0.333333333,0.666666667,1,197
794568bafe32416338a011258872907bb51b476b,1,Aditya Agarwal,2007-01-18 06:20:24+00:00,['f3763a1fae75a7820cfec9a2d16fdaa981fadb63'],18,70,88,56121,4,0.444444444,0.296296296,1,197
032606bb7204070e71c698f9c25fe02f23928fa6,0,Mark Slee,2007-01-18 06:54:43+00:00,['794568bafe32416338a011258872907bb51b476b'],0,2,2,56123,1,1,1,1,197
06098d75864b4629f93c237d3c0b148e278e299d,0,Mark Slee,2007-01-18 18:35:26+00:00,['032606bb7204070e71c698f9c25fe02f23928fa6'],3526,1,3527,59650,11,0.44539737,0.234419668,0.337907376,197
ace6e6dbc0ef327a34fab0109f471081dc7fb08e,0,Mark Slee,2007-01-18 20:00:11+00:00,['06098d75864b4629f93c237d3c0b148e278e299d'],1,5,6,59656,1,0,0,1,197
0e0ff7e00353fc4a9a1b5a6f49069d05b64604f2,0,Mark Slee,2007-01-18 22:59:59+00:00,['ace6e6dbc0ef327a34fab0109f471081dc7fb08e'],1,261,262,59918,5,0.256410256,0.474358974,0.762820513,199
782abbb75692d4cc582e60e88da5e58c049e4bfd,0,Mark Slee,2007-01-19 00:17:02+00:00,['0e0ff7e00353fc4a9a1b5a6f49069d05b64604f2'],7,43,50,59968,4,0.470588235,1,1,199
1ea90526b0acf89e3e06174fdfef524b671ce0bf,0,Aditya Agarwal,2007-01-19 02:02:12+00:00,['782abbb75692d4cc582e60e88da5e58c049e4bfd'],15,73,88,60056,3,0.473684211,1,0.368421053,199
b6200d82f6611c5c3ca962f8de48ea840fe35de1,0,Mark Slee,2007-01-19 19:14:36+00:00,['1ea90526b0acf89e3e06174fdfef524b671ce0bf'],3,30,33,60089,8,0.785714286,0.785714286,1,199
36bfa2e61f6321f6910293d3cf66241fcd66ccfb,0,Mark Slee,2007-01-19 20:09:51+00:00,['b6200d82f6611c5c3ca962f8de48ea840fe35de1'],27,60,87,60176,6,0.666666667,0.666666667,0.75,199
eb08f9e6802949238f523836cf853a2a1dab6aba,0,Mark Slee,2007-01-19 22:12:10+00:00,['36bfa2e61f6321f6910293d3cf66241fcd66ccfb'],1,13,14,60190,2,0.857142857,0.857142857,0.857142857,199
f49041c083e12c89c7d8d8ebdcafcb3b566534c4,0,Mark Slee,2007-01-19 23:49:00+00:00,['eb08f9e6802949238f523836cf853a2a1dab6aba'],5,5,10,60200,1,,,,199
8896a54720f6fe760b163378e18f9440b48706c9,0,Mark Slee,2007-01-23 23:22:35+00:00,['f49041c083e12c89c7d8d8ebdcafcb3b566534c4'],4,0,4,60204,1,1,0,0,199
502ea8a3c835e5807f6980d8d1157d5fd0b3b657,0,Aditya Agarwal,2007-01-24 02:24:35+00:00,['8896a54720f6fe760b163378e18f9440b48706c9'],13,29,42,60246,1,0.3,0.3,1,199
f9373397c3e33437e7353ad43c55a33bca4e6583,0,Mark Slee,2007-01-24 19:41:57+00:00,['502ea8a3c835e5807f6980d8d1157d5fd0b3b657'],0,7,7,60253,1,1,1,1,199
1921d2046b588cd1f19c40d323d44e74b02a4e1f,1,Mark Slee,2007-01-24 19:43:06+00:00,['f9373397c3e33437e7353ad43c55a33bca4e6583'],44,48,92,60345,2,0,0,0,199
bf05a6069e5bcdf0a2254ee933f0925a45615233,0,Mark Slee,2007-01-24 22:53:07+00:00,['1921d2046b588cd1f19c40d323d44e74b02a4e1f'],60,128,188,60533,2,0,0.381818182,0,199
9abb0d69b7613f73e3fe079cfdafabab59bc4ec9,0,Aditya Agarwal,2007-01-24 22:53:54+00:00,['bf05a6069e5bcdf0a2254ee933f0925a45615233'],123,184,307,60840,13,0.866666667,0.911111111,0.4,199
c42ecd5cfee2e922fd3d150f840c6532af1b8919,0,Mark Slee,2007-01-24 22:57:20+00:00,['9abb0d69b7613f73e3fe079cfdafabab59bc4ec9'],4,4,8,60848,1,,,,199
c425780847ea746a474f8c81c6e8cb350d1a4feb,0,Mark Slee,2007-01-24 23:14:30+00:00,['c42ecd5cfee2e922fd3d150f840c6532af1b8919'],3,4,7,60855,1,,,,199
68f08ee5f5986138105bb3906b086cd15df02026,1,Aditya Agarwal,2007-01-24 23:39:10+00:00,['c425780847ea746a474f8c81c6e8cb350d1a4feb'],34,120,154,61009,2,0.233333333,0.516666667,0.766666667,199
9e288d4f7ad0b55f5a1c6b0010f4f0a5d935fece,1,Mark Slee,2007-01-24 23:42:12+00:00,['68f08ee5f5986138105bb3906b086cd15df02026'],2,25,27,61036,3,,,,200
cc11b06c018997d37f7c2a76e6439fcf8f1b82d5,0,Mark Slee,2007-01-25 02:07:22+00:00,['9e288d4f7ad0b55f5a1c6b0010f4f0a5d935fece'],0,0,0,61036,3,,,,200
938bc38e7dba592a9c69d690c052c7279f59a9f9,0,Mark Slee,2007-01-25 02:10:07+00:00,['cc11b06c018997d37f7c2a76e6439fcf8f1b82d5'],10,10,20,61056,1,,,,200
2c9f2fb0bd356f45a10b2c37743677969c61ef72,0,Aditya Agarwal,2007-01-25 03:27:43+00:00,['938bc38e7dba592a9c69d690c052c7279f59a9f9'],11,16,27,61083,1,0,1,0,200
79e025b3e8710cbee50db83f84cce153a230f6ea,0,Mark Slee,2007-01-25 06:28:24+00:00,['2c9f2fb0bd356f45a10b2c37743677969c61ef72'],1,1,2,61085,1,,,,200
eb0d024ee1ca1cf55b813d4890d6eef388b5ef94,1,Mark Slee,2007-01-25 07:58:55+00:00,['79e025b3e8710cbee50db83f84cce153a230f6ea'],232,267,499,61584,17,1,1,1,208
6f5e2cb3ea48815d6e1d45d95dbe69176a46926a,1,Mark Slee,2007-01-25 08:01:28+00:00,['eb0d024ee1ca1cf55b813d4890d6eef388b5ef94'],4,4,8,61592,4,,,,208
0788a70568640d0709e3655ba782b186fc9d9526,1,Mark Slee,2007-01-25 08:14:50+00:00,['6f5e2cb3ea48815d6e1d45d95dbe69176a46926a'],6,9,15,61607,2,,,,208
50919171b72e3a13daa5fa4159121c0a30e845a2,0,Martin Kraemer,2007-01-26 01:41:03+00:00,['0788a70568640d0709e3655ba782b186fc9d9526'],5,5,10,61617,1,,,,208
6d7d5958586e5021f84f9a7c36bbc58b47c1c6b2,1,Mark Slee,2007-01-27 01:44:22+00:00,['50919171b72e3a13daa5fa4159121c0a30e845a2'],3,3806,3809,65426,12,0.482553529,0.603489294,0.804520222,218
cb09cfa3220dff831acf7256179a6ec60874aec0,0,Mark Slee,2007-01-27 01:58:17+00:00,['6d7d5958586e5021f84f9a7c36bbc58b47c1c6b2'],1,1,2,65428,1,,,,218
a7747c2525bc0815c01a896cb0dd8eba7adf5ce5,0,Mark Slee,2007-01-29 17:35:54+00:00,['cb09cfa3220dff831acf7256179a6ec60874aec0'],14,16,30,65458,2,,,,218
2006d99d251bc2c4a1e06e39bdee789c459327fe,1,Mark Slee,2007-01-29 17:58:54+00:00,['a7747c2525bc0815c01a896cb0dd8eba7adf5ce5'],5,45,50,65508,5,0,0.710526316,0.789473684,218
4637bfbff88c3b15ae81abe85a712cfc3cef248e,0,dave,2007-01-30 19:50:30+00:00,['2006d99d251bc2c4a1e06e39bdee789c459327fe'],2,2,4,65512,1,,,,218
aaa23ed4ea6aa683f8b1f1d5de79846f61d1937e,1,Mark Slee,2007-01-30 19:52:05+00:00,['4637bfbff88c3b15ae81abe85a712cfc3cef248e'],6,10,16,65528,1,0,0,1,218
0d9199e709c92e28ffe67b14916a9c49ce7dbca0,0,Mark Slee,2007-01-31 02:08:30+00:00,['aaa23ed4ea6aa683f8b1f1d5de79846f61d1937e'],1,25,26,65554,4,0.6,1,1,218
492d22311846f4338461882f4531e18baff63014,0,dave,2007-01-31 02:49:01+00:00,['0d9199e709c92e28ffe67b14916a9c49ce7dbca0'],1,2,3,65557,1,0,1,1,218
cb126a0c196a14734194c983452f702f16c9c929,0,Mark Slee,2007-01-31 08:31:29+00:00,['492d22311846f4338461882f4531e18baff63014'],10,11,21,65578,1,,,,218
29cbeb6235f6637f2584715cf3ea37cf6a371653,0,dave,2007-02-01 00:17:28+00:00,['cb126a0c196a14734194c983452f702f16c9c929'],9,13,22,65600,2,0,0,0,218
7ff3245bfae7c99ac12550ddc252f80ad32dd366,1,Mark Slee,2007-02-01 05:26:18+00:00,['29cbeb6235f6637f2584715cf3ea37cf6a371653'],243,283,526,66126,13,1,1,1,218
7a20a14a0647fb2856898b6994cd35917c10791f,0,Mark Slee,2007-02-01 21:39:50+00:00,['7ff3245bfae7c99ac12550ddc252f80ad32dd366'],23,16,39,66165,2,1,0,0,218
b3cb62959edab16c0ee8ccfd3cf7bc45d63ef703,1,Mark Slee,2007-02-01 22:55:00+00:00,['7a20a14a0647fb2856898b6994cd35917c10791f'],4,152,156,66321,4,0.253968254,0.73015873,0.777777778,220
739dbe55aee3baa81a3678fbb307b4e70d6caea8,1,Mark Slee,2007-02-01 22:55:30+00:00,['b3cb62959edab16c0ee8ccfd3cf7bc45d63ef703'],11,18,29,66350,2,0,0,1,220
8cbda85be56cf03bb8d0c1a84d200ea04173f4aa,0,Mark Slee,2007-02-01 23:05:38+00:00,['739dbe55aee3baa81a3678fbb307b4e70d6caea8'],1,2,3,66353,1,,,,220
f23cfd810c75ebeb725380a9e40fd91eea884399,0,Mark Slee,2007-02-02 00:09:51+00:00,['8cbda85be56cf03bb8d0c1a84d200ea04173f4aa'],1,1,2,66355,1,,,,220
10640d8935c62d6ee5684ad4b26b760dc0e424d1,1,Martin Kraemer,2007-02-03 01:59:12+00:00,['f23cfd810c75ebeb725380a9e40fd91eea884399'],2,12,14,66369,2,1,1,1,220
f53b5cfed2d6aeba4e0f6cc4dface6d641f98ce7,1,ccheever,2007-02-05 20:33:11+00:00,['10640d8935c62d6ee5684ad4b26b760dc0e424d1'],36,239,275,66644,9,0.833333333,1,1,221
92a2eac8cbeef3fbdb6f3f9dd9df8db226240959,0,Martin Kraemer,2007-02-05 20:58:41+00:00,['f53b5cfed2d6aeba4e0f6cc4dface6d641f98ce7'],2,2,4,66648,1,,,,221
ee341cb57bc860b41477fb9f9e8ff035c6ba9b47,1,Martin Kraemer,2007-02-05 21:40:38+00:00,['92a2eac8cbeef3fbdb6f3f9dd9df8db226240959'],17,19,36,66684,3,1,1,0,221
74eea207a02fb5e3a92c0afcadd0e7a0d6313ef5,0,Mark Slee,2007-02-05 21:47:03+00:00,['ee341cb57bc860b41477fb9f9e8ff035c6ba9b47'],0,32,32,66716,1,1,1,1,222
21135c300bd4418365981e930d3aeba6f290fb5b,0,Mark Slee,2007-02-05 21:52:08+00:00,['74eea207a02fb5e3a92c0afcadd0e7a0d6313ef5'],172,98,270,66986,8,1,1,0,222
5c468196dc7a1d6035df83fb656ab3f214657421,0,Aditya Agarwal,2007-02-06 01:14:33+00:00,['21135c300bd4418365981e930d3aeba6f290fb5b'],49,70,119,67105,4,0,1,1,222
f954f97b963d618dc767677850cb13429c9f5a52,0,Aditya Agarwal,2007-02-06 01:26:12+00:00,['5c468196dc7a1d6035df83fb656ab3f214657421'],2,6,8,67113,1,1,1,1,222
6a5bcaa754fa8ece15658d8542602cd7b846d00c,0,Aditya Agarwal,2007-02-06 02:50:56+00:00,['f954f97b963d618dc767677850cb13429c9f5a52'],47,30,77,67190,2,0,0,0,222
5a429586f8ec917f0b0c5209d645304199be1bbe,1,Aditya Agarwal,2007-02-06 02:51:15+00:00,['6a5bcaa754fa8ece15658d8542602cd7b846d00c'],82,142,224,67414,7,0.530612245,0.918367347,0.020408163,222
e12d48596d4666b393d8f69fa8ef2764b9b5bfaa,0,Aditya Agarwal,2007-02-06 03:25:13+00:00,['5a429586f8ec917f0b0c5209d645304199be1bbe'],205,211,416,67830,4,1,1,0.888888889,222
86c87b0fe1581a4a27b603119327a3f9eb602fa7,0,Mark Slee,2007-02-06 07:11:23+00:00,['e12d48596d4666b393d8f69fa8ef2764b9b5bfaa'],1,7,8,67838,1,0,0,0,222
7df0e2a9aa61e24a5121b24f0cac60d8a858a88b,0,Mark Slee,2007-02-06 21:03:18+00:00,['86c87b0fe1581a4a27b603119327a3f9eb602fa7'],19,44,63,67901,5,0.8,0.8,0.7,222
43b6c6378e6a56c4d5dd69164f87d470273eed40,0,Mark Slee,2007-02-07 00:54:17+00:00,['7df0e2a9aa61e24a5121b24f0cac60d8a858a88b'],6,9,15,67916,1,1,1,1,222
81cf1e550d6ffdde116f541a8a5f7a75625ffbf9,0,Mark Slee,2007-02-07 00:54:49+00:00,['43b6c6378e6a56c4d5dd69164f87d470273eed40'],19,29,48,67964,1,0,0,1,222
748d83f65f7567415efda53f5cfd62c726737469,0,Mark Slee,2007-02-07 01:20:08+00:00,['81cf1e550d6ffdde116f541a8a5f7a75625ffbf9'],21,30,51,68015,4,0.333333333,0.333333333,0.166666667,222
9bae5e783e8c2886a1608b0976f626ec6469e97e,0,Aditya Agarwal,2007-02-07 02:36:56+00:00,['748d83f65f7567415efda53f5cfd62c726737469'],1,2,3,68018,1,,,,222
af602f5e9f338c8ca73992ea968001151c9350db,0,Aditya Agarwal,2007-02-07 02:38:54+00:00,['9bae5e783e8c2886a1608b0976f626ec6469e97e'],2,0,2,68020,1,,,,222
6a47fed5feef44de4c5505fff21126f09ec02c6e,1,Mark Slee,2007-02-07 02:40:59+00:00,['af602f5e9f338c8ca73992ea968001151c9350db'],11,90,101,68121,4,0.107142857,1,1,222
fdef47ea2bbb1802deee4f10407c40cd32c42d52,1,Aditya Agarwal,2007-02-07 03:54:18+00:00,['6a47fed5feef44de4c5505fff21126f09ec02c6e'],12,45,57,68178,3,0,0,1,222
79e41b817e59615ce03910e104e18e300a9204d4,0,Mark Slee,2007-02-07 04:07:07+00:00,['fdef47ea2bbb1802deee4f10407c40cd32c42d52'],2,1,3,68181,1,,,,222
da748dd5fe09fbc76d9db8e26b73012d229f9787,1,Mark Slee,2007-02-07 06:03:32+00:00,['79e41b817e59615ce03910e104e18e300a9204d4'],6,7,13,68194,1,0,1,1,222
157d9f794ea62740095dcf1f4dd4b401068fc340,0,Mark Slee,2007-02-07 06:03:53+00:00,['da748dd5fe09fbc76d9db8e26b73012d229f9787'],1,70,71,68265,2,1,1,1,223
e1165d4b1837726dba8c144719cbde6f47389478,0,Mark Slee,2007-02-07 06:05:28+00:00,['157d9f794ea62740095dcf1f4dd4b401068fc340'],5,66,71,68336,4,0.6,1,0.775,224
0b64e77d96fbf2f80b78b768613c84584c84920f,1,Martin Kraemer,2007-02-07 22:39:58+00:00,['e1165d4b1837726dba8c144719cbde6f47389478'],7,25,32,68368,1,0,0,1,224
907e3d6345858f245331d9e6f6a98624b3eda624,1,Mark Slee,2007-02-08 22:29:24+00:00,['0b64e77d96fbf2f80b78b768613c84584c84920f'],0,16,16,68384,1,0,0,1,224
9f8361fee7ea26167fd0818e6de1b000f582dd5e,0,Mark Slee,2007-02-09 02:14:43+00:00,['907e3d6345858f245331d9e6f6a98624b3eda624'],6,6,12,68396,3,,,,224
afc76543cd50b44560f864bd4f871de62cea9d7b,0,Mark Slee,2007-02-09 21:55:44+00:00,['9f8361fee7ea26167fd0818e6de1b000f582dd5e'],2,2,4,68400,1,,,,224
a0c92417a0eedcb65361d4e8f0d9ae679554c715,1,James Wang,2007-02-14 23:22:08+00:00,['afc76543cd50b44560f864bd4f871de62cea9d7b'],195,286,481,68881,2,0.76119403,0.850746269,0.701492537,224
fb84b2b264c833a10192374197b08b805739ea49,0,Mark Slee,2007-02-20 03:37:28+00:00,['a0c92417a0eedcb65361d4e8f0d9ae679554c715'],2,2,4,68885,1,,,,224
04342d8b632f0f0c0677c630492843530278ac64,0,Mark Slee,2007-02-20 03:41:35+00:00,['fb84b2b264c833a10192374197b08b805739ea49'],1,1,2,68887,1,,,,224
0e5283914f19fc1442db9b49cda400d1b28ab164,0,Mark Slee,2007-02-20 04:23:26+00:00,['04342d8b632f0f0c0677c630492843530278ac64'],1,0,1,68888,1,0,0,0,224
98e962bf24b7c1758c01a268d494c8e9e62642fe,1,Mark Slee,2007-02-20 18:44:05+00:00,['0e5283914f19fc1442db9b49cda400d1b28ab164'],5,21,26,68914,3,0,1,1,224
3cd75f543cae5fb5728e09340668ebe1885bfcf0,0,Mark Slee,2007-02-20 20:57:36+00:00,['98e962bf24b7c1758c01a268d494c8e9e62642fe'],2,2,4,68918,1,,,,224
f9831084bc213937c3826485b9e8130c6f8baf0c,1,Mark Slee,2007-02-20 20:59:21+00:00,['3cd75f543cae5fb5728e09340668ebe1885bfcf0'],63,358,421,69339,12,0.313253012,0.620481928,0.921686747,226
ecf490e30d03ecd246217457a36a45ffb597e3db,1,Mark Slee,2007-02-21 00:05:18+00:00,['f9831084bc213937c3826485b9e8130c6f8baf0c'],12,30,42,69381,2,0,1,1,226
2c2a648023209222bdc1f547eee28582e1b5be6e,0,Mark Slee,2007-02-21 00:22:33+00:00,['ecf490e30d03ecd246217457a36a45ffb597e3db'],1,1,2,69383,1,,,,226
f3d3363c8e624b6773d173dce1f97104f6e47a9b,1,Mark Slee,2007-02-21 01:39:23+00:00,['2c2a648023209222bdc1f547eee28582e1b5be6e'],1,5,6,69389,1,,,,226
4c948d4b5c2480e32322e7ae7f037a7a7cbc2437,0,Mark Slee,2007-02-21 01:40:05+00:00,['f3d3363c8e624b6773d173dce1f97104f6e47a9b'],10,38,48,69437,1,0,0,1,226
3d42440e420ca1f6871b8ac436e05b10e4c32995,1,Mark Slee,2007-02-21 04:17:34+00:00,['4c948d4b5c2480e32322e7ae7f037a7a7cbc2437'],0,108,108,69545,2,0.236111111,0.527777778,1,227
5e0465738e719ce87ae445843eb42324c482b7b1,1,Mark Slee,2007-02-21 04:17:55+00:00,['3d42440e420ca1f6871b8ac436e05b10e4c32995'],8,18,26,69571,1,0,0,1,227
a9848d761816731a4ac509b379ea807960e74786,1,Mark Slee,2007-02-21 04:54:05+00:00,['5e0465738e719ce87ae445843eb42324c482b7b1'],2,7,9,69580,2,0,0,1,227
b46c0418c716b593fd82b31b96e933e6ba9f1ab1,1,Mark Slee,2007-02-21 04:54:38+00:00,['a9848d761816731a4ac509b379ea807960e74786'],13,47,60,69640,5,1,1,0.789473684,227
e5341192fdd65bd306f1bb46410f09c4674a415f,0,Mark Slee,2007-02-21 04:56:26+00:00,['b46c0418c716b593fd82b31b96e933e6ba9f1ab1'],0,59,59,69699,1,1,1,0.870967742,228
92195ae21929b464a80b25906b80181384e3ae95,1,Mark Slee,2007-02-21 05:16:30+00:00,['e5341192fdd65bd306f1bb46410f09c4674a415f'],5,88,93,69792,4,0.565217391,0.565217391,0.804347826,228
e129a2db0c2f05a209be1e514214aa6b83ba1d91,1,Mark Slee,2007-02-21 05:17:48+00:00,['92195ae21929b464a80b25906b80181384e3ae95'],11,47,58,69850,5,0,0,1,228
b0060b0401b5bcf85aa1523817793956ef5a5219,0,Mark Slee,2007-02-21 05:37:50+00:00,['e129a2db0c2f05a209be1e514214aa6b83ba1d91'],7,19,26,69876,1,0,0.583333333,1,228
e74306a96556748f887628deddec544fe24b7be9,0,Mark Slee,2007-02-21 05:38:12+00:00,['b0060b0401b5bcf85aa1523817793956ef5a5219'],24,25,49,69925,2,,,,228
44e5f0157fae3419899e937720a38fc37759fd46,0,Mark Slee,2007-02-21 05:42:38+00:00,['e74306a96556748f887628deddec544fe24b7be9'],3,0,3,69928,1,,,,228
dac7856db7c26bf2ea7405a736dba94c93652e7a,0,Mark Slee,2007-02-21 07:35:03+00:00,['44e5f0157fae3419899e937720a38fc37759fd46'],0,109,109,70037,3,0.181818182,0.439393939,1,228
1ecb1b053aa5262415c38aa7671a460d20abe674,0,Mark Slee,2007-02-22 01:01:10+00:00,['dac7856db7c26bf2ea7405a736dba94c93652e7a'],40,35,75,70112,3,,,,228
49aea10d7a3f189cceb0459d8a05ef64dd76e23e,1,Aditya Agarwal,2007-02-27 00:07:45+00:00,['1ecb1b053aa5262415c38aa7671a460d20abe674'],1,2,3,70115,1,0,0,1,228
d395d57d3b31d70b6d387dd757cb121df8abda06,0,Mark Slee,2007-02-27 01:16:55+00:00,['49aea10d7a3f189cceb0459d8a05ef64dd76e23e'],2,3,5,70120,3,,,,228
8a98e1bc0f843f503c3f0832ac6d1686f5681a64,1,Mark Slee,2007-02-27 05:16:23+00:00,['d395d57d3b31d70b6d387dd757cb121df8abda06'],4,417,421,70541,6,0.523622047,1,0.897637795,230
a2c760b7928bc72c2770275d9431742e48c55f6d,0,Mark Slee,2007-02-27 05:18:07+00:00,['8a98e1bc0f843f503c3f0832ac6d1686f5681a64'],1,1,2,70543,1,,,,230
4401814d3a4ea2ef02215073d74e9ec4b946afab,0,Mark Slee,2007-02-27 19:03:01+00:00,['a2c760b7928bc72c2770275d9431742e48c55f6d'],25,29,54,70597,2,0,1,1,230
2a22a88c5761620b41fded977c5d68abff49a12c,0,Mark Slee,2007-02-27 19:53:38+00:00,['4401814d3a4ea2ef02215073d74e9ec4b946afab'],70,80,150,70747,2,1,0,0.636363636,230
bd8b991fa740def63b74a6b54ab746b59c7b3d89,1,Mark Slee,2007-02-27 20:17:00+00:00,['2a22a88c5761620b41fded977c5d68abff49a12c'],1,52,53,70800,2,1,1,0.777777778,231
0af62d181c30a2758191055b32baeb5156ceef57,0,Mark Slee,2007-02-27 22:11:09+00:00,['bd8b991fa740def63b74a6b54ab746b59c7b3d89'],1,1,2,70802,1,,,,231
7a49888fc6990ec7485e3804a1958db7cbe70b07,0,Mark Slee,2007-02-27 22:11:39+00:00,['0af62d181c30a2758191055b32baeb5156ceef57'],8,25,33,70835,1,0,0,1,231
57cc25e2a348bd8fe844b39321207226181e62c3,0,Mark Slee,2007-02-28 21:43:54+00:00,['7a49888fc6990ec7485e3804a1958db7cbe70b07'],64,277,341,71176,19,,,,241
9f0c65153c6c0100071029c27b20db62bf98ffa4,0,Mark Slee,2007-02-28 23:58:26+00:00,['57cc25e2a348bd8fe844b39321207226181e62c3'],0,282,282,71458,47,,,,241
7eb0d635428cc24b8394fcacc2c8d0093e32e5ea,0,Mark Slee,2007-03-01 00:00:27+00:00,['9f0c65153c6c0100071029c27b20db62bf98ffa4'],0,168,168,71626,28,,,,241
89e2bb84e2ceb690c1d8abc1b6641e16ee73a19a,0,Mark Slee,2007-03-01 00:20:36+00:00,['7eb0d635428cc24b8394fcacc2c8d0093e32e5ea'],3,99,102,71728,12,,,,241
4902c0563f632f8fa955c6ea16a0f9dafc08291f,0,Mark Slee,2007-03-01 00:31:30+00:00,['89e2bb84e2ceb690c1d8abc1b6641e16ee73a19a'],1,100,101,71829,9,,,,241
43df5c5b8a942f59b28c04e7091e4db0a39bd1e3,0,Mark Slee,2007-03-01 00:34:42+00:00,['4902c0563f632f8fa955c6ea16a0f9dafc08291f'],0,60,60,71889,6,,,,241
fb40c190caaccaa9ba56172092d49c455f23f51c,0,Mark Slee,2007-03-01 00:35:54+00:00,['43df5c5b8a942f59b28c04e7091e4db0a39bd1e3'],0,8,8,71897,1,,,,241
adde9687c6b09af70a65c88764fd1ee3422d9163,0,Mark Slee,2007-03-01 00:37:56+00:00,['fb40c190caaccaa9ba56172092d49c455f23f51c'],1,1,2,71899,1,,,,241
7c10eaf35c200b46e26b9165be088b6a5d7dd791,1,Mark Slee,2007-03-01 02:45:10+00:00,['adde9687c6b09af70a65c88764fd1ee3422d9163'],11,33,44,71943,2,0.444444444,0,1,241
6e3f637bab9bb19621382047d413100fe6c44e0a,1,Mark Slee,2007-03-01 22:05:46+00:00,['7c10eaf35c200b46e26b9165be088b6a5d7dd791'],8,45,53,71996,6,0.346153846,0.346153846,0.846153846,241
a5a783f9534dc8a5bdd11d8da1472091859bc79b,1,Mark Slee,2007-03-02 19:41:08+00:00,['6e3f637bab9bb19621382047d413100fe6c44e0a'],29,108,137,72133,8,0.173076923,0,0.980769231,241
4e441e296c1c525d404e882057adda0691a9b594,0,Mark Slee,2007-03-02 21:23:30+00:00,['a5a783f9534dc8a5bdd11d8da1472091859bc79b'],4,4,8,72141,1,1,1,0,241
b32f3c6ad76536e6a8e334064fb09f8c6ddebb9e,1,Mark Slee,2007-03-05 04:48:48+00:00,['4e441e296c1c525d404e882057adda0691a9b594'],0,161,161,72302,3,0.578947368,1,1,244
c416a2730da7979933133c825dd576fee075436a,1,Mark Slee,2007-03-05 05:40:37+00:00,['b32f3c6ad76536e6a8e334064fb09f8c6ddebb9e'],11,62,73,72375,4,0.217391304,1,1,245
4841b2d51f8472ab4ce476790f38b525b098f22e,0,Mark Slee,2007-03-05 05:41:04+00:00,['c416a2730da7979933133c825dd576fee075436a'],1,1,2,72377,1,,,,245
c2c82c97f40e0c0eb52db001c28ce1acae8fa69e,0,Mark Slee,2007-03-05 05:45:51+00:00,['4841b2d51f8472ab4ce476790f38b525b098f22e'],4,4,8,72385,1,,,,245
3303f360818aa39fc197f1f73ce3f7d578fbc2b1,1,Mark Slee,2007-03-05 20:09:37+00:00,['c2c82c97f40e0c0eb52db001c28ce1acae8fa69e'],37,80,117,72502,5,0,0,1,245
5d06feab210f1175bc95d2ea435fd59a82b76024,0,Mark Slee,2007-03-05 22:18:18+00:00,['3303f360818aa39fc197f1f73ce3f7d578fbc2b1'],165,52,217,72719,12,,,,246
5ea15f9e3206a4bb903f77d149b9cb8c1c2a392e,1,Mark Slee,2007-03-05 22:55:59+00:00,['5d06feab210f1175bc95d2ea435fd59a82b76024'],181,235,416,73135,25,,,,248
54b7ab9b53d82020b7cb055f11cd895db97a43a4,1,Mark Slee,2007-03-06 00:06:27+00:00,['5ea15f9e3206a4bb903f77d149b9cb8c1c2a392e'],6,199,205,73340,10,,,,254
1d4ce80af87143025b7d830e39d0f86475b980a6,1,Mark Slee,2007-03-07 05:16:16+00:00,['54b7ab9b53d82020b7cb055f11cd895db97a43a4'],18,83,101,73441,2,0.159090909,0.159090909,0.931818182,254
02d1edc6f041b968a0f02d01c767f37eda3fab27,0,Mark Slee,2007-03-07 05:17:25+00:00,['1d4ce80af87143025b7d830e39d0f86475b980a6'],6,17,23,73464,4,1,0,0,254
07a3aab207242ef4ee8a45825e2fbab2bbf57510,1,Mark Slee,2007-03-07 05:45:10+00:00,['02d1edc6f041b968a0f02d01c767f37eda3fab27'],0,705,705,74169,11,0.327777778,0.516666667,0.844444444,265
b6616fc42dd10ecf0bf4cc3a3010dae1b70d9063,0,Mark Slee,2007-03-07 05:46:05+00:00,['07a3aab207242ef4ee8a45825e2fbab2bbf57510'],1,1,2,74171,1,,,,265
227ac2c50e11f3d70ca13d811b044fb9e2a528cc,0,Mark Slee,2007-03-07 05:46:50+00:00,['b6616fc42dd10ecf0bf4cc3a3010dae1b70d9063'],11,53,64,74235,5,0,0.5,1,266
4c91e554185e25d81ca2026070e3f6d7d13ac819,0,Mark Slee,2007-03-08 01:22:46+00:00,['227ac2c50e11f3d70ca13d811b044fb9e2a528cc'],4,4,8,74243,2,,,,266
4265a2c4d9701078d595f8a319621247fa5e3b59,0,Aditya Agarwal,2007-03-08 03:10:29+00:00,['4c91e554185e25d81ca2026070e3f6d7d13ac819'],2,2,4,74247,2,,,,266
561b5368886ced8ac0bca947a2bcdc6d70666206,1,Mark Slee,2007-03-09 19:26:29+00:00,['4265a2c4d9701078d595f8a319621247fa5e3b59'],26,57,83,74330,2,0.483870968,0.483870968,0.967741935,266
0c2dff3f5a69726e98636c091454b9b5e3ab8898,0,Mark Slee,2007-03-09 19:26:57+00:00,['561b5368886ced8ac0bca947a2bcdc6d70666206'],1,15,16,74346,1,0,0,1,266
7679196f1cb6a4b919917aeab065ca86b9b8ad91,1,Mark Slee,2007-03-14 02:47:35+00:00,['0c2dff3f5a69726e98636c091454b9b5e3ab8898'],165,336,501,74847,17,0.621359223,0.689320388,1,266
8109757e6cdf12e08b22dd0f563e1624a60fe0c9,1,Mark Slee,2007-03-14 03:07:00+00:00,['7679196f1cb6a4b919917aeab065ca86b9b8ad91'],1,44,45,74892,2,0,0.96969697,0.96969697,266
6632e0b041e9557105f23beba0a8b09621aa1343,1,Mark Slee,2007-03-14 09:08:38+00:00,['8109757e6cdf12e08b22dd0f563e1624a60fe0c9'],1,1,2,74894,1,,,,266
a7d6c3c142594b3ba2eb294c96b9ee3e48f20b75,0,Martin Kraemer,2007-03-16 02:03:32+00:00,['6632e0b041e9557105f23beba0a8b09621aa1343'],2,2,4,74898,1,,,,266
24b49d30bd5e50849330808457c96ed972dbe25e,1,Mark Slee,2007-03-21 01:24:00+00:00,['a7d6c3c142594b3ba2eb294c96b9ee3e48f20b75'],0,2032,2032,76930,2,,,,268
06af13d3087c9340088b957f25b4617be8e4fb9e,0,Mark Slee,2007-03-21 06:50:52+00:00,['24b49d30bd5e50849330808457c96ed972dbe25e'],0,48,48,76978,1,,,,269
a821cfd39f077e5372260ba1bcf7365754a76167,0,Mark Slee,2007-03-21 06:53:03+00:00,['06af13d3087c9340088b957f25b4617be8e4fb9e'],1,2,3,76981,1,,,,269
be0ae5b1be0dcd1272a351bfb9c21d6466a62240,0,Mark Slee,2007-03-22 02:35:33+00:00,['a821cfd39f077e5372260ba1bcf7365754a76167'],5,6,11,76992,2,0,1,1,269
3e9d177fd2a063a027262735adafc4d256748b1c,1,James Wang,2007-03-27 23:17:34+00:00,['be0ae5b1be0dcd1272a351bfb9c21d6466a62240'],53,634,687,77679,9,0.351428571,0.494285714,0.962857143,272
8f6e207a5ded3c0dd12eca450031ff6f01c406c5,0,James Wang,2007-03-28 00:47:09+00:00,['3e9d177fd2a063a027262735adafc4d256748b1c'],3,3,6,77685,1,,,,272
f1ceb477ea0ce6a5f2938582404b56bd345247e3,0,James Wang,2007-03-28 22:43:57+00:00,['8f6e207a5ded3c0dd12eca450031ff6f01c406c5'],1,1,2,77687,1,,,,272
ac62f948cc0775ea5c9af317f4d301f7f8143e11,0,Martin Kraemer,2007-03-30 18:41:48+00:00,['f1ceb477ea0ce6a5f2938582404b56bd345247e3'],1,1,2,77689,1,1,1,0,272
af524ee5a0b24e0a64c0f555a9280bf221765b61,0,Aditya Agarwal,2007-03-31 08:28:06+00:00,['ac62f948cc0775ea5c9af317f4d301f7f8143e11'],12,24,36,77725,1,,,,272
08719678316cce23a6e2c083855bb2a4db468882,0,Aditya Agarwal,2007-03-31 09:18:29+00:00,['af524ee5a0b24e0a64c0f555a9280bf221765b61'],0,0,0,77725,1,,,,273
adf3e7f0c6127967ab546b8a460131c07de84b2d,0,Aditya Agarwal,2007-03-31 16:56:14+00:00,['08719678316cce23a6e2c083855bb2a4db468882'],0,20,20,77745,2,,,,273
9dc57402b5297a14a53f47658e72fcdab7e99f72,1,Aditya Agarwal,2007-03-31 17:45:12+00:00,['adf3e7f0c6127967ab546b8a460131c07de84b2d'],22,45,67,77812,5,0,0.954545455,1,273
3f234dad0ed5e5eb629e5eaf451672366ce1f89e,1,Aditya Agarwal,2007-04-01 01:19:57+00:00,['9dc57402b5297a14a53f47658e72fcdab7e99f72'],27,22,49,77861,5,0.8,0.2,0,273
10b3bdbb853519b922a0b18ca9f384167b82d035,0,Marc Slemko,2007-04-01 09:14:05+00:00,['3f234dad0ed5e5eb629e5eaf451672366ce1f89e'],7,165,172,78033,1,,,,273
b6b5a9e001071b781a2bd826770ad56165dc08e4,0,Marc Slemko,2007-04-01 20:17:02+00:00,['10b3bdbb853519b922a0b18ca9f384167b82d035'],1,0,1,78034,1,,,,273
c11045ade243dfc9d60a2d231ea7b378540fa65d,1,Mark Slee,2007-04-01 23:14:38+00:00,['b6b5a9e001071b781a2bd826770ad56165dc08e4'],110,115,225,78259,2,,,,273
ba8f8d7953c06e27bac7f569d628a49c27231c73,0,Mark Slee,2007-04-03 00:34:00+00:00,['c11045ade243dfc9d60a2d231ea7b378540fa65d'],2,2,4,78263,1,,,,273
13a0d4a3d6dba9fbbee4b0be189c8188cc055a5f,0,Mark Slee,2007-04-03 03:16:11+00:00,['ba8f8d7953c06e27bac7f569d628a49c27231c73'],4,10,14,78277,1,0,0,1,273
8142b9d122078793b8a2ff8d4510ff03ecd1a5b7,0,Mark Slee,2007-04-03 05:49:12+00:00,['13a0d4a3d6dba9fbbee4b0be189c8188cc055a5f'],2,1,3,78280,2,,,,273
ba35456acfbd00b8e623977dbc9679f6c2e49270,0,Mark Slee,2007-04-03 07:31:51+00:00,['8142b9d122078793b8a2ff8d4510ff03ecd1a5b7'],1,1,2,78282,1,,,,273
afaf27607d24de7f494a7823d38b2c8a31878934,1,Mark Slee,2007-04-03 19:47:04+00:00,['ba35456acfbd00b8e623977dbc9679f6c2e49270'],145,147,292,78574,2,,,,273
09bfd615301dd2af23d6f251f6334a3e149d5b99,0,Mark Slee,2007-04-04 19:56:41+00:00,['afaf27607d24de7f494a7823d38b2c8a31878934'],2,2,4,78578,2,,,,273
82a6c0f2590a6681f122eb9654afc1c967319acb,0,Mark Slee,2007-04-04 21:08:21+00:00,['09bfd615301dd2af23d6f251f6334a3e149d5b99'],16,16,32,78610,6,,,,273
a28d819d1345f9c14adfd0fd2b2b0f8f73fcc9f7,1,Mark Slee,2007-04-04 22:11:17+00:00,['82a6c0f2590a6681f122eb9654afc1c967319acb'],1,39,40,78650,3,1,1,1,274
ff24f74b49efaa25eb443f03d814fd29f4cd664c,0,Mark Slee,2007-04-04 22:13:37+00:00,['a28d819d1345f9c14adfd0fd2b2b0f8f73fcc9f7'],1,1,2,78652,1,,,,274
86efa707480155ab7a9497ae295faad4ef9e973e,0,dweatherford,2007-04-05 00:20:40+00:00,['ff24f74b49efaa25eb443f03d814fd29f4cd664c'],0,4,4,78656,1,,,,274
8c5daa44579038c68abfe563b091d08095b2be0e,0,Aditya Agarwal,2007-04-05 01:17:52+00:00,['86efa707480155ab7a9497ae295faad4ef9e973e'],1,1,2,78658,1,,,,274
2e15e2080438b6d8e8d8bd457fcb172301bcdb18,0,Aditya Agarwal,2007-04-05 01:20:45+00:00,['8c5daa44579038c68abfe563b091d08095b2be0e'],0,0,0,78658,1,,,,274
cb39f08ceda2bedf5b80c3520590aec8917edcbf,1,Mark Slee,2007-04-10 02:30:30+00:00,['2e15e2080438b6d8e8d8bd457fcb172301bcdb18'],0,199,199,78857,5,0.3,0.66,1,279
ec3f32009b0c9b3f2a5004e88752e7f5e9ec0598,1,Mark Slee,2007-04-10 06:15:25+00:00,['cb39f08ceda2bedf5b80c3520590aec8917edcbf'],0,16,16,78873,1,0,0,1,279
b86c4b251e99dde627fdbe74b453cc6bf885d783,0,Mark Slee,2007-04-10 06:44:53+00:00,['ec3f32009b0c9b3f2a5004e88752e7f5e9ec0598'],1,1,2,78875,1,,,,279
c10bba1e1628748c8902e6a465d39ab1285b92aa,1,James Wang,2007-04-10 17:29:06+00:00,['b86c4b251e99dde627fdbe74b453cc6bf885d783'],8,17,25,78900,2,0.8,1,1,279
89b85f87d8b222c72c864b68f6d820d7f4b5daa7,1,Aditya Agarwal,2007-04-10 23:15:04+00:00,['c10bba1e1628748c8902e6a465d39ab1285b92aa'],5,19,24,78924,1,0.333333333,0.333333333,0.666666667,279
8dc76e6a87be426d05331dc3fcbd4c947df04805,0,Aditya Agarwal,2007-04-11 00:13:09+00:00,['89b85f87d8b222c72c864b68f6d820d7f4b5daa7'],1,6,7,78931,1,0,0,1,279
cbc51600eea9c429057349e8f3ac9239479274b0,1,Mark Slee,2007-04-11 08:57:07+00:00,['8dc76e6a87be426d05331dc3fcbd4c947df04805'],0,3,3,78934,1,0,1,1,279
0f2916c3f63e50a6265685be6cdac98f4260785c,0,Mark Slee,2007-04-11 09:16:23+00:00,['cbc51600eea9c429057349e8f3ac9239479274b0'],1,3,4,78938,1,0,0,1,279
4f261c5b23d2eb3b01da4b894a1d5eabc48f6817,1,Mark Slee,2007-04-13 00:33:24+00:00,['0f2916c3f63e50a6265685be6cdac98f4260785c'],26,102,128,79066,7,0,0,0,279
8d725a27385fb33bce8fe50fff77f763617b49d4,1,Mark Slee,2007-04-13 01:57:12+00:00,['4f261c5b23d2eb3b01da4b894a1d5eabc48f6817'],7,58,65,79131,9,0.516129032,0.516129032,0.741935484,279
5f45207ee9774226ef39fa93e6a2100e9e8d8ff5,1,James Wang,2007-04-13 20:10:39+00:00,['8d725a27385fb33bce8fe50fff77f763617b49d4'],17,44,61,79192,3,1,1,1,279
4fd2dbaf0698662ad46bdb4b0a1507f325a0b051,0,James Wang,2007-04-17 22:38:58+00:00,['5f45207ee9774226ef39fa93e6a2100e9e8d8ff5'],0,9,9,79201,1,1,1,1,279
67bfaf27826510e9e1c4b07307633065722879e4,0,peter,2007-05-01 04:03:22+00:00,['4fd2dbaf0698662ad46bdb4b0a1507f325a0b051'],1,1,2,79203,1,,,,279
e9a1edc75df35ec82a22fee5084039ac8d6c2bc2,0,Mark Slee,2007-05-03 01:30:18+00:00,['67bfaf27826510e9e1c4b07307633065722879e4'],1,1,2,79205,1,,,,279
fa6ac9f2aa503922224c14c290206bcc115630ff,0,Mark Slee,2007-05-04 18:49:56+00:00,['e9a1edc75df35ec82a22fee5084039ac8d6c2bc2'],6,15,21,79226,2,0,0.333333333,1,279
3690ee412a245f5287563fe57e5e5d2d66161a9e,0,Mark Slee,2007-05-07 22:54:18+00:00,['fa6ac9f2aa503922224c14c290206bcc115630ff'],1,1,2,79228,1,,,,279
e02e42448611b7c2103ef03b0a5a5a197fd92c1b,1,jsobel,2007-05-08 17:51:49+00:00,['3690ee412a245f5287563fe57e5e5d2d66161a9e'],2,206,208,79436,5,0.442622951,1,1,281
5f68c7161daf70b4f04f0157d8d0b265d729247a,0,Mark Slee,2007-05-11 17:58:54+00:00,['e02e42448611b7c2103ef03b0a5a5a197fd92c1b'],1,3,4,79440,1,0,0,1,281
b5f93b0b3a3c57ce6ff75f37120688276512c869,1,Mark Slee,2007-05-11 23:46:42+00:00,['5f68c7161daf70b4f04f0157d8d0b265d729247a'],0,107,107,79547,1,,,,282
1ea81ce9b08d554a6256611adc5089184692ab71,1,boz,2007-05-14 23:04:33+00:00,['b5f93b0b3a3c57ce6ff75f37120688276512c869'],3,33,36,79583,2,0.625,0.625,0.875,282
8ca2d0910927a781b6181e7177a404e37c09d82d,1,Martin Kraemer,2007-05-15 23:24:30+00:00,['1ea81ce9b08d554a6256611adc5089184692ab71'],0,71,71,79654,1,,,,283
2c44d2047ee4b34ab995cd08c931cb51835ae73d,1,Mark Slee,2007-05-16 02:18:07+00:00,['8ca2d0910927a781b6181e7177a404e37c09d82d'],17,1784,1801,81455,6,0.16797215,0.340295909,0.631853786,285
254ce20e51f61f919c8ff903ad66a72f0e133c99,1,Mark Slee,2007-05-16 02:21:06+00:00,['2c44d2047ee4b34ab995cd08c931cb51835ae73d'],0,1891,1891,83346,11,,,,296
e9ce01cf402fca4c275554847c85aff9fff17dc6,0,Mark Slee,2007-05-16 02:29:53+00:00,['254ce20e51f61f919c8ff903ad66a72f0e133c99'],19,259,278,83624,40,,,,296
bf8215109490924ccf8d6fb92a1c2129ce00fb78,0,Mark Slee,2007-05-16 02:31:53+00:00,['e9ce01cf402fca4c275554847c85aff9fff17dc6'],11,11,22,83646,1,,,,296
3e3d7ad8349e76fcfaf82980e2598ec011b314f6,1,Mark Slee,2007-05-16 02:35:58+00:00,['bf8215109490924ccf8d6fb92a1c2129ce00fb78'],1,336,337,83983,3,,,,298
738ad31baf286e5ef0cd9aa35892c3523a083183,1,Mark Slee,2007-05-16 02:40:12+00:00,['3e3d7ad8349e76fcfaf82980e2598ec011b314f6'],2,65,67,84050,3,,,,299
8168706fe9f076af0e6dd299d8fde628a6a854ec,0,Mark Slee,2007-05-16 02:44:21+00:00,['738ad31baf286e5ef0cd9aa35892c3523a083183'],3,5,8,84058,1,,,,299
468bfe9395c1a680df5c9c37daa7e3876e174491,1,Mark Slee,2007-05-16 02:45:16+00:00,['8168706fe9f076af0e6dd299d8fde628a6a854ec'],1,8,9,84067,1,,,,299
f4f18ec514d42cec7a1368242015db1c3ad9da29,0,Mark Slee,2007-05-16 21:22:34+00:00,['468bfe9395c1a680df5c9c37daa7e3876e174491'],0,1,1,84068,1,,,,299
3a3b53bc6eefa91ea60e5da2b2c91519ca1d9b2e,1,Marc Slemko,2007-05-22 23:59:54+00:00,['f4f18ec514d42cec7a1368242015db1c3ad9da29'],122,425,547,84615,15,0.214723926,0.141104294,0.975460123,299
e04475b5aaa2bba920a2c1b4021a1a447f947dd9,1,Aditya Agarwal,2007-05-23 02:14:58+00:00,['3a3b53bc6eefa91ea60e5da2b2c91519ca1d9b2e'],17,70,87,84702,3,0.375,0.375,1,299
2782d6d205344fc6b02f30c674812bd91bcff2a1,0,Mark Slee,2007-05-23 04:55:30+00:00,['e04475b5aaa2bba920a2c1b4021a1a447f947dd9'],27,27,54,84756,5,,,,299
9b82d275c627b1f4f64b5d3c82d54422fe6b5d5a,1,Mark Slee,2007-05-23 05:16:07+00:00,['2782d6d205344fc6b02f30c674812bd91bcff2a1'],65,71,136,84892,17,1,1,1,299
448849deede56f011dae0049e7b5bb142271eaf6,1,Mark Slee,2007-05-31 01:30:22+00:00,['9b82d275c627b1f4f64b5d3c82d54422fe6b5d5a'],16,81,97,84989,4,0.923076923,0.923076923,0.288461538,299
7859a579db3d0a4d2d4ca62993ee98e90dc9d617,0,Aditya Agarwal,2007-05-31 01:33:07+00:00,['448849deede56f011dae0049e7b5bb142271eaf6'],1,10,11,85000,1,0,0,1,299
7a2fb142f12a68aa661100bd9c7ce8d6f0775c85,0,Mark Slee,2007-05-31 02:30:34+00:00,['7859a579db3d0a4d2d4ca62993ee98e90dc9d617'],0,119,119,85119,1,,,,300
f83c9dbf6ffdcd7c2fa833b243211822ba521e16,1,boz,2007-05-31 23:38:37+00:00,['7a2fb142f12a68aa661100bd9c7ce8d6f0775c85'],1,1,2,85121,1,,,,300
5e707a6cd9aa9c3de9b3eddb83307a8268449f58,0,Mark Slee,2007-06-01 23:04:09+00:00,['f83c9dbf6ffdcd7c2fa833b243211822ba521e16'],0,26,26,85147,1,1,1,1,301
67606e5d7207874d003bc9ba433edd66d74662f0,1,Marc Slemko,2007-06-04 21:01:19+00:00,['5e707a6cd9aa9c3de9b3eddb83307a8268449f58'],39,85,124,85271,4,0.181818182,0,0.954545455,301
a647903dd2edaa8cf846fe9dac4df82cf74740a0,1,Marc Slemko,2007-06-05 22:20:14+00:00,['67606e5d7207874d003bc9ba433edd66d74662f0'],49,140,189,85460,7,0.404761905,0.904761905,1,301
6ded775196d10f86ac5b99843f018aa2b29772b8,1,boz,2007-06-05 22:41:18+00:00,['a647903dd2edaa8cf846fe9dac4df82cf74740a0'],55,75,130,85590,8,1,1,1,301
e02385b0b4e84aed0e456cb697a471c211705eba,1,Mark Slee,2007-06-09 01:21:16+00:00,['6ded775196d10f86ac5b99843f018aa2b29772b8'],40,659,699,86289,5,0.254742547,0.306233062,0.918699187,302
1d2ead34a23602a1dd248648204bbbeea356bc0c,0,Mark Slee,2007-06-09 01:23:04+00:00,['e02385b0b4e84aed0e456cb697a471c211705eba'],0,10,10,86299,1,,,,302
447d7d236590db3dad60dc10eed72274a5b66edf,1,eletuchy,2007-06-13 04:24:11+00:00,['1d2ead34a23602a1dd248648204bbbeea356bc0c'],9,12,21,86320,1,0,0,0,302
8eceaeacfb084dd603c4d0fe07cc26066ca70abe,0,Mark Slee,2007-06-15 01:43:21+00:00,['447d7d236590db3dad60dc10eed72274a5b66edf'],1,2,3,86323,1,1,1,1,302
3e5d2d72b4f48e2008462fbb9ac86f76011ceb91,0,Mark Slee,2007-06-15 01:45:56+00:00,['8eceaeacfb084dd603c4d0fe07cc26066ca70abe'],82,75,157,86480,2,0,0,0,302
589859984f43af1ed0f9ee45ce8374a0d1640813,0,dweatherford,2007-06-19 23:10:19+00:00,['3e5d2d72b4f48e2008462fbb9ac86f76011ceb91'],3,25,28,86508,2,0,0.769230769,0.692307692,302
808454ec634278eec7e0ee5c523b00e3e4257287,1,Mark Slee,2007-06-20 21:51:57+00:00,['589859984f43af1ed0f9ee45ce8374a0d1640813'],90,319,409,86917,14,0.324503311,1,0.410596026,302
552410c037c323085e075bd4b0f268ee941083b8,0,Mark Slee,2007-06-22 01:03:55+00:00,['808454ec634278eec7e0ee5c523b00e3e4257287'],3,3,6,86923,1,,,,302
a9294a9522bb6045f468b04abfee648b71c9b99b,0,Mark Slee,2007-06-22 19:43:12+00:00,['552410c037c323085e075bd4b0f268ee941083b8'],0,1,1,86924,1,0,1,1,302
0e1100c9215d1bc58ca6c01fae80439764b50e58,0,Mark Slee,2007-06-23 00:08:13+00:00,['a9294a9522bb6045f468b04abfee648b71c9b99b'],1,1,2,86926,1,,,,302
66ccee2a7489a26d58197f75c0136eebdb345dff,0,eletuchy,2007-06-25 18:29:28+00:00,['0e1100c9215d1bc58ca6c01fae80439764b50e58'],1,10,11,86937,1,1,1,1,302
58500e976364aea0df156a08b6c0336f6da26cd1,0,Aditya Agarwal,2007-06-26 02:57:04+00:00,['66ccee2a7489a26d58197f75c0136eebdb345dff'],2,2,4,86941,1,,,,302
82883299ef730cd2badf11ba4225de47709392e1,0,Mark Slee,2007-06-26 20:19:56+00:00,['58500e976364aea0df156a08b6c0336f6da26cd1'],117,0,117,87058,1,,,,302
d795b9d3fdd78c9ec22e8487af9b52087853c085,0,Christopher Piro,2007-06-28 01:09:22+00:00,['82883299ef730cd2badf11ba4225de47709392e1'],1,1,2,87060,1,,,,302
2f5afceeaa2050ce3cca477288729c30622a1d38,0,Christopher Piro,2007-06-29 07:17:33+00:00,['d795b9d3fdd78c9ec22e8487af9b52087853c085'],2,2656,2658,89718,29,0.212746017,0.443298969,0.691658857,329
4d73d5c5cb31ca7d4c24b2d3d113903ea5ec8412,0,Mark Slee,2007-06-29 23:15:00+00:00,['2f5afceeaa2050ce3cca477288729c30622a1d38'],0,185,185,89903,1,1,1,0.775510204,330
477a580aa40c871e5b211a9a53108852969f2895,1,Mark Slee,2007-06-30 01:18:12+00:00,['4d73d5c5cb31ca7d4c24b2d3d113903ea5ec8412'],0,96,96,89999,3,1,1,1,331
7ef673345bcac6284067280a1e8e1c49fbc2c9b9,0,Christopher Piro,2007-07-02 06:35:10+00:00,['477a580aa40c871e5b211a9a53108852969f2895'],2,2,4,90003,1,,,,331
756b1d1b071157677980f6b5735b7e8a3ac44419,0,Mark Slee,2007-07-06 00:30:21+00:00,['7ef673345bcac6284067280a1e8e1c49fbc2c9b9'],5,16,21,90024,3,0.2,0.6,0,331
58dfb4fbe82c346814c2e4f33b6045468bfd68c6,1,Mark Slee,2007-07-06 02:45:25+00:00,['756b1d1b071157677980f6b5735b7e8a3ac44419'],770,478,1248,91272,13,1,1,1,331
f79031e87531464b84d911acf9aee57cac8b83d8,0,David Reiss,2007-07-06 21:43:48+00:00,['58dfb4fbe82c346814c2e4f33b6045468bfd68c6'],22,27,49,91321,2,0.714285714,1,0.428571429,331
22974602532c9d1e1dacb5d0f873667a237b0981,1,Mark Slee,2007-07-06 22:20:19+00:00,['f79031e87531464b84d911acf9aee57cac8b83d8'],4,18,22,91343,1,1,1,1,331
cce8184d997b37a2da1b885125b43bcda103fa76,1,boz,2007-07-06 22:27:52+00:00,['22974602532c9d1e1dacb5d0f873667a237b0981'],3,73,76,91419,2,1,1,1,331
6d56eb9d651a72a1fe10b7829e569a7ac12afb20,1,Mark Slee,2007-07-06 22:28:15+00:00,['cce8184d997b37a2da1b885125b43bcda103fa76'],53,102,155,91574,4,0,0,1,331
e6c4fa671e63f9bfcc443d3fb5802e886f237c9a,0,Martin Kraemer,2007-07-09 19:08:25+00:00,['6d56eb9d651a72a1fe10b7829e569a7ac12afb20'],12,36,48,91622,2,0.090909091,0.090909091,1,331
85287d3989359231026807bac52364cbe49b8d84,0,Mark Slee,2007-07-09 19:50:30+00:00,['e6c4fa671e63f9bfcc443d3fb5802e886f237c9a'],1,5,6,91628,2,0,0,1,331
abc12e5ca5ca6bd1fb9e744fea20e2508227b3c1,0,peterm,2007-07-10 00:08:20+00:00,['85287d3989359231026807bac52364cbe49b8d84'],0,0,0,91628,1,,,,332
d093e7c32aa8f99b5696603fdd39ceeeebbdc150,0,peterm,2007-07-10 00:22:20+00:00,['abc12e5ca5ca6bd1fb9e744fea20e2508227b3c1'],0,0,0,91628,1,,,,332
8b82fb7a757f54659c88f294a217613a9fea59ca,0,Mark Slee,2007-07-10 00:49:04+00:00,['d093e7c32aa8f99b5696603fdd39ceeeebbdc150'],1,0,1,91629,1,0,0,0,332
b1ad0141d4df4b4488882880a6d9d4aa84f3b178,0,Mark Slee,2007-07-10 16:48:37+00:00,['8b82fb7a757f54659c88f294a217613a9fea59ca'],1,30,31,91660,2,0,0,1,332
a36f5db4b323adbcd13cd298ab73eee2be6200f2,0,yunfang,2007-07-14 01:23:05+00:00,['b1ad0141d4df4b4488882880a6d9d4aa84f3b178'],0,16,16,91676,1,1,1,1,332
9a41a0c51ea322c3950ddc0cbbcc04fa3f135f1c,1,iproctor,2007-07-16 21:59:24+00:00,['a36f5db4b323adbcd13cd298ab73eee2be6200f2'],5,3761,3766,95442,22,0.11295972,0.425569177,0.805604203,350
094823a46c4dd2449ec4ec9458b8358f8abd3dbe,0,Christopher Piro,2007-07-18 00:26:12+00:00,['9a41a0c51ea322c3950ddc0cbbcc04fa3f135f1c'],825,12493,13318,108760,133,1,0,1,458
8639e1056d6db52d53ff579f0f8d4728b702740e,0,David Reiss,2007-07-21 00:23:32+00:00,['094823a46c4dd2449ec4ec9458b8358f8abd3dbe'],1,1,2,108762,1,,,,458
00dcccfef251bb99836760eb31b2522608c23418,1,David Reiss,2007-07-21 01:18:10+00:00,['8639e1056d6db52d53ff579f0f8d4728b702740e'],0,790,790,109552,7,0.602739726,0.792237443,0.894977169,463
d51643cbf99f57f1945eaedb30bde8efa714c7ac,0,James Wang,2007-07-22 05:48:12+00:00,['00dcccfef251bb99836760eb31b2522608c23418'],3,1,4,109556,1,,,,463
e9cd65557916236ff4e29bcffdd33751190d55c9,0,James Wang,2007-07-23 17:35:32+00:00,['d51643cbf99f57f1945eaedb30bde8efa714c7ac'],1,4,5,109561,1,1,1,1,463
ae1f10f8f296f0e19229994e2ef58569754c66f6,0,Christopher Piro,2007-07-24 04:30:15+00:00,['e9cd65557916236ff4e29bcffdd33751190d55c9'],269,188,457,110018,3,1,1,0,463
873726035af15c467770ca56a99f90f3f0ffd5a6,0,Christopher Piro,2007-07-24 06:20:47+00:00,['ae1f10f8f296f0e19229994e2ef58569754c66f6'],0,4,4,110022,1,0,1,1,463
d4de1e93c653c048f54944b331f8350dc45b81c0,1,iproctor,2007-07-24 19:47:55+00:00,['873726035af15c467770ca56a99f90f3f0ffd5a6'],9,25,34,110056,2,,,,463
e168d5e12707fa4311b44e38eb769083b4a8c964,0,James Wang,2007-07-24 23:59:51+00:00,['d4de1e93c653c048f54944b331f8350dc45b81c0'],0,2,2,110058,1,1,1,1,463
5ced286cec268191c72125440ac911582f84a6b9,0,iproctor,2007-07-25 18:50:50+00:00,['e168d5e12707fa4311b44e38eb769083b4a8c964'],19,19,38,110096,1,,,,463
ff8eb9288d57845319b65f1bfd3d4a13cecc3217,1,iproctor,2007-07-25 19:06:13+00:00,['5ced286cec268191c72125440ac911582f84a6b9'],4,2084,2088,112184,15,0.101694915,0.379860419,0.83449651,476
5f5fdf3a20f2459eabbee771e6eff4159c6f2bca,0,Christopher Piro,2007-07-25 22:41:00+00:00,['ff8eb9288d57845319b65f1bfd3d4a13cecc3217'],193,238,431,112615,6,0,1,0.511111111,477
96d2388ade7af4f23d2c95b92496b79ec0321133,0,David Reiss,2007-07-26 21:10:32+00:00,['5f5fdf3a20f2459eabbee771e6eff4159c6f2bca'],117,121,238,112853,13,0,1,1,477
877237abcf93e7bd7bc9a7d095d3a850c309817e,0,David Reiss,2007-07-27 00:40:19+00:00,['96d2388ade7af4f23d2c95b92496b79ec0321133'],2,6,8,112861,1,0,0,1,477
5b4181919de0245098b481ea2ed5ecd1e7a0d83f,0,Aditya Agarwal,2007-07-27 07:04:49+00:00,['877237abcf93e7bd7bc9a7d095d3a850c309817e'],2,0,2,112863,1,0,0,0,477
26549566bc502dece76ad596126b219dc5c8991c,0,Mark Slee,2007-07-27 18:56:56+00:00,['5b4181919de0245098b481ea2ed5ecd1e7a0d83f'],1,1,2,112865,1,,,,477
a46438e11d506433ec7c995ad7d11003ca7d87de,0,pfung,2007-07-27 20:43:49+00:00,['26549566bc502dece76ad596126b219dc5c8991c'],2,2,4,112869,1,,,,477
d0767c579673c868d1ae15e5979a9301ac1347d7,1,Mark Slee,2007-07-27 22:14:41+00:00,['a46438e11d506433ec7c995ad7d11003ca7d87de'],9,48,57,112926,4,1,1,1,477
1ac05803788fb15bcf16e48cdd53b550b3bc5515,1,David Reiss,2007-07-30 22:00:27+00:00,['d0767c579673c868d1ae15e5979a9301ac1347d7'],24,273,297,113223,5,0.091743119,0.091743119,1,477
c2532a9ac4168778c581cff235943eb270df6dbc,0,David Reiss,2007-07-30 23:46:11+00:00,['1ac05803788fb15bcf16e48cdd53b550b3bc5515'],3,31,34,113257,5,1,1,1,477
0dd0916f9a519f9664c416d9d6b6885560299b1f,1,Aditya Agarwal,2007-07-30 23:58:37+00:00,['c2532a9ac4168778c581cff235943eb270df6dbc'],0,34,34,113291,1,1,1,1,477
99e2c07815c927f319c19e01f9a0d3a2f34b807c,0,Aditya Agarwal,2007-07-31 01:36:08+00:00,['0dd0916f9a519f9664c416d9d6b6885560299b1f'],1,3,4,113295,1,,,,477
5b3a8f7a8b1f428ef103f5e9a9de13bcae1618c4,0,Christopher Piro,2007-08-01 22:27:37+00:00,['99e2c07815c927f319c19e01f9a0d3a2f34b807c'],213,606,819,114114,18,0,0,1,480
c3c6c0c9c4dc77c6b2b7dce952eeb2fe69513a40,0,Christopher Piro,2007-08-01 23:42:12+00:00,['5b3a8f7a8b1f428ef103f5e9a9de13bcae1618c4'],5,10,15,114129,2,,,,480
80cdca7344fba98dcda6bcc694a1419cb2dc60a6,0,Aditya Agarwal,2007-08-02 06:26:11+00:00,['c3c6c0c9c4dc77c6b2b7dce952eeb2fe69513a40'],1,1,2,114131,1,,,,480
17496a04d61a5ed0dbece2d5067135871a526da4,1,Mark Slee,2007-08-02 06:37:40+00:00,['80cdca7344fba98dcda6bcc694a1419cb2dc60a6'],7,2,9,114140,2,,,,480
ee5988444f49bb2564bf50e7bf470c4c7c33cdd6,0,Christopher Piro,2007-08-03 23:34:55+00:00,['17496a04d61a5ed0dbece2d5067135871a526da4'],10,22,32,114172,3,,,,480
8dae994f8f4abca87c3e9cbb73d1863d4883dda7,0,David Reiss,2007-08-06 20:32:59+00:00,['ee5988444f49bb2564bf50e7bf470c4c7c33cdd6'],1,3,4,114176,1,0,1,1,480
6f226558d605ab7525d5410a5f4c2feb09594081,0,David Reiss,2007-08-06 20:33:00+00:00,['8dae994f8f4abca87c3e9cbb73d1863d4883dda7'],1,1,2,114178,1,,,,480
202111d2e9cb351ac77929f573569625a3937308,1,David Reiss,2007-08-06 20:38:18+00:00,['6f226558d605ab7525d5410a5f4c2feb09594081'],3,11,14,114192,2,0,1,1,480
6148175aea790e2e009e4605917967dfd5e58158,0,David Reiss,2007-08-06 20:56:30+00:00,['202111d2e9cb351ac77929f573569625a3937308'],0,2,2,114194,1,,,,480
7897c927b23554daf862ac7c5eca1d4f369a292d,1,iproctor,2007-08-08 01:43:39+00:00,['6148175aea790e2e009e4605917967dfd5e58158'],35,81,116,114310,9,,,,482
7e2cda13166e5cc27f37c55647b4070f5df178a5,0,Mark Slee,2007-08-09 03:39:18+00:00,['7897c927b23554daf862ac7c5eca1d4f369a292d'],36,36,72,114382,1,0,0,0,482
7dafc94e50081abbcde4602cf84863fdfbf9c269,0,Mark Slee,2007-08-09 03:40:15+00:00,['7e2cda13166e5cc27f37c55647b4070f5df178a5'],2,2,4,114386,2,,,,482
e470aa38f548f80b0d8f924b17bc7f8eb93b1421,1,iproctor,2007-08-10 20:48:12+00:00,['7dafc94e50081abbcde4602cf84863fdfbf9c269'],56,72,128,114514,8,,,,482
fa0c85737036e53728aab46dcda242d113f926be,0,Christopher Piro,2007-08-11 01:15:57+00:00,['e470aa38f548f80b0d8f924b17bc7f8eb93b1421'],2,23,25,114539,1,,,,482
cdffe260f1c8d21dbd3b6904e6ca596c7f4c6b06,0,David Reiss,2007-08-14 17:12:31+00:00,['fa0c85737036e53728aab46dcda242d113f926be'],38,80,118,114657,4,0,0,1,482
cbd4bacc307c0103aa07d5bbc2104e14b8a29aac,1,David Reiss,2007-08-14 17:12:33+00:00,['cdffe260f1c8d21dbd3b6904e6ca596c7f4c6b06'],35,82,117,114774,7,1,1,1,482
8320a92d9b07f8dc5f7d9f0517a28bec64ce20e2,1,David Reiss,2007-08-14 19:59:26+00:00,['cbd4bacc307c0103aa07d5bbc2104e14b8a29aac'],27,426,453,115227,8,0.054054054,0.45045045,0.711711712,484
3429b6a9a046bbc4bd6e476467aca89ce7317cc2,1,David Reiss,2007-08-15 00:55:41+00:00,['8320a92d9b07f8dc5f7d9f0517a28bec64ce20e2'],4,12,16,115243,2,1,1,1,484
5362e70f8f3c58f0f1fc67ea0a8fc299c554e1bc,1,boz,2007-08-15 20:55:36+00:00,['3429b6a9a046bbc4bd6e476467aca89ce7317cc2'],0,5,5,115248,2,1,1,1,484
1b65b724eb7ed096c9204683ac5f441d7d7e9c02,0,Mark Slee,2007-08-16 00:27:21+00:00,['5362e70f8f3c58f0f1fc67ea0a8fc299c554e1bc'],8,27,35,115283,1,0,0,1,484
27ed6ec1f9ca50f2447b80dfeeabfd54da35f4db,1,Mark Slee,2007-08-16 01:26:31+00:00,['1b65b724eb7ed096c9204683ac5f441d7d7e9c02'],96,113,209,115492,12,0,1,1,484
937fa6258bc4f9509dbaf914108cf2d381c8f741,0,Mark Slee,2007-08-17 03:53:13+00:00,['27ed6ec1f9ca50f2447b80dfeeabfd54da35f4db'],1,1,2,115494,1,,,,484
94112d699411fcca2bde9721da46ddcd4c15a5bf,0,iproctor,2007-08-17 21:34:15+00:00,['937fa6258bc4f9509dbaf914108cf2d381c8f741'],3,6,9,115503,1,,,,484
1ec47d4395be54319598aa5cd74ee8d44246b335,0,yunfang,2007-08-19 22:18:38+00:00,['94112d699411fcca2bde9721da46ddcd4c15a5bf'],3,62,65,115568,1,1,1,1,484
04f0b7b21b4902f356809fced858de8d00bae1b6,0,Mark Slee,2007-08-21 01:54:36+00:00,['1ec47d4395be54319598aa5cd74ee8d44246b335'],2,2,4,115572,1,,,,484
98439158db96e682467f87b0d6533896db9ae72a,1,Mark Slee,2007-08-21 02:39:40+00:00,['04f0b7b21b4902f356809fced858de8d00bae1b6'],2,6,8,115580,1,1,1,1,484
dd56497a7c97f07c8d97b9c7323652fb2b7154e0,0,Mark Slee,2007-08-21 02:39:57+00:00,['98439158db96e682467f87b0d6533896db9ae72a'],1,3,4,115584,2,,,,484
2dc72c3864e76d9eb14c1f83def63fa2351f4fb2,1,David Reiss,2007-08-21 23:59:34+00:00,['dd56497a7c97f07c8d97b9c7323652fb2b7154e0'],98,175,273,115857,7,0.192307692,1,0.480769231,485
95aaaf1852dd245e106a5879eb5b9baba32ce5a8,0,David Reiss,2007-08-22 02:32:11+00:00,['2dc72c3864e76d9eb14c1f83def63fa2351f4fb2'],1,1,2,115859,1,,,,485
bc3dddb91c1e26ecfa290c10f9a5950adc8dedd1,1,David Reiss,2007-08-22 23:20:24+00:00,['95aaaf1852dd245e106a5879eb5b9baba32ce5a8'],70,112,182,116041,8,1,1,0,486
25b5ee3285d9230fcda9ec30ca99db306906ae89,0,David Reiss,2007-08-23 00:14:48+00:00,['bc3dddb91c1e26ecfa290c10f9a5950adc8dedd1'],1,12,13,116054,2,0,1,1,486
402ee28f87dd855d8825182b79617891a7ac4b93,1,Mark Slee,2007-08-23 01:43:20+00:00,['25b5ee3285d9230fcda9ec30ca99db306906ae89'],2,20,22,116076,2,0.428571429,0,1,486
d4a269cdb5ecf62e91384e33cdb6bf887f69e9a9,0,David Reiss,2007-08-23 02:37:19+00:00,['402ee28f87dd855d8825182b79617891a7ac4b93'],3,5,8,116084,3,,,,486
a41c8705db8f09227e22c04bbb98ca046c819ca9,0,David Reiss,2007-08-23 17:20:38+00:00,['d4a269cdb5ecf62e91384e33cdb6bf887f69e9a9'],1,1,2,116086,1,,,,486
e087a305857d04e2772e928b6df4d83fbab5b8d5,0,David Reiss,2007-08-23 21:43:25+00:00,['a41c8705db8f09227e22c04bbb98ca046c819ca9'],170,79,249,116335,12,0.894308943,0.975609756,0.577235772,487
cf3c124f29346f26be9d707ef11d30563a45f43b,0,Mark Slee,2007-08-23 23:19:56+00:00,['e087a305857d04e2772e928b6df4d83fbab5b8d5'],2,2,4,116339,1,,,,487
3f808ab33787044e149fb25d1c6c6c18811afde9,0,David Reiss,2007-08-24 00:19:12+00:00,['cf3c124f29346f26be9d707ef11d30563a45f43b'],1,1,2,116341,1,,,,487
40c6ac574c0090900736da744ef8cb72340b6c07,0,Mark Slee,2007-08-24 19:24:10+00:00,['3f808ab33787044e149fb25d1c6c6c18811afde9'],1,1,2,116343,1,,,,487
382fc3043cba33fea1a919e4e6bfeac0cb9c22aa,1,David Reiss,2007-08-25 18:01:30+00:00,['40c6ac574c0090900736da744ef8cb72340b6c07'],65,1651,1716,118059,9,0.198901099,0.31978022,0.48021978,489
5ec8e26d25dc459041e7c31aa2c65eff4f70ad4e,1,David Reiss,2007-08-26 02:21:24+00:00,['382fc3043cba33fea1a919e4e6bfeac0cb9c22aa'],0,5,5,118064,1,,,,489
2375312fa05e1560f0fc83c642dcb2535d9d2eba,1,David Reiss,2007-08-27 19:57:34+00:00,['5ec8e26d25dc459041e7c31aa2c65eff4f70ad4e'],5,1060,1065,119129,11,0.196374622,0.318731118,0.954682779,494
18bf22d5ba896026b5b2ba500f84b003e343c3b1,1,David Reiss,2007-08-28 20:49:17+00:00,['2375312fa05e1560f0fc83c642dcb2535d9d2eba'],3,575,578,119707,15,0.589285714,0.903571429,0.717857143,496
dd7796fd8b99d41f09660cbad22826f5573f15fd,1,David Reiss,2007-08-28 21:09:06+00:00,['18bf22d5ba896026b5b2ba500f84b003e343c3b1'],45,52,97,119804,12,1,1,1,496
1746e30c913d76681ad5ec788cd5ab82f67ecbd0,0,David Reiss,2007-08-28 22:18:22+00:00,['dd7796fd8b99d41f09660cbad22826f5573f15fd'],12,39,51,119855,2,0.055555556,1,0.055555556,496
1ac120f1598a5bc8c9077448a3191c440be82b1d,0,David Reiss,2007-08-29 00:58:14+00:00,['1746e30c913d76681ad5ec788cd5ab82f67ecbd0'],3,43,46,119901,7,,,,500
a0f8bdca952a521d27ec848026dc7631fbb8abac,0,Mark Slee,2007-08-29 04:36:28+00:00,['1ac120f1598a5bc8c9077448a3191c440be82b1d'],2,30,32,119933,1,0,0,0,500
6868eae42a889f002da365bd1bf538dae748ace9,0,Mark Slee,2007-08-29 04:36:53+00:00,['a0f8bdca952a521d27ec848026dc7631fbb8abac'],0,4,4,119937,1,,,,500
aea19c9d65a7a70770fbcc25a81579575382c40d,0,David Reiss,2007-08-29 23:17:32+00:00,['6868eae42a889f002da365bd1bf538dae748ace9'],2,10,12,119949,2,,,,500
c6fc329a4040f9945576bc7007ab8df44d112635,1,David Reiss,2007-08-30 00:58:43+00:00,['aea19c9d65a7a70770fbcc25a81579575382c40d'],13,84,97,120046,10,0.433333333,1,1,503
792df0bf78d061ede0af7f12bf92c72254ed12d8,0,David Reiss,2007-08-30 03:30:22+00:00,['c6fc329a4040f9945576bc7007ab8df44d112635'],2,591,593,120639,10,0.308823529,0.448529412,1,507
5db3e926713d6fba0e9d0348d29b58bb8ec29367,1,David Reiss,2007-08-30 23:07:45+00:00,['792df0bf78d061ede0af7f12bf92c72254ed12d8'],23,48,71,120710,4,0.75,0,0.833333333,507
9885c6801dbd3b49591ea69544fdb03b1ce43642,1,David Reiss,2007-08-30 23:12:37+00:00,['5db3e926713d6fba0e9d0348d29b58bb8ec29367'],59,85,144,120854,6,1,1,1,507
6ce97e3d8d3365da4b7c9bcc280ea458449becd5,0,David Reiss,2007-08-30 23:18:31+00:00,['9885c6801dbd3b49591ea69544fdb03b1ce43642'],5,2,7,120861,2,,,,507
01a9f8845d38cd32694d91b35d7a844c3646e3c3,1,Mark Slee,2007-08-31 00:55:28+00:00,['6ce97e3d8d3365da4b7c9bcc280ea458449becd5'],11,143,154,121015,3,0.00952381,0.028571429,0.923809524,507
d779cbe48c1335169cb87ed8977e293247b1434a,1,David Reiss,2007-08-31 01:42:55+00:00,['01a9f8845d38cd32694d91b35d7a844c3646e3c3'],76,409,485,121500,6,0.17037037,0.377777778,0.296296296,509
f150f1aed51d48c36b05cf92f7a7dedb9c9cfeb7,0,Mark Slee,2007-08-31 04:30:52+00:00,['d779cbe48c1335169cb87ed8977e293247b1434a'],2,5,7,121507,1,0,0,0,509
8b6c2ebf42b6ed4e2c9fced2e29a31483d9ac840,0,Aditya Agarwal,2007-08-31 07:54:40+00:00,['f150f1aed51d48c36b05cf92f7a7dedb9c9cfeb7'],0,5,5,121512,1,0,0,1,509
000b111922ccb9c53390bd8e337ae9d48fc80268,0,Aditya Agarwal,2007-08-31 08:03:05+00:00,['8b6c2ebf42b6ed4e2c9fced2e29a31483d9ac840'],3,9,12,121524,1,,,,509
5de75dd859bf1ffaa974fc8ae6dbd1ff1dada1b0,1,Mark Slee,2007-08-31 20:06:36+00:00,['000b111922ccb9c53390bd8e337ae9d48fc80268'],11,13,24,121548,1,0,0,1,509
d3f1a2d2ba1257718e7c442c1cf8ce4fb9516d78,0,James Wang,2007-08-31 23:45:53+00:00,['5de75dd859bf1ffaa974fc8ae6dbd1ff1dada1b0'],25,24,49,121597,3,0,1,0,509
47557bc8ad061a90c88d485979009c2ee8237854,0,David Reiss,2007-09-04 21:31:04+00:00,['d3f1a2d2ba1257718e7c442c1cf8ce4fb9516d78'],10,53,63,121660,3,0.043478261,0.043478261,0.043478261,509
4e7530d4e5eaee2ba54d67d2b096c7e705bb53ce,1,David Reiss,2007-09-04 21:49:53+00:00,['47557bc8ad061a90c88d485979009c2ee8237854'],3,840,843,122503,6,0.526315789,0.945263158,0.762105263,512
d683219966237417297e8f0b24e6c8fce166c490,0,David Reiss,2007-09-05 00:47:32+00:00,['4e7530d4e5eaee2ba54d67d2b096c7e705bb53ce'],4,19,23,122526,5,,,,512
4529c4b394d39900e1b50f6be08ba31553550c0d,1,Aditya Agarwal,2007-09-05 01:01:15+00:00,['d683219966237417297e8f0b24e6c8fce166c490'],19,48,67,122593,3,0.76,0.76,1,512
2c2e6d27a238746a0db9982cc4eb35c093553361,1,David Reiss,2007-09-05 01:14:09+00:00,['4529c4b394d39900e1b50f6be08ba31553550c0d'],9,54,63,122656,3,0.074074074,1,0.703703704,512
d8429fcc1020dec143e36dbfc055edbd3009f11b,0,David Reiss,2007-09-07 01:26:30+00:00,['2c2e6d27a238746a0db9982cc4eb35c093553361'],2,105,107,122763,3,1,1,1,512
e67c0e63b315873aba8fb6770821fc88bd276a74,0,David Reiss,2007-09-07 01:34:12+00:00,['d8429fcc1020dec143e36dbfc055edbd3009f11b'],62,231,293,123056,3,0.300884956,0.690265487,0.911504425,512
979ff958c125adaae29d3f93d89243f7b9e68b24,0,Mark Slee,2007-09-10 20:53:23+00:00,['e67c0e63b315873aba8fb6770821fc88bd276a74'],2,13,15,123071,1,0,0,0.888888889,512
7e9eea48711d015a2764f119ea5e78d8b6447476,1,Mark Slee,2007-09-10 21:00:23+00:00,['979ff958c125adaae29d3f93d89243f7b9e68b24'],2,2822,2824,125895,17,0.180798005,0.413341646,0.64713217,524
7816572784c7ddafc2c4350b221469af12d198fc,0,Mark Slee,2007-09-10 22:08:49+00:00,['7e9eea48711d015a2764f119ea5e78d8b6447476'],4,29,33,125928,1,,,,524
8775c73db2729f85fd66e2c8443a3628fd55a972,0,Mark Slee,2007-09-10 22:33:05+00:00,['7816572784c7ddafc2c4350b221469af12d198fc'],4,31,35,125963,2,0.833333333,0.944444444,0.944444444,524
ce161a96cddbea8916d0b20406b12d96772482ed,1,David Reiss,2007-09-11 22:09:42+00:00,['8775c73db2729f85fd66e2c8443a3628fd55a972'],187,550,737,126700,7,0,0,1,524
ae8f1d3f2341660a84a9b64e05c1ee4bec6df581,0,David Reiss,2007-09-12 01:45:12+00:00,['ce161a96cddbea8916d0b20406b12d96772482ed'],2,3,5,126705,2,,,,524
33a7d898ca8d40d02cbd6a5b7547b7fa3958c3cf,0,Mark Slee,2007-09-14 19:44:30+00:00,['ae8f1d3f2341660a84a9b64e05c1ee4bec6df581'],68,94,162,126867,8,0.714285714,1,0.571428571,524
1ca5129de0946e777cc6dab9f0ce0c8646bff0d5,1,Mark Slee,2007-09-14 19:45:12+00:00,['33a7d898ca8d40d02cbd6a5b7547b7fa3958c3cf'],0,16,16,126883,1,,,,524
3d029786cda9ecc549e57c0a9a07bfaa454cb34d,0,Mark Slee,2007-09-14 22:18:09+00:00,['1ca5129de0946e777cc6dab9f0ce0c8646bff0d5'],1,4,5,126888,1,0,0,1,524
b8c6334d99acdc36eda81a1105f7760fd16cb3e5,0,David Reiss,2007-09-15 01:44:47+00:00,['3d029786cda9ecc549e57c0a9a07bfaa454cb34d'],46,1020,1066,127954,10,0.254847645,0.529085873,0.814404432,528
5aea7c8d00b1c25fc6611c217d929c61cddd843e,0,David Reiss,2007-09-15 01:54:56+00:00,['b8c6334d99acdc36eda81a1105f7760fd16cb3e5'],1020,46,1066,129020,10,0.745152355,0.470914127,0.185595568,528
df72c01c37f4404df65971b5e538c4a47985bf81,0,dweatherford,2007-09-15 08:49:48+00:00,['5aea7c8d00b1c25fc6611c217d929c61cddd843e'],9,23,32,129052,1,0,0,1,528
fd7c26fec0ed25e5f6e134c7788258082723ee2c,0,Martin Kraemer,2007-09-17 06:58:47+00:00,['df72c01c37f4404df65971b5e538c4a47985bf81'],1,1,2,129054,1,,,,528
476b796fd7d4d7036a106682ebcb73a63349b408,0,mvaradachari,2007-09-17 20:40:16+00:00,['fd7c26fec0ed25e5f6e134c7788258082723ee2c'],2,3,5,129059,1,1,1,1,528
79ae0f8d485a568ce94be9f86a2aa5f143856dda,1,David Reiss,2007-09-17 21:15:47+00:00,['476b796fd7d4d7036a106682ebcb73a63349b408'],121,206,327,129386,4,,,,529
f84b360d5c593653a3f038d526797805861b8ace,0,David Reiss,2007-09-17 21:16:32+00:00,['79ae0f8d485a568ce94be9f86a2aa5f143856dda'],13,25,38,129424,3,1,1,1,529
faebedd356985c3b2df5e39e1cf5b152c29fc179,1,David Reiss,2007-09-17 23:20:38+00:00,['f84b360d5c593653a3f038d526797805861b8ace'],13,993,1006,130430,10,0.254847645,0.529085873,0.814404432,533
6137146329d2344aaba1a9b9492a7ed24b48a39e,1,David Reiss,2007-09-17 23:53:58+00:00,['faebedd356985c3b2df5e39e1cf5b152c29fc179'],1,1,2,130432,1,,,,533
b97b89d1dc5398021443a3c281536c27f61ac038,0,Christopher Piro,2007-09-18 00:07:42+00:00,['6137146329d2344aaba1a9b9492a7ed24b48a39e'],82,82,164,130596,2,,,,533
0f6cc29f7237e4d2b1b757848e27ccc3efdbc513,0,Christopher Piro,2007-09-18 02:14:31+00:00,['b97b89d1dc5398021443a3c281536c27f61ac038'],1,1,2,130598,1,,,,533
93a0664affc0805d11c9d69ae9989e96f2700842,0,Christopher Piro,2007-09-18 06:23:33+00:00,['0f6cc29f7237e4d2b1b757848e27ccc3efdbc513'],9094,118,9212,139810,108,,,,534
b72d19f653878dddfe09d01082dad3f077ecf95a,1,David Reiss,2007-09-18 19:46:00+00:00,['93a0664affc0805d11c9d69ae9989e96f2700842'],8,110,118,139928,10,,,,536
b8f0d496c16504f43e0d5c9ec6e6090742a4a086,0,eletuchy,2007-09-19 01:23:19+00:00,['b72d19f653878dddfe09d01082dad3f077ecf95a'],0,857,857,140785,8,0.247947455,0.543513957,0.893267652,544
8266443d925794b4323bae7cc840f5a9827ac874,1,Mark Slee,2007-09-19 06:49:30+00:00,['b8f0d496c16504f43e0d5c9ec6e6090742a4a086'],50,56,106,140891,4,0,0,0,544
2ac60ed96d3075b367ef18aa96787c68330d0248,1,Mark Slee,2007-09-19 21:10:18+00:00,['8266443d925794b4323bae7cc840f5a9827ac874'],0,255,255,141146,8,0.426751592,0.592356688,1,552
aa3c5a882c747a7686fc3dac8f7a5572cc55cdfd,1,Mark Slee,2007-09-19 21:12:52+00:00,['2ac60ed96d3075b367ef18aa96787c68330d0248'],7,29,36,141182,3,0.384615385,0.384615385,1,552
623096780fa745658e6336390c8e45bfd1f28d24,0,boz,2007-09-20 23:24:16+00:00,['aa3c5a882c747a7686fc3dac8f7a5572cc55cdfd'],2,11,13,141195,3,,,,552
19cee90ca41922a4437d547a2298201359bbcdcc,0,boz,2007-09-22 23:08:11+00:00,['623096780fa745658e6336390c8e45bfd1f28d24'],9,10,19,141214,2,,,,552
77575e69bbb9a8bc4b7d392abec781150c4cb039,1,Mark Slee,2007-09-24 19:24:53+00:00,['19cee90ca41922a4437d547a2298201359bbcdcc'],11,301,312,141526,12,0.826446281,0.983471074,1,560
c7fd7639b7a4fbfd5948d9c552baf118bc94c3c3,0,Christopher Piro,2007-10-02 00:05:04+00:00,['77575e69bbb9a8bc4b7d392abec781150c4cb039'],142,136,278,141804,8,,,,560
42fe4b9a3e20e07160b5f32c652b47fa2cb09141,0,Christopher Piro,2007-10-02 00:24:07+00:00,['c7fd7639b7a4fbfd5948d9c552baf118bc94c3c3'],136,135,271,142075,7,,,,560
68940295e1b2e8caca6376b95879ef252bc5dd3e,0,Christopher Piro,2007-10-02 00:35:12+00:00,['42fe4b9a3e20e07160b5f32c652b47fa2cb09141'],135,136,271,142346,7,,,,560
efd5eec21194c7b9e92fb17a26329e26b202e4f3,0,Christopher Piro,2007-10-02 01:33:37+00:00,['68940295e1b2e8caca6376b95879ef252bc5dd3e'],1,190,191,142537,10,,,,567
780e4ecac988ba8aeea794631da2ea9a24c7717b,0,Mark Slee,2007-10-02 04:43:31+00:00,['efd5eec21194c7b9e92fb17a26329e26b202e4f3'],1,12,13,142550,1,0,0,1,567
9b36ef3575c13aa360f1b2fac312683270978094,0,Mark Slee,2007-10-02 04:44:48+00:00,['780e4ecac988ba8aeea794631da2ea9a24c7717b'],3,12,15,142565,1,,,,567
73e3dd7d5fdd30301816982d2cd6a961380538ac,0,Christopher Piro,2007-10-03 07:13:44+00:00,['9b36ef3575c13aa360f1b2fac312683270978094'],1,1,2,142567,1,,,,567
145429602687d1785c485bcd1ea9dcd83f28bda4,0,yunfang,2007-10-03 22:59:41+00:00,['73e3dd7d5fdd30301816982d2cd6a961380538ac'],3,4,7,142574,2,,,,567
165eca9c7cdfcbc3b6ac4d8eeadb8e1c80a2584c,0,Mark Slee,2007-10-04 01:19:20+00:00,['145429602687d1785c485bcd1ea9dcd83f28bda4'],1,10,11,142585,1,0,0,1,567
e4e1968935f0dce5720f82baef19605f64512120,0,Christopher Piro,2007-10-04 01:54:11+00:00,['165eca9c7cdfcbc3b6ac4d8eeadb8e1c80a2584c'],6,0,6,142591,1,0,1,0,567
6fc7be28bb1363adaedee47c34ea0262e3346eb4,0,David Reiss,2007-10-04 23:02:01+00:00,['e4e1968935f0dce5720f82baef19605f64512120'],0,39,39,142630,1,1,1,1,568
5299a959e0ac89ce26b6ad4f73b893207f9bae3d,1,Mark Slee,2007-10-05 00:13:24+00:00,['6fc7be28bb1363adaedee47c34ea0262e3346eb4'],106,117,223,142853,5,1,1,1,569
6c848a02df5cf8276f25091e96582ac16a4358fb,0,Mark Slee,2007-10-08 22:31:03+00:00,['5299a959e0ac89ce26b6ad4f73b893207f9bae3d'],5,2,7,142860,1,1,1,0,569
4c3d7b84b62c7a0f5974e376a0cb32fe599d0277,0,Christopher Piro,2007-10-09 04:41:48+00:00,['6c848a02df5cf8276f25091e96582ac16a4358fb'],7,0,7,142867,1,0,1,0,569
34b2926d5ca9b6068fa863e7d5e0a4055cbbef30,1,Mark Slee,2007-10-09 20:55:10+00:00,['4c3d7b84b62c7a0f5974e376a0cb32fe599d0277'],1,32,33,142900,2,,,,570
d1372829e65dcca66ab0ca75a20919e76bbf7fc9,0,dweatherford,2007-10-09 22:57:23+00:00,['34b2926d5ca9b6068fa863e7d5e0a4055cbbef30'],1,28,29,142929,2,1,1,1,570
b92e3164767027e7b0048717dcac6741c31d7a3e,0,pkeyani,2007-10-10 05:22:31+00:00,['d1372829e65dcca66ab0ca75a20919e76bbf7fc9'],0,0,0,142929,1,,,,570
b6dcd2b595724fd9c3d575466db8394dc16be3ae,0,Christopher Piro,2007-10-13 01:11:46+00:00,['b92e3164767027e7b0048717dcac6741c31d7a3e'],136,196,332,143261,6,,,,570
7b19b65a1623d197395b0cac79720666e8aa5d82,0,Christopher Piro,2007-10-13 05:10:52+00:00,['b6dcd2b595724fd9c3d575466db8394dc16be3ae'],3,3,6,143267,1,,,,570
524c3ecef7954fbd1c7820b160426a069fef819f,0,Christopher Piro,2007-10-13 05:15:33+00:00,['7b19b65a1623d197395b0cac79720666e8aa5d82'],6,8,14,143281,1,,,,570
65e595f54fb188b112ef050fbd56914b509f7b2e,0,Mark Slee,2007-10-15 21:32:12+00:00,['524c3ecef7954fbd1c7820b160426a069fef819f'],0,3,3,143284,1,0,0,1,570
2b9ddab14cf8bc64e50e3f2cf2334b9503b60866,0,David Reiss,2007-10-17 03:39:55+00:00,['65e595f54fb188b112ef050fbd56914b509f7b2e'],3,3,6,143290,2,,,,570
14b0ed6fad8fab2a22595f6a2a0407cf1b211763,0,dweatherford,2007-10-19 01:03:32+00:00,['2b9ddab14cf8bc64e50e3f2cf2334b9503b60866'],0,22,22,143312,2,1,1,1,570
3b63fe4d3c75b20250ca1977750d4b4b3f80bf9b,0,Christopher Piro,2007-10-19 21:34:31+00:00,['14b0ed6fad8fab2a22595f6a2a0407cf1b211763'],73,70,143,143455,6,,,,570
969b226b06aa80b4d35e0190b69569bdeb8d926c,0,dweatherford,2007-10-23 00:26:44+00:00,['3b63fe4d3c75b20250ca1977750d4b4b3f80bf9b'],7,11,18,143473,1,0,0,1,570
6c46f1a8c98113ff5951ae8974339cdeda0eb4bc,0,Christopher Piro,2007-10-23 09:47:15+00:00,['969b226b06aa80b4d35e0190b69569bdeb8d926c'],123,50,173,143646,6,,,,570
2e7801d7c0b7b881067f4f84c664f22e64a988fa,1,Mark Slee,2007-10-24 02:56:24+00:00,['6c46f1a8c98113ff5951ae8974339cdeda0eb4bc'],0,9,9,143655,1,0,0,1,570
5e60901123f267ab6f1aa3c395560c965dbac724,0,David Reiss,2007-10-24 03:35:36+00:00,['2e7801d7c0b7b881067f4f84c664f22e64a988fa'],0,0,0,143655,26,,,,570
3e098b1757724eb2e78a4abc1306a32abaf610b2,0,Mark Slee,2007-10-30 16:55:47+00:00,['5e60901123f267ab6f1aa3c395560c965dbac724'],1,1,2,143657,1,,,,570
65b7075b5aa64c139ad59a3db35ddddda6a2203f,1,dweatherford,2007-10-31 02:18:14+00:00,['3e098b1757724eb2e78a4abc1306a32abaf610b2'],100,142,242,143899,26,0.551020408,0.571428571,1,570
51c03936206fbde7b6b980c8d745f758b464c9bc,0,dweatherford,2007-10-31 04:22:12+00:00,['65b7075b5aa64c139ad59a3db35ddddda6a2203f'],0,367,367,144266,3,0.220408163,0.293877551,0.424489796,573
5afc0aae324e8ad31ff2122ae33d6963ebf75c1d,0,dweatherford,2007-10-31 06:03:54+00:00,['51c03936206fbde7b6b980c8d745f758b464c9bc'],117,161,278,144544,2,0,0,0,573
83f14ee795917b2f8fa7eb8c18564161b69d9780,0,eletuchy,2007-10-31 13:40:48+00:00,['5afc0aae324e8ad31ff2122ae33d6963ebf75c1d'],1,1,2,144546,1,,,,573
80940b70e8af3d379e0c822895fa5fcfa51a7dad,0,dweatherford,2007-10-31 23:30:56+00:00,['83f14ee795917b2f8fa7eb8c18564161b69d9780'],13,48,61,144607,3,1,1,0.7,573
8ebe4a1757145121f9af74d0d9f172d418771cfa,0,boz,2007-11-01 07:37:45+00:00,['80940b70e8af3d379e0c822895fa5fcfa51a7dad'],1,9,10,144617,1,0.5,0.666666667,0.666666667,573
83be086c7d8bf7d6b61f953c15737e3bbd25c91a,0,David Reiss,2007-11-01 17:15:35+00:00,['8ebe4a1757145121f9af74d0d9f172d418771cfa'],14,14,28,144645,11,,,,573
f36e484cfb8a919e8bc587bec91d14ef55e2eb1b,0,dweatherford,2007-11-02 02:22:25+00:00,['83be086c7d8bf7d6b61f953c15737e3bbd25c91a'],3,3,6,144651,1,,,,573
b000f7433dd0a767e191b7e78b7da38a3b9670cd,0,hzhao,2007-11-02 03:18:28+00:00,['f36e484cfb8a919e8bc587bec91d14ef55e2eb1b'],1,1,2,144653,1,,,,573
ffc21fb792b152ed6b45c4e83b4c5fd295465007,0,lklots,2007-11-02 23:01:27+00:00,['b000f7433dd0a767e191b7e78b7da38a3b9670cd'],0,75,75,144728,1,1,1,1,574
52182d674eff80ac99da38b34273279bce9a327b,0,Mark Slee,2007-11-03 04:48:43+00:00,['ffc21fb792b152ed6b45c4e83b4c5fd295465007'],2,2,4,144732,1,,,,574
0502e61fb99d4aab9717e2ba42ac6d9987ea5e2d,1,Mark Slee,2007-11-03 05:30:32+00:00,['52182d674eff80ac99da38b34273279bce9a327b'],6,66,72,144804,5,0.464285714,0,0.964285714,574
3788038a3564e131372b3e54832d513dcc36917f,0,Aditya Agarwal,2007-11-06 06:33:06+00:00,['0502e61fb99d4aab9717e2ba42ac6d9987ea5e2d'],0,2,2,144806,1,1,1,1,574
f968926f2b757c1ab7b0bb008e96c58d081f172e,0,Mark Slee,2007-11-06 22:10:24+00:00,['3788038a3564e131372b3e54832d513dcc36917f'],0,2,2,144808,1,,,,574
5151c6279ba4faa6bc3c3450b22da225a10ada8d,0,Mark Slee,2007-11-06 22:11:29+00:00,['f968926f2b757c1ab7b0bb008e96c58d081f172e'],72,80,152,144960,1,0,1,1,574
6eb58926628132770508c146e01686a832b97dc8,0,Mark Slee,2007-11-07 00:48:47+00:00,['5151c6279ba4faa6bc3c3450b22da225a10ada8d'],10,19,29,144989,1,1,1,1,574
c0c88ee8056427f66451e527f791b31f7485b4ca,1,David Reiss,2007-11-08 01:05:46+00:00,['6eb58926628132770508c146e01686a832b97dc8'],24,227,251,145240,4,,,,575
5b743079da3b0f817545d7e0574222a5c16fc2a9,0,Mark Slee,2007-11-13 04:00:29+00:00,['c0c88ee8056427f66451e527f791b31f7485b4ca'],71,852,923,146163,8,0.053701016,0.088534107,0.120464441,575
2b786221edc8a0bfd640e5755459f3973120dd7a,0,Mark Slee,2007-11-13 05:35:34+00:00,['5b743079da3b0f817545d7e0574222a5c16fc2a9'],4,4,8,146171,1,,,,575
c557df42ed89913dd35536fcb30621d64c4ab0e6,0,Mark Slee,2007-11-13 05:53:44+00:00,['2b786221edc8a0bfd640e5755459f3973120dd7a'],1,1,2,146173,1,,,,575
0cdc6c8cd94cad4407e38db5975715fb67c71fb7,0,Mark Slee,2007-11-13 10:19:08+00:00,['c557df42ed89913dd35536fcb30621d64c4ab0e6'],18,47,65,146238,7,1,1,1,575
380298f458dcdedb1e59227c90cee4af890bef08,0,David Reiss,2007-11-13 11:55:06+00:00,['0cdc6c8cd94cad4407e38db5975715fb67c71fb7'],1,1,2,146240,1,,,,575
465ccc09240b16f5790dfc5c5e7579c42ec54770,0,David Reiss,2007-11-13 21:41:29+00:00,['380298f458dcdedb1e59227c90cee4af890bef08'],6,6,12,146252,1,,,,575
89d52079834a20411d2b842d2e71a4e3390911a9,0,Mark Slee,2007-11-14 00:24:14+00:00,['465ccc09240b16f5790dfc5c5e7579c42ec54770'],2,9,11,146263,1,0,0.8,0.8,575
6c74062262aaad614719227a279dfb7789e56471,0,Christopher Piro,2007-11-15 02:20:58+00:00,['89d52079834a20411d2b842d2e71a4e3390911a9'],51,51,102,146365,1,,,,575
0d5cd8a6b92053df8e8b1f5df9e2e3e55c3a9cd1,0,Christopher Piro,2007-11-15 02:20:59+00:00,['6c74062262aaad614719227a279dfb7789e56471'],4,5,9,146374,1,,,,575
3121c8271f07b56593df3e6a10ad549590059057,0,Christopher Piro,2007-11-15 06:26:26+00:00,['0d5cd8a6b92053df8e8b1f5df9e2e3e55c3a9cd1'],38,37,75,146449,1,,,,575
a1650fe55cfdba6c5cad1f09e3142b23b24b66c9,0,Christopher Piro,2007-11-15 06:26:27+00:00,['3121c8271f07b56593df3e6a10ad549590059057'],32,45,77,146526,2,,,,575
53b6ef670cd70c0f81d6ade52de27dde763b3686,0,Christopher Piro,2007-11-15 06:26:28+00:00,['a1650fe55cfdba6c5cad1f09e3142b23b24b66c9'],169,169,338,146864,8,,,,575
2605af3a2d6bd7c8815e08ecf886eb3720d2ac1d,0,Christopher Piro,2007-11-15 06:26:29+00:00,['53b6ef670cd70c0f81d6ade52de27dde763b3686'],121,121,242,147106,1,,,,575
90eab4d6e4279e9e61fa295e19a834f4c6ebe632,0,Christopher Piro,2007-11-15 06:26:29+00:00,['2605af3a2d6bd7c8815e08ecf886eb3720d2ac1d'],4,4,8,147114,1,,,,575
c2e37c7a617c7e7d55ab79a3f23542aeec42b1af,0,Christopher Piro,2007-11-15 06:26:30+00:00,['90eab4d6e4279e9e61fa295e19a834f4c6ebe632'],266,212,478,147592,3,,,,575
10522a7f2b9d413d97f49670e3102826833dcdcf,0,Christopher Piro,2007-11-15 06:26:31+00:00,['c2e37c7a617c7e7d55ab79a3f23542aeec42b1af'],9,17,26,147618,2,,,,575
9230539a6f2b36e25799b97ff45e90743af61269,0,Christopher Piro,2007-11-15 06:26:32+00:00,['10522a7f2b9d413d97f49670e3102826833dcdcf'],8,4,12,147630,1,1,1,0,575
9e58f4330ddac304a03e6d240968a6185d4531f3,0,Mark Slee,2007-11-16 02:48:52+00:00,['9230539a6f2b36e25799b97ff45e90743af61269'],4,4,8,147638,1,,,,575
eab6ac8b18db9bb6c83b44845aabea177777addf,0,Mark Slee,2007-11-16 03:27:22+00:00,['9e58f4330ddac304a03e6d240968a6185d4531f3'],9,8,17,147655,1,0,0,0,575
611434992a349fb69507a625929f98f61656feef,0,dweatherford,2007-11-16 03:29:47+00:00,['eab6ac8b18db9bb6c83b44845aabea177777addf'],2,2,4,147659,1,,,,575
f5a6b0c10939a2c0dd33fa88b8ce4e3f44a33186,0,Mark Slee,2007-11-17 00:27:17+00:00,['611434992a349fb69507a625929f98f61656feef'],0,27,27,147686,1,0,1,1,575
09f69e052452e973949bc143d0f34c28c51ff15e,0,Mark Slee,2007-11-17 00:32:36+00:00,['f5a6b0c10939a2c0dd33fa88b8ce4e3f44a33186'],48,144,192,147878,4,0.211538462,0.884615385,0.557692308,576
de11d852113dcb2284c54ab47333e6f602320fc9,0,Christopher Piro,2007-11-18 02:10:20+00:00,['09f69e052452e973949bc143d0f34c28c51ff15e'],398,319,717,148595,22,,,,576
7fcc9e87ba180909c7309ecb713321f6aabfe9f4,1,hzhao,2007-11-18 20:48:56+00:00,['de11d852113dcb2284c54ab47333e6f602320fc9'],0,375,375,148970,3,0.227091633,0.302788845,0.430278884,579
b6014f494f41ecee4f8e1c7264e99a883805e99f,0,hzhao,2007-11-18 20:54:30+00:00,['7fcc9e87ba180909c7309ecb713321f6aabfe9f4'],0,0,0,148970,3,,,,579
fb4b514028ed073302ffa8d3dcbfba3a89b427f0,0,Mark Slee,2007-11-20 01:27:08+00:00,['b6014f494f41ecee4f8e1c7264e99a883805e99f'],7,26,33,149003,1,0,0,1,579
8440605c277339770483a7daf31da7858bff2b38,1,Mark Slee,2007-11-20 01:39:25+00:00,['fb4b514028ed073302ffa8d3dcbfba3a89b427f0'],39,151,190,149193,12,0.815384615,0.876923077,1,579
12a3b4e002b34ba115959b89f113e76a325e5389,0,Mark Slee,2007-11-20 02:05:29+00:00,['8440605c277339770483a7daf31da7858bff2b38'],11,15,26,149219,1,0.5,1,1,579
276eea68b78e61713ac747c41960fcd469edd0e4,0,Mark Slee,2007-11-20 02:06:47+00:00,['12a3b4e002b34ba115959b89f113e76a325e5389'],11,11,22,149241,1,,,,579
a1d4cab45f1d061e6121a7ed6b826dc79beca02a,0,Mark Slee,2007-11-20 04:58:16+00:00,['276eea68b78e61713ac747c41960fcd469edd0e4'],2,2,4,149245,1,,,,579
efd37f14d25bb446e8ed0975803d228ef8e20dd8,1,Mark Slee,2007-11-20 05:13:09+00:00,['a1d4cab45f1d061e6121a7ed6b826dc79beca02a'],35,3240,3275,152520,6,0.326951399,0.693667158,0.916053019,583
80674855958ff6378513cbfabb651404115fbc1d,0,Mark Slee,2007-11-20 05:54:13+00:00,['efd37f14d25bb446e8ed0975803d228ef8e20dd8'],12,12,24,152544,1,0,0,0,583
12a28758a684321f29a3ceab17df9ae19570591d,0,Mark Slee,2007-11-20 23:55:33+00:00,['80674855958ff6378513cbfabb651404115fbc1d'],62,65,127,152671,1,0,1,1,583
bd5882259de8bbe7e3f8283c8959d99acee9a501,1,Mark Slee,2007-11-21 08:43:35+00:00,['12a28758a684321f29a3ceab17df9ae19570591d'],1584,266,1850,154521,8,0.764705882,1,1,583
a9387af56ee5dd6fe601ac59f62a553b64e0eb49,0,Mark Slee,2007-11-21 22:05:50+00:00,['bd5882259de8bbe7e3f8283c8959d99acee9a501'],1,1,2,154523,1,,,,583
7962223ce299bbeb20348b3819a423a72efa2335,0,Mark Slee,2007-11-21 23:35:52+00:00,['a9387af56ee5dd6fe601ac59f62a553b64e0eb49'],1,9,10,154533,2,,,,583
79b1694043e07a673c343c42ad75d72f3b560539,1,Mark Slee,2007-11-26 19:05:29+00:00,['7962223ce299bbeb20348b3819a423a72efa2335'],101,169,270,154803,5,0.518518519,1,0.962962963,583
53d9c0c20bd5af65676928b9b7a73dcb2cad3d78,1,Mark Slee,2007-11-26 21:15:40+00:00,['79b1694043e07a673c343c42ad75d72f3b560539'],2,115,117,154920,3,0.651515152,0.909090909,0.909090909,584
5ab570558f55d73472fbf6c0e66e6e165093c7d8,0,Mark Slee,2007-11-27 08:38:16+00:00,['53d9c0c20bd5af65676928b9b7a73dcb2cad3d78'],62,62,124,155044,1,,,,584
844ac12489600d7647f01ab4f9b99d9e1b81e69e,1,Mark Slee,2007-11-27 08:38:52+00:00,['5ab570558f55d73472fbf6c0e66e6e165093c7d8'],11,438,449,155493,4,0.892703863,0.987124464,1,586
256bdc444866b90bbdccfb5343e9c9ea8c22603c,1,Mark Slee,2007-11-27 08:42:19+00:00,['844ac12489600d7647f01ab4f9b99d9e1b81e69e'],42,42,84,155577,4,,,,586
fe6ed0dff423a405fabd61e4bef3e490506ba2ba,0,Mark Slee,2007-11-27 21:54:38+00:00,['256bdc444866b90bbdccfb5343e9c9ea8c22603c'],22,50,72,155649,1,0,0,0,586
b45529269934a053b03528e287e66812e1109ad3,1,Mark Slee,2007-11-28 00:12:11+00:00,['fe6ed0dff423a405fabd61e4bef3e490506ba2ba'],5,122,127,155776,3,0.263157895,1,1,586
b4d3e7b052c960a5ab96310f7cb16ba46e6d32b4,0,Mark Slee,2007-11-28 01:51:43+00:00,['b45529269934a053b03528e287e66812e1109ad3'],67,141,208,155984,9,0.25,0.138888889,1,586
b22df7c9639335ce336ba977312b2ad25180595e,0,Mark Slee,2007-11-28 02:39:59+00:00,['b4d3e7b052c960a5ab96310f7cb16ba46e6d32b4'],29,51,80,156064,3,0.111111111,0.166666667,0.555555556,586
d602f822d50bec166cd34c8ece170b13694268a9,0,Mark Slee,2007-11-28 02:45:13+00:00,['b22df7c9639335ce336ba977312b2ad25180595e'],31,75,106,156170,3,0,0,1,587
645ecea7146b95f4b832a1042e58227216d7db4e,0,Mark Slee,2007-11-28 02:46:24+00:00,['d602f822d50bec166cd34c8ece170b13694268a9'],54,36,90,156260,1,1,1,1,587
e02ab33cb8e38392d371d08e09dbfb136202d61a,1,Mark Slee,2007-11-28 04:17:49+00:00,['645ecea7146b95f4b832a1042e58227216d7db4e'],8,33,41,156301,3,0.25,0.25,0.25,587
d0f5b28835d80fc9a0f7bdb61e88e32b98a911c0,0,Mark Slee,2007-11-28 04:29:25+00:00,['e02ab33cb8e38392d371d08e09dbfb136202d61a'],1,1,2,156303,1,,,,587
b16074d53bd7b66d1e34dc6623637d59be717db5,1,Mark Slee,2007-11-28 05:54:33+00:00,['d0f5b28835d80fc9a0f7bdb61e88e32b98a911c0'],5,57,62,156365,6,,,,590
bef54c0647b22128c9035cfbc4d4b112ab5e68f8,0,David Reiss,2007-11-28 20:15:11+00:00,['b16074d53bd7b66d1e34dc6623637d59be717db5'],6,6,12,156377,1,,,,590
6f9ac3ffeb408392d1c3bb3945fe5b261f9e7817,1,Mark Slee,2007-11-28 22:28:13+00:00,['bef54c0647b22128c9035cfbc4d4b112ab5e68f8'],7,22,29,156406,3,1,1,1,590
f60467efc9d11804f6d38370c4b90fa39e2262df,0,Mark Slee,2007-11-29 02:57:34+00:00,['6f9ac3ffeb408392d1c3bb3945fe5b261f9e7817'],2,22,24,156430,1,0.642857143,0,1,590
9860ee2c86971cbbc1d2593ad67f8ea5bbf2aaa5,1,Mark Slee,2007-11-30 01:43:36+00:00,['f60467efc9d11804f6d38370c4b90fa39e2262df'],1,1,2,156432,1,,,,590
ef22dc652fbfaa7b7c718f752f2ca5b1fecdf94e,0,David Reiss,2007-11-30 20:38:49+00:00,['9860ee2c86971cbbc1d2593ad67f8ea5bbf2aaa5'],0,1,1,156433,1,,,,590
2323cf642226468e6363b031fad6d9f64a45cb9f,0,dweatherford,2007-12-05 03:40:19+00:00,['ef22dc652fbfaa7b7c718f752f2ca5b1fecdf94e'],1,9,10,156443,1,1,0,1,590
c37b4c5193c344d6827a197bb86c718b42d74e47,0,Mark Slee,2007-12-05 23:03:37+00:00,['2323cf642226468e6363b031fad6d9f64a45cb9f'],9,2,11,156454,1,1,1,0,590
3f14d3ebec2028bbacbeb0991b236152f2912d1b,0,Mark Slee,2007-12-05 23:13:11+00:00,['c37b4c5193c344d6827a197bb86c718b42d74e47'],35,230,265,156719,4,0.820754717,1,0.933962264,591
5d1784a7b41939e2ac09005c688b5d8165e3b323,0,Mark Slee,2007-12-05 23:20:54+00:00,['3f14d3ebec2028bbacbeb0991b236152f2912d1b'],1,2,3,156722,1,0,1,0,591
c31769cceb013d947c2349f21285dfaf90d83fe2,1,Aditya Agarwal,2007-12-11 22:23:51+00:00,['5d1784a7b41939e2ac09005c688b5d8165e3b323'],2,17,19,156741,1,0,1,1,591
ae3804f8f7941102d42230a59879dbec8f076223,1,James Wang,2007-12-13 19:46:27+00:00,['c31769cceb013d947c2349f21285dfaf90d83fe2'],14,11,25,156766,1,1,1,0,591
78ee85c911891231030f2045cb17f98530abf9d9,0,pfung,2007-12-13 22:30:47+00:00,['ae3804f8f7941102d42230a59879dbec8f076223'],0,2,2,156768,1,0,0,1,591
77a31384b89683f7cb5ae7132ca3961a88886793,0,Mark Slee,2007-12-13 22:47:33+00:00,['78ee85c911891231030f2045cb17f98530abf9d9'],53,53,106,156874,1,,,,591
15457c9b08a75e0b5a8c82936151468bddfd27b8,0,David Reiss,2007-12-14 07:03:03+00:00,['77a31384b89683f7cb5ae7132ca3961a88886793'],21,48,69,156943,5,1,1,1,591
adad4ab20356d4c16f2df521b205aae7272c105f,1,David Reiss,2007-12-14 20:56:04+00:00,['15457c9b08a75e0b5a8c82936151468bddfd27b8'],11,28,39,156982,3,0,0,1,591
4a15eb7f7114e1ef585365c0cbcd2fb0de982d27,1,David Reiss,2007-12-14 22:14:47+00:00,['adad4ab20356d4c16f2df521b205aae7272c105f'],5,30,35,157017,1,1,1,0.777777778,591
c16a8f6e45015299ed65fbdbfb3bda9017663a6d,1,David Reiss,2007-12-14 23:46:47+00:00,['4a15eb7f7114e1ef585365c0cbcd2fb0de982d27'],6,91,97,157114,2,0.627906977,1,0.953488372,592
5f54566f8ad4bac927de425dee555b9627957533,1,David Reiss,2007-12-15 00:09:54+00:00,['c16a8f6e45015299ed65fbdbfb3bda9017663a6d'],0,7,7,157121,1,,,,592
5ddd2f13faa12c5a45ebafcb229c570031678a78,0,David Reiss,2007-12-17 09:49:10+00:00,['5f54566f8ad4bac927de425dee555b9627957533'],1,1,2,157123,1,,,,592
677ffc50446082e3cd12bbf3e2cc1364c603429a,0,Mark Slee,2007-12-18 02:06:44+00:00,['5ddd2f13faa12c5a45ebafcb229c570031678a78'],1,1,2,157125,1,,,,592
80a702fa395c3887281407b0d44af5cbe3e3006c,0,David Reiss,2007-12-18 02:54:06+00:00,['677ffc50446082e3cd12bbf3e2cc1364c603429a'],1,1,2,157127,1,,,,592
6495adb992eca5eb37da1bd72ebb5cc798e1afb1,1,David Reiss,2007-12-18 03:37:30+00:00,['80a702fa395c3887281407b0d44af5cbe3e3006c'],21,27,48,157175,3,1,1,0,592
a89cd7b03e1a1071094bacdfbf74cff3739b2911,0,Christopher Piro,2007-12-19 00:00:39+00:00,['6495adb992eca5eb37da1bd72ebb5cc798e1afb1'],0,9,9,157184,1,,,,592
97264864df4e7c14d8a4323af6ad37e726c52ef9,0,Mark Slee,2007-12-20 03:23:27+00:00,['a89cd7b03e1a1071094bacdfbf74cff3739b2911'],14,20,34,157218,2,,,,592
eaa61e43630c68ee2e98f7b649047e45c524f9d8,0,David Reiss,2007-12-20 21:42:05+00:00,['97264864df4e7c14d8a4323af6ad37e726c52ef9'],0,6,6,157224,1,,,,592
16cf270283cd08e53467baa765b05c0427a4f5b8,0,dweatherford,2007-12-21 07:07:31+00:00,['eaa61e43630c68ee2e98f7b649047e45c524f9d8'],1,1,2,157226,1,,,,592
c27fc31333720f7f959f526534fa8ed8f37bd532,0,Mark Slee,2007-12-21 23:52:19+00:00,['16cf270283cd08e53467baa765b05c0427a4f5b8'],0,1,1,157227,1,,,,592
f845b7d3e097097446067b3a0bc96c6dc85008ca,0,Mark Slee,2007-12-21 23:53:10+00:00,['c27fc31333720f7f959f526534fa8ed8f37bd532'],1,1,2,157229,1,,,,592
4b6ff2dabcc67b437f9fb9e6930cb4705bd936df,0,Aditya Agarwal,2007-12-25 22:58:50+00:00,['f845b7d3e097097446067b3a0bc96c6dc85008ca'],4,4,8,157237,2,,,,592
5d86e399036740633954c50cc88f2a98908f54b0,0,David Reiss,2007-12-26 20:23:03+00:00,['4b6ff2dabcc67b437f9fb9e6930cb4705bd936df'],1,9,10,157247,1,,,,592
65704511459cdfc0f3e7d70b5008ea4e18a6f538,0,eletuchy,2007-12-27 15:20:14+00:00,['5d86e399036740633954c50cc88f2a98908f54b0'],19,29,48,157295,2,0.875,0.875,1,592
832b262acab7656ce5d5541f010c29f060580693,1,David Reiss,2007-12-28 18:25:33+00:00,['65704511459cdfc0f3e7d70b5008ea4e18a6f538'],554,151,705,158000,33,,,,593
fbc911438de5b86f665b3e8b7d2499d52e37d357,0,mvaradachari,2008-01-01 04:51:24+00:00,['832b262acab7656ce5d5541f010c29f060580693'],1,1,2,158002,1,,,,593
7ab31e4fd1bf3c6389d1743ee0e8554aa8b97ad4,0,Christopher Piro,2008-01-04 00:21:18+00:00,['fbc911438de5b86f665b3e8b7d2499d52e37d357'],7,7,14,158016,1,,,,593
e8abada6ad63306c38d2107601a5645ff8f1d22c,0,pfung,2008-01-05 23:23:53+00:00,['7ab31e4fd1bf3c6389d1743ee0e8554aa8b97ad4'],2,1,3,158019,1,1,1,0,593
8ec70e88e68aba3e3fa636b6ac23cbf2ec726152,0,Mark Slee,2008-01-07 21:50:30+00:00,['e8abada6ad63306c38d2107601a5645ff8f1d22c'],3,1,4,158023,1,,,,593
33d8f340dcca637e3b91d946f3f6f92daff64456,1,dweatherford,2008-01-07 22:23:07+00:00,['8ec70e88e68aba3e3fa636b6ac23cbf2ec726152'],0,16,16,158039,1,1,0,1,593
26484fb7b145a10a3aa8f3b396a32c4f5b85236c,0,Christopher Piro,2008-01-08 03:14:19+00:00,['33d8f340dcca637e3b91d946f3f6f92daff64456'],1,2,3,158042,1,,,,593
a65a79ed26419f0267dfd4a97d3b9adc42163385,1,David Reiss,2008-01-09 19:20:20+00:00,['26484fb7b145a10a3aa8f3b396a32c4f5b85236c'],1,1,2,158044,1,,,,593
8c46b1a88180d8ca1cd943439e3c365d91e33672,1,Mark Slee,2008-01-09 19:51:24+00:00,['a65a79ed26419f0267dfd4a97d3b9adc42163385'],1,1,2,158046,1,,,,593
89f57164215850cc1b0d12460ce242a44a4143af,1,Mark Slee,2008-01-10 00:53:08+00:00,['8c46b1a88180d8ca1cd943439e3c365d91e33672'],192,326,518,158564,10,0.761904762,0.961904762,0.961904762,597
19c9777583bf4614a237be824bbed80fa6db9213,0,Mark Slee,2008-01-10 19:57:47+00:00,['89f57164215850cc1b0d12460ce242a44a4143af'],12,12,24,158588,1,,,,597
204420fa56d93adb59ac9fe339bb25e8d9b13fb2,1,David Reiss,2008-01-11 20:59:03+00:00,['19c9777583bf4614a237be824bbed80fa6db9213'],49,127,176,158764,18,0.684210526,0.684210526,1,598
7f42bcf97c8961d5f25cb88220d0b358a1cbccae,1,David Reiss,2008-01-11 20:59:12+00:00,['204420fa56d93adb59ac9fe339bb25e8d9b13fb2'],4,4075,4079,162843,41,0.345283824,0.57106274,0.734955186,630
21db52de163e27f6cb01410fec812dc5f9e6e6a9,0,Christopher Piro,2008-01-14 05:54:50+00:00,['7f42bcf97c8961d5f25cb88220d0b358a1cbccae'],1,1,2,162845,1,,,,630
1c4ced7409e86f64b449b4e33cf0a50b7f1e4c34,0,Mark Slee,2008-01-14 23:04:43+00:00,['21db52de163e27f6cb01410fec812dc5f9e6e6a9'],15,16,31,162876,2,1,1,1,630
737ce021d1eebc100df83ee04489cb85e4a5f56c,0,Mark Slee,2008-01-15 02:59:12+00:00,['1c4ced7409e86f64b449b4e33cf0a50b7f1e4c34'],14,33,47,162923,1,1,1,0,630
8ca66b8805921f2ec60f088177f0e9596f08dc57,0,Christopher Piro,2008-01-15 12:04:09+00:00,['737ce021d1eebc100df83ee04489cb85e4a5f56c'],7,1,8,162931,1,,,,630
5165f3e65ed5a072099f561d28b3b3994ab8aa95,0,Christopher Piro,2008-01-15 12:04:12+00:00,['8ca66b8805921f2ec60f088177f0e9596f08dc57'],1,29,30,162961,2,,,,631
8ba81573b3e82103b0ecc7af14d253ebe2489260,0,Christopher Piro,2008-01-15 12:04:15+00:00,['5165f3e65ed5a072099f561d28b3b3994ab8aa95'],0,68,68,163029,1,,,,632
3f1d8c7cf645256455c2231a8273411a4f83d594,0,Christopher Piro,2008-01-15 12:52:51+00:00,['8ba81573b3e82103b0ecc7af14d253ebe2489260'],53,59,112,163141,2,,,,633
1c99140ec009fad8e8e03e9896ed078fabee7c98,0,David Reiss,2008-01-15 19:45:02+00:00,['3f1d8c7cf645256455c2231a8273411a4f83d594'],3,3,6,163147,1,,,,633
2e8a8d40951ba3708ddb377e90e34b270bfc5446,0,Mark Slee,2008-01-16 00:38:20+00:00,['1c99140ec009fad8e8e03e9896ed078fabee7c98'],21,60,81,163228,2,0,0,1,633
76f2c88edad82d3f6c0b7407295d9f7263394bdf,0,kholst,2008-01-16 02:47:41+00:00,['2e8a8d40951ba3708ddb377e90e34b270bfc5446'],14,106,120,163348,6,0.592592593,0.777777778,1,633
225f8b0d51c699db74026d367f6294d22cf7c3ae,1,David Reiss,2008-01-16 06:32:19+00:00,['76f2c88edad82d3f6c0b7407295d9f7263394bdf'],12,8,20,163368,1,,,,633
4b3381314f590c8338c81a5ac71aac9007fea343,0,Mark Slee,2008-01-16 21:29:45+00:00,['225f8b0d51c699db74026d367f6294d22cf7c3ae'],1,1,2,163370,1,,,,633
32007a555cc2d10207e65a163f6ab809534d47e4,0,Mark Slee,2008-01-18 00:57:59+00:00,['4b3381314f590c8338c81a5ac71aac9007fea343'],2,2,4,163374,1,,,,633
b216c032298a0325c08807ae22ac1a12306b3ece,0,mvaradachari,2008-01-18 01:00:18+00:00,['32007a555cc2d10207e65a163f6ab809534d47e4'],0,2,2,163376,1,,,,633
5b3cbd13d60433f231697e8e39d3ffa6d73398b3,0,mvaradachari,2008-01-18 01:54:55+00:00,['b216c032298a0325c08807ae22ac1a12306b3ece'],1,0,1,163377,1,,,,633
050f3200a2963d00212d4f4b62acfe428ad789a6,0,David Reiss,2008-01-18 07:39:36+00:00,['5b3cbd13d60433f231697e8e39d3ffa6d73398b3'],3,2,5,163382,1,1,1,1,633
a9a4d481e08b44972324db1620871cd1a83a804f,0,Christopher Piro,2008-01-18 21:35:34+00:00,['050f3200a2963d00212d4f4b62acfe428ad789a6'],0,68,68,163450,1,0.072727273,0.072727273,0.927272727,633
1e150185daeb953d8ed1b91cc9694bbacb5518e5,0,Mark Slee,2008-01-22 04:04:30+00:00,['a9a4d481e08b44972324db1620871cd1a83a804f'],0,5,5,163455,1,0,0,1,633
b0232b39e365b25d2aab5e6dc76e4b40cb37d74f,0,David Reiss,2008-01-23 20:35:39+00:00,['1e150185daeb953d8ed1b91cc9694bbacb5518e5'],12,32,44,163499,2,0,1,1,633
0e87ef7ae72e4f897adca447f1932147cb05a57e,0,David Reiss,2008-01-25 20:05:50+00:00,['b0232b39e365b25d2aab5e6dc76e4b40cb37d74f'],5,5,10,163509,1,,,,633
41911a516663fec077b4b5228fc66ddebc1aae47,0,David Reiss,2008-01-25 20:12:26+00:00,['0e87ef7ae72e4f897adca447f1932147cb05a57e'],2,3,5,163514,1,0,1,1,633
fe6d1488eb5196764c7fa41190dd5f2e1fac0e3f,0,David Reiss,2008-01-28 20:46:50+00:00,['41911a516663fec077b4b5228fc66ddebc1aae47'],1,1,2,163516,1,1,0,0,633
f09b8a01b1082f581442a08d6e28891e2495c0a6,0,David Reiss,2008-01-28 20:46:53+00:00,['fe6d1488eb5196764c7fa41190dd5f2e1fac0e3f'],13,16,29,163545,1,0,0,1,633
3e6583365a3e0106cb656765290e768f5b5077ef,1,David Reiss,2008-01-28 20:46:57+00:00,['f09b8a01b1082f581442a08d6e28891e2495c0a6'],0,22,22,163567,2,0.058823529,1,0.823529412,633
073e2cfeb5eea795ca6941774633243d3958e970,0,David Reiss,2008-01-28 20:47:00+00:00,['3e6583365a3e0106cb656765290e768f5b5077ef'],0,16,16,163583,2,0.769230769,1,0.769230769,633
aa93451dbfd068c4e661e646b3e8a24f1f7ee29a,0,Christopher Piro,2008-01-30 01:39:01+00:00,['073e2cfeb5eea795ca6941774633243d3958e970'],29,28,57,163640,3,,,,633
61959f5d9deb0e3535ee727f0c3ca694f3b40173,0,Mark Slee,2008-01-30 23:23:15+00:00,['aa93451dbfd068c4e661e646b3e8a24f1f7ee29a'],17,23,40,163680,2,0,0,0,633
8d4b1cc3ab706c8116e279782a1773f5b011860a,0,Mark Slee,2008-01-31 00:06:29+00:00,['61959f5d9deb0e3535ee727f0c3ca694f3b40173'],13,8,21,163701,2,0,0,1,633
91f2b7b2f71dc67bc90f5eed0de99dbb9317d793,0,Mark Slee,2008-01-31 01:49:16+00:00,['8d4b1cc3ab706c8116e279782a1773f5b011860a'],0,23,23,163724,3,1,1,1,633
5cf89c1610e54609b551f7d46d2745c2f16d00c2,0,Mark Slee,2008-01-31 22:02:26+00:00,['91f2b7b2f71dc67bc90f5eed0de99dbb9317d793'],5,20,25,163749,2,0,0.692307692,0,633
f07d48e812e5761239c9d34cae35e52e15d1a99e,0,Mark Slee,2008-02-01 01:36:26+00:00,['5cf89c1610e54609b551f7d46d2745c2f16d00c2'],1,1,2,163751,1,,,,633
84e5022bfc9a815ce5f14e6effd980c6672da872,0,dweatherford,2008-02-01 20:42:56+00:00,['f07d48e812e5761239c9d34cae35e52e15d1a99e'],1,1,2,163753,1,,,,633
d46eb09befca3e43b01a00476611c7a0c0fc0254,0,David Reiss,2008-02-02 00:54:48+00:00,['84e5022bfc9a815ce5f14e6effd980c6672da872'],47,55,102,163855,6,0,0,1,633
f495f367c9d7dd89c15b9732a7ac8d0db43596bf,0,David Reiss,2008-02-02 00:54:55+00:00,['d46eb09befca3e43b01a00476611c7a0c0fc0254'],5,44,49,163904,2,0,0,1,633
46379900138403d9012cc504d9143d971920ec91,0,David Reiss,2008-02-04 19:23:57+00:00,['f495f367c9d7dd89c15b9732a7ac8d0db43596bf'],2,2,4,163908,1,,,,633
20f009d6251af0f838c4ef8799d6b238cd230606,0,David Reiss,2008-02-04 19:24:00+00:00,['46379900138403d9012cc504d9143d971920ec91'],1,1,2,163910,1,,,,633
8180c0c028d11086f6dd042e637af7c38db073f2,0,David Reiss,2008-02-04 21:14:14+00:00,['20f009d6251af0f838c4ef8799d6b238cd230606'],45,71,116,164026,9,,,,634
e6ec4141a882867663eaf5664d70305d97f273fc,1,David Reiss,2008-02-04 21:28:20+00:00,['8180c0c028d11086f6dd042e637af7c38db073f2'],0,6,6,164032,1,,,,634
adb5cad7d32c1dd2f11b18b8d0f14b6955df3606,0,Mark Slee,2008-02-04 21:34:22+00:00,['e6ec4141a882867663eaf5664d70305d97f273fc'],1,1,2,164034,1,,,,634
f7baf549bcea8793f7882eb7e01cb3affaea97b8,1,David Reiss,2008-02-04 21:56:27+00:00,['adb5cad7d32c1dd2f11b18b8d0f14b6955df3606'],42,126,168,164202,2,0,0.05,0.5,634
e4667378c4e30f1b7b465e89837462a2fed28b16,0,David Reiss,2008-02-06 18:22:39+00:00,['f7baf549bcea8793f7882eb7e01cb3affaea97b8'],3,3,6,164208,1,,,,634
cba5727a3fc49a1c8e93bc8cfd5ba4e20326cbc3,1,David Reiss,2008-02-06 22:09:44+00:00,['e4667378c4e30f1b7b465e89837462a2fed28b16'],16,37,53,164261,5,0.380952381,0.380952381,0.571428571,634
46dc62950d24cf785415de040255b3b0c67ecb3a,1,David Reiss,2008-02-06 22:09:58+00:00,['cba5727a3fc49a1c8e93bc8cfd5ba4e20326cbc3'],36,11,47,164308,8,0,0,0,634
1fdb59242a697202587c3ef714e703144073dfbb,1,David Reiss,2008-02-06 22:10:12+00:00,['46dc62950d24cf785415de040255b3b0c67ecb3a'],0,47,47,164355,4,,,,635
3160971286aea0d5b28d5a7a87acaa8a12209ef8,0,David Reiss,2008-02-06 22:10:26+00:00,['1fdb59242a697202587c3ef714e703144073dfbb'],1,8,9,164364,2,,,,635
0c90f6f8af1d64ec9272bb2f6092336f3d0b8df8,0,David Reiss,2008-02-06 22:18:40+00:00,['3160971286aea0d5b28d5a7a87acaa8a12209ef8'],1017,1017,2034,166398,206,,,,635
3c5d2fd9a87f3bdb07aac7afa2c50e5e90d88fa8,0,David Reiss,2008-02-08 21:58:06+00:00,['0c90f6f8af1d64ec9272bb2f6092336f3d0b8df8'],4,13,17,166415,2,0,1,1,635
a8de4895f61196d6bf139c3becbad5800b977e1c,0,Mark Slee,2008-02-09 00:02:26+00:00,['3c5d2fd9a87f3bdb07aac7afa2c50e5e90d88fa8'],21,26,47,166462,7,0,0.666666667,0,635
22360b2f30ae980bd78d114f1acb73a03053951e,1,Mark Slee,2008-02-09 00:18:32+00:00,['a8de4895f61196d6bf139c3becbad5800b977e1c'],29,45,74,166536,3,0.166666667,0.166666667,0.166666667,635
6756f1351a718b33a09ed17781e40339fa2ef8cf,1,Mark Slee,2008-02-09 00:26:29+00:00,['22360b2f30ae980bd78d114f1acb73a03053951e'],0,17,17,166553,1,0,0,1,635
407c9e7865ba63409bb842b9286f18fb3d19abc5,0,David Reiss,2008-02-09 02:51:43+00:00,['6756f1351a718b33a09ed17781e40339fa2ef8cf'],4,11,15,166568,2,0,0,0,635
55aebc404b52971909e8edd41c03c49b398698c1,1,iproctor,2008-02-11 22:59:01+00:00,['407c9e7865ba63409bb842b9286f18fb3d19abc5'],125,122,247,166815,4,,,,635
7ed4b98a44e8af506991634482a41da77c1b7838,0,David Reiss,2008-02-11 23:24:47+00:00,['55aebc404b52971909e8edd41c03c49b398698c1'],0,9,9,166824,1,,,,635
bd03e3e40e4117ffb32fe5d4ed703f0f7c233680,0,eletuchy,2008-02-13 00:48:15+00:00,['7ed4b98a44e8af506991634482a41da77c1b7838'],1,2,3,166827,1,,,,635
dd43eb85c767118c89137dc5ac5b9f29f2cc80f6,0,Mark Slee,2008-02-13 22:03:15+00:00,['bd03e3e40e4117ffb32fe5d4ed703f0f7c233680'],4,4,8,166835,1,,,,635
260a5fa08e87643bd5c001cc25311e9074795cfc,0,eletuchy,2008-02-13 22:41:03+00:00,['dd43eb85c767118c89137dc5ac5b9f29f2cc80f6'],1,1,2,166837,1,,,,635
bbf8062e4f37bde9e698e080b9f2017dd93bbfc6,0,eletuchy,2008-02-13 22:44:24+00:00,['260a5fa08e87643bd5c001cc25311e9074795cfc'],3,7,10,166847,1,0,0,1,635
bc444b034e79b521b0512198a1feaa37da6d3ee7,0,David Reiss,2008-02-14 20:20:08+00:00,['bbf8062e4f37bde9e698e080b9f2017dd93bbfc6'],1,3,4,166851,1,0,0,0,635
9ff3b9d5fc823fdc0d25cb3e034b00d098ebbdda,1,David Reiss,2008-02-15 01:10:23+00:00,['bc444b034e79b521b0512198a1feaa37da6d3ee7'],32,145,177,167028,10,0.648148148,1,0.907407407,637
c005b1b65ed24bba18e843c85b9a2a281bfec265,0,David Reiss,2008-02-15 01:38:18+00:00,['9ff3b9d5fc823fdc0d25cb3e034b00d098ebbdda'],5,51,56,167084,10,0.655172414,0.655172414,0.655172414,637
db0ea15310339c504f37128e49421bba58051933,1,David Reiss,2008-02-18 01:49:37+00:00,['c005b1b65ed24bba18e843c85b9a2a281bfec265'],0,1516,1516,168600,8,0.489678899,0.762614679,0.88646789,642
9590a4c9ccc2fde8b9c65407ec1e36e892db1db1,0,David Reiss,2008-02-18 02:11:39+00:00,['db0ea15310339c504f37128e49421bba58051933'],2,2,4,168604,2,,,,642
2ab6fe88e26b5570bcdb357fdf6c1ee84b37bd44,0,David Reiss,2008-02-18 02:11:44+00:00,['9590a4c9ccc2fde8b9c65407ec1e36e892db1db1'],0,49,49,168653,5,0.384615385,0.384615385,1,642
db893b617f3cd4e7170ced145d75a8a16d7abc97,1,David Reiss,2008-02-18 02:11:48+00:00,['2ab6fe88e26b5570bcdb357fdf6c1ee84b37bd44'],1,13,14,168667,2,1,1,1,642
2845b52f47a361d89434b3234545811e082f7716,0,David Reiss,2008-02-18 02:11:52+00:00,['db893b617f3cd4e7170ced145d75a8a16d7abc97'],0,16,16,168683,1,0,0,1,642
d7a16f4c111599f8b78905df70f0f60af0721e08,1,David Reiss,2008-02-19 22:47:29+00:00,['2845b52f47a361d89434b3234545811e082f7716'],20,26,46,168729,9,,,,642
399442be815c460065766e4b45ba754b3ca4ab32,0,David Reiss,2008-02-20 02:28:05+00:00,['d7a16f4c111599f8b78905df70f0f60af0721e08'],1,1,2,168731,1,,,,642
c91d07c784e603dfb49a0721bab34b0ff960fc3f,0,David Reiss,2008-02-20 05:30:55+00:00,['399442be815c460065766e4b45ba754b3ca4ab32'],1,1,2,168733,1,,,,642
215ba5c310dd82b56805982634b346e3f99c6a49,0,Christopher Piro,2008-02-20 08:19:38+00:00,['c91d07c784e603dfb49a0721bab34b0ff960fc3f'],1,6,7,168740,1,,,,642
1e62ab468cda132ae29b849d7c1ea4eac141140b,0,David Reiss,2008-02-21 22:37:45+00:00,['215ba5c310dd82b56805982634b346e3f99c6a49'],94,115,209,168949,2,1,0.555555556,1,642
132cc46d07a2b92f273b37f4c163b03a001f1a5a,0,David Reiss,2008-02-21 22:49:58+00:00,['1e62ab468cda132ae29b849d7c1ea4eac141140b'],3,7,10,168959,1,,,,642
dab2ad85dab534fb0488ce530d5231261c56487c,1,David Reiss,2008-02-23 21:56:16+00:00,['132cc46d07a2b92f273b37f4c163b03a001f1a5a'],22,5,27,168986,2,,,,642
f8dcf03416bec49ee4ba7cc1615f61fa5e5419d7,1,David Reiss,2008-02-23 22:07:39+00:00,['dab2ad85dab534fb0488ce530d5231261c56487c'],1,296,297,169283,4,,,,644
4f15f59bca8cf4c1aa6ccb2ea75ce4cba5a77447,0,David Reiss,2008-02-23 22:07:43+00:00,['f8dcf03416bec49ee4ba7cc1615f61fa5e5419d7'],2,2,4,169287,1,,,,644
ff50f28700b68264f2d54d8f6fb3b929b64c5a32,1,David Reiss,2008-02-23 22:07:46+00:00,['4f15f59bca8cf4c1aa6ccb2ea75ce4cba5a77447'],0,11,11,169298,3,,,,645
223d6bd1ac0c033aa01cad3aad8051df8a161a49,0,David Reiss,2008-02-24 02:03:17+00:00,['ff50f28700b68264f2d54d8f6fb3b929b64c5a32'],0,2,2,169300,2,,,,645
2ca456a8ae1599a2112eed0ddffa922657c8b123,1,David Reiss,2008-02-24 16:42:18+00:00,['223d6bd1ac0c033aa01cad3aad8051df8a161a49'],12,12,24,169324,11,,,,645
3de1c4e4d33cc5c32809771f2bbec746501d1f94,0,David Reiss,2008-02-24 17:45:03+00:00,['2ca456a8ae1599a2112eed0ddffa922657c8b123'],3,3,6,169330,3,,,,645
01d187cb801a3c0462af337a8f0b6f0e2b1f2ec3,1,veeve,2008-02-26 05:12:08+00:00,['3de1c4e4d33cc5c32809771f2bbec746501d1f94'],0,34,34,169364,3,1,1,1,646
ebbfbd83956e3e85c9be7b419b0f4d2748f866e7,1,David Reiss,2008-02-26 06:40:16+00:00,['01d187cb801a3c0462af337a8f0b6f0e2b1f2ec3'],2,2,4,169368,1,,,,646
68ccc699a398ed47cde0ad1d405f94241fed6068,0,David Reiss,2008-02-26 06:40:22+00:00,['ebbfbd83956e3e85c9be7b419b0f4d2748f866e7'],16,1,17,169385,2,0.230769231,0,0.230769231,646
0e18224473b8bad918e060900663a9d0058d7196,1,David Reiss,2008-02-26 06:40:25+00:00,['68ccc699a398ed47cde0ad1d405f94241fed6068'],1,7,8,169393,1,0,1,1,646
698713cf644661faa935f0b5cdee2b8e4a99f1a2,0,eletuchy,2008-02-26 11:44:00+00:00,['0e18224473b8bad918e060900663a9d0058d7196'],3,13,16,169409,1,,,,646
c81e82bc26c309d2875b9eb4b946cabe6c0e9481,0,eletuchy,2008-02-26 12:11:29+00:00,['698713cf644661faa935f0b5cdee2b8e4a99f1a2'],17,2,19,169428,1,,,,646
9cc2c137102ce4b5a2e0d362832ea1021c20ca19,0,David Reiss,2008-02-27 01:54:47+00:00,['c81e82bc26c309d2875b9eb4b946cabe6c0e9481'],0,10,10,169438,1,0,0,1,646
bd0db88477f02c67962c638c8dfb5f2bb6619144,1,David Reiss,2008-02-27 01:54:51+00:00,['9cc2c137102ce4b5a2e0d362832ea1021c20ca19'],4,183,187,169625,3,0.367346939,0.510204082,0.785714286,646
400cd4be38bc422859b9506fb084495a1ac78e6d,0,David Reiss,2008-02-27 01:54:55+00:00,['bd0db88477f02c67962c638c8dfb5f2bb6619144'],18,32,50,169675,3,1,0.428571429,0,646
52812f98db860d1703b08cebefa61fd2a89e899c,0,David Reiss,2008-02-27 01:54:59+00:00,['400cd4be38bc422859b9506fb084495a1ac78e6d'],227,217,444,170119,3,,,,646
e1404d21ac1276176167cf11d7ad0150a9178dae,1,David Reiss,2008-02-27 01:55:05+00:00,['52812f98db860d1703b08cebefa61fd2a89e899c'],21,25,46,170165,3,1,1,0,646
dc61be96505383f8832da53ca41a6d13b15bcd5c,1,David Reiss,2008-02-27 01:55:09+00:00,['e1404d21ac1276176167cf11d7ad0150a9178dae'],182,172,354,170519,3,,,,646
79eca14125c391c6011f4ffb14bfea898bc6c2f9,1,David Reiss,2008-02-27 01:55:13+00:00,['dc61be96505383f8832da53ca41a6d13b15bcd5c'],4,19,23,170542,2,1,1,1,646
9a08dc6184cd0c3fd3d774fcf3f0a4233e28975f,0,David Reiss,2008-02-27 01:55:17+00:00,['79eca14125c391c6011f4ffb14bfea898bc6c2f9'],29,20,49,170591,14,0,0,0,646
771f8c797b1920919aadcb63d9e1dab3cd1905f6,0,David Reiss,2008-02-27 01:55:25+00:00,['9a08dc6184cd0c3fd3d774fcf3f0a4233e28975f'],20,11,31,170622,9,0,0,0,646
add584d8f957347c0b5394a9562181a87d4eb468,0,David Reiss,2008-02-27 01:55:30+00:00,['771f8c797b1920919aadcb63d9e1dab3cd1905f6'],0,22,22,170644,1,,,,647
22585733e1d2b61aa8b588a94626d40b3f4dd978,0,David Reiss,2008-02-27 01:55:33+00:00,['add584d8f957347c0b5394a9562181a87d4eb468'],1,7,8,170652,2,,,,647
9db977f5bd83bf7a2c915d1bdd0397e902f52d2f,0,David Reiss,2008-02-27 07:45:00+00:00,['b1b8079e62e6bfffd171da8406370dd26dfb2071'],4,4,8,170666,2,,,,647
4ce2874fd50acaff7fa5b0f571098f50623752cc,0,David Reiss,2008-02-27 07:45:05+00:00,['9db977f5bd83bf7a2c915d1bdd0397e902f52d2f'],4,14,18,170684,2,0.5,1,0.5,647
10ae20f684a364f3c7f4151e8ea93993593e3b15,0,David Reiss,2008-02-27 07:45:10+00:00,['4ce2874fd50acaff7fa5b0f571098f50623752cc'],1,1,2,170686,1,,,,647
efe64a6cc501f69fa07adc37c7be3664bdbcdfbe,0,eletuchy,2008-02-27 16:31:01+00:00,['10ae20f684a364f3c7f4151e8ea93993593e3b15'],3,14,17,170703,1,,,,647
7dc23bce4bef0a826a0a737222029874334e4b47,0,eletuchy,2008-02-27 17:41:05+00:00,['efe64a6cc501f69fa07adc37c7be3664bdbcdfbe'],1,5,6,170709,1,,,,647
57fd32c796256e5523197921d950d2c496f46865,0,eletuchy,2008-02-27 17:43:40+00:00,['7dc23bce4bef0a826a0a737222029874334e4b47'],7,9,16,170725,1,,,,647
53e571968f2ba9e0cba7e7e22962a22d610afcdb,0,eletuchy,2008-02-27 18:38:42+00:00,['57fd32c796256e5523197921d950d2c496f46865'],1,1,2,170727,1,,,,647
f0cf2a37456034d699b396b7f9cdd28ba467500e,0,eletuchy,2008-02-27 19:27:41+00:00,['53e571968f2ba9e0cba7e7e22962a22d610afcdb'],1,1,2,170729,1,,,,647
cf2e8d9af3650212ed02d61e3f21c4eb29c6ffa4,0,David Reiss,2008-02-27 19:38:51+00:00,['f0cf2a37456034d699b396b7f9cdd28ba467500e'],0,7,7,170736,1,0,0,0,647
38d199b87930d6abed82c5ad408bdf8691b398a1,0,eletuchy,2008-02-27 19:55:15+00:00,['cf2e8d9af3650212ed02d61e3f21c4eb29c6ffa4'],1,4,5,170741,1,,,,647
7d2ab9fd43a51ae93c70a7920baa54c4be472364,0,eletuchy,2008-02-27 19:56:52+00:00,['38d199b87930d6abed82c5ad408bdf8691b398a1'],1,1,2,170743,1,,,,647
4b6a3c7a686a401e3e0eac972bfa1a96eabc198b,0,David Reiss,2008-02-27 22:28:12+00:00,['7d2ab9fd43a51ae93c70a7920baa54c4be472364'],10,10,20,170763,1,1,1,0,647
6f3507c42574a6e8a58e10e07c58c3ba434b4e7a,0,eletuchy,2008-02-27 23:50:21+00:00,['4b6a3c7a686a401e3e0eac972bfa1a96eabc198b'],3,7,10,170773,1,,,,647
1a3546464dcbb4ff59fae50c6463a4ea78d4df74,0,David Reiss,2008-02-28 21:11:34+00:00,['6f3507c42574a6e8a58e10e07c58c3ba434b4e7a'],2,10,12,170785,1,,,,647
9163073ca120478733602d42e344f14c241ad2d1,0,David Reiss,2008-02-28 21:11:39+00:00,['1a3546464dcbb4ff59fae50c6463a4ea78d4df74'],0,3,3,170788,1,0.333333333,0.666666667,1,647
6d0cccd64000ae35ce1e648020f852ba333a5ba2,1,David Reiss,2008-02-28 21:20:12+00:00,['9163073ca120478733602d42e344f14c241ad2d1'],13,91,104,170892,2,0.4,0,1,647
f50021af668da8a143a5dfd764c5380c0a330a39,0,David Reiss,2008-02-29 07:33:47+00:00,['6d0cccd64000ae35ce1e648020f852ba333a5ba2'],0,3,3,170895,1,0,0,1,647
2c9824c5bdd3d9aefa0c1edb4538c996e4d513dd,0,David Reiss,2008-03-02 00:20:47+00:00,['f50021af668da8a143a5dfd764c5380c0a330a39'],1,1,2,170897,1,,,,647
907ad76c2db1ae834ea8d09a0aca86da008c261f,0,David Reiss,2008-03-02 00:25:58+00:00,['2c9824c5bdd3d9aefa0c1edb4538c996e4d513dd'],2,29,31,170928,2,1,1,1,647
dc815f5402deeaa6ddd25c536bf912be59438d57,0,David Reiss,2008-03-02 00:58:04+00:00,['907ad76c2db1ae834ea8d09a0aca86da008c261f'],2,43,45,170973,3,0.25,0,1,647
c0fef71697303057c72e546fa06a37fb3e585320,0,David Reiss,2008-03-02 06:29:12+00:00,['dc815f5402deeaa6ddd25c536bf912be59438d57'],2,0,2,170975,1,,,,647
d2a3e566b7814cfe176dd988854f6b3dca6a47d7,1,David Reiss,2008-03-02 06:29:16+00:00,['c0fef71697303057c72e546fa06a37fb3e585320'],0,85,85,171060,1,1,1,0.681818182,648
3b15ebc251adc63d9c330c50e9a399e8117bdf35,1,David Reiss,2008-03-02 06:29:19+00:00,['d2a3e566b7814cfe176dd988854f6b3dca6a47d7'],7,2086,2093,173153,6,0,0.012269939,0.999318337,650
14feb4127c03bf164c0268eb2c0c29f2fb308bae,1,David Reiss,2008-03-02 06:29:23+00:00,['3b15ebc251adc63d9c330c50e9a399e8117bdf35'],11,63,74,173227,2,0,0.175,0.95,650
b3483d0b2c7fbf923a63d6f138ada8d2fc53cbab,0,David Reiss,2008-03-02 07:00:15+00:00,['14feb4127c03bf164c0268eb2c0c29f2fb308bae'],1,1,2,173229,1,,,,650
be5ee7c191ec125c80f4221c3231b254b3bcb145,0,David Reiss,2008-03-02 07:00:19+00:00,['b3483d0b2c7fbf923a63d6f138ada8d2fc53cbab'],2,15,17,173246,1,,,,650
62d3981c9e2f118c098774f40138a65803136a8d,0,David Reiss,2008-03-02 07:00:22+00:00,['be5ee7c191ec125c80f4221c3231b254b3bcb145'],3,6,9,173255,1,,,,650
520b5eec8f85ce6b524021c026677d1991ad72f6,0,David Reiss,2008-03-02 07:00:26+00:00,['62d3981c9e2f118c098774f40138a65803136a8d'],1,4,5,173260,1,,,,650
9f646157f0c22f021343df778df5ed3fcd8da933,0,David Reiss,2008-03-02 21:59:48+00:00,['520b5eec8f85ce6b524021c026677d1991ad72f6'],1,1,2,173262,1,,,,650
cf997a45c6a79ff662679003fa0904c9a73454de,1,dweatherford,2008-03-04 01:08:23+00:00,['9f646157f0c22f021343df778df5ed3fcd8da933'],835,1032,1867,175129,10,0.32,0.67,0.925,652
b6f18c20ee5db403047b803f4ce64d6a17abf978,1,Christopher Piro,2008-03-04 07:09:12+00:00,['cf997a45c6a79ff662679003fa0904c9a73454de'],2,13,15,175144,3,,,,652
cdd6f3c029657ca8ac97393f6d76b89b6616b470,0,David Reiss,2008-03-04 21:10:29+00:00,['b6f18c20ee5db403047b803f4ce64d6a17abf978'],1,1,2,175146,1,,,,652
a014788f732e20484d6e8f24180f663c64643d1f,0,David Reiss,2008-03-04 21:10:34+00:00,['cdd6f3c029657ca8ac97393f6d76b89b6616b470'],9,7,16,175162,1,1,0,0,652
4ac9267cf8f38d1b802ccb95e0e978414118b4fe,0,David Reiss,2008-03-04 21:10:38+00:00,['a014788f732e20484d6e8f24180f663c64643d1f'],12,14,26,175188,1,0,1,1,652
6987535d65529be108f36a51f8a603d675c89e16,0,David Reiss,2008-03-04 21:10:41+00:00,['4ac9267cf8f38d1b802ccb95e0e978414118b4fe'],1,1,2,175190,1,,,,652
631dcb42d1be0896c14e7830a45a5db4e3ee5ef6,1,David Reiss,2008-03-05 07:51:40+00:00,['6987535d65529be108f36a51f8a603d675c89e16'],15,33,48,175238,1,1,1,1,652
edde04804b3cf6196a6f19d5c08a8df619d7a0e2,0,David Reiss,2008-03-05 07:51:44+00:00,['631dcb42d1be0896c14e7830a45a5db4e3ee5ef6'],15,46,61,175299,2,1,1,1,652
a79e48874bfe03cf7195474719a85f4633931050,0,David Reiss,2008-03-05 07:51:47+00:00,['edde04804b3cf6196a6f19d5c08a8df619d7a0e2'],5,6,11,175310,1,,,,652
f8f21e769e7c7344c32d920a9825b27cbef1fbcc,0,lucas,2008-03-05 22:04:13+00:00,['a79e48874bfe03cf7195474719a85f4633931050'],0,375,375,175685,3,0.227091633,0.302788845,0.430278884,655
9b945da3ca84b2e27c5cb0e62bfe5eafcf28b45b,1,dweatherford,2008-03-06 03:11:08+00:00,['f8f21e769e7c7344c32d920a9825b27cbef1fbcc'],5,5,10,175695,1,,,,655
4a8f46ca0b449654626e7a68861d2fabb3fb9f48,0,David Reiss,2008-03-07 20:12:07+00:00,['9b945da3ca84b2e27c5cb0e62bfe5eafcf28b45b'],0,31,31,175726,2,0,1,1,655
80f6398b63cfd3679fa9957f9563dc182213968d,0,David Reiss,2008-03-07 20:12:13+00:00,['4a8f46ca0b449654626e7a68861d2fabb3fb9f48'],0,1,1,175727,1,,,,655
a7f879b81f9058c5843d5b1bffeb8224db1c3a3b,0,David Reiss,2008-03-07 20:12:17+00:00,['80f6398b63cfd3679fa9957f9563dc182213968d'],0,73,73,175800,1,1,1,0.52,656
ea5e75af3ba79dc8a2893f959d52d284e806de86,1,David Reiss,2008-03-07 20:12:20+00:00,['a7f879b81f9058c5843d5b1bffeb8224db1c3a3b'],3,1205,1208,177008,4,0.404092072,0.569053708,0.947570332,659
2c2dc67fd87eb7d293eb689199cd5b631bd67523,0,David Reiss,2008-03-07 20:12:25+00:00,['ea5e75af3ba79dc8a2893f959d52d284e806de86'],0,63,63,177071,1,,,,660
84e63abf2ef29725b45a0266a94abffe27046ed7,0,David Reiss,2008-03-07 20:12:28+00:00,['2c2dc67fd87eb7d293eb689199cd5b631bd67523'],1,1,2,177073,1,,,,660
0e913a6381c5dc6b50460d18e2490165db4de629,0,David Reiss,2008-03-07 20:28:31+00:00,['84e63abf2ef29725b45a0266a94abffe27046ed7'],0,11,11,177084,1,0,0,1,660
840ca085fcfe737554ede28088d4ae9adf457216,1,dweatherford,2008-03-08 05:51:24+00:00,['0e913a6381c5dc6b50460d18e2490165db4de629'],19,31,50,177134,1,0,0,0,660
6b53bbb77881ceb149e468e7e5082f82b50c07d9,0,dweatherford,2008-03-11 02:42:45+00:00,['840ca085fcfe737554ede28088d4ae9adf457216'],4,3,7,177141,1,1,1,0,660
85c44c559b01a7106e1033b1c55548f16c9f8328,0,David Reiss,2008-03-11 21:41:47+00:00,['6b53bbb77881ceb149e468e7e5082f82b50c07d9'],0,2,2,177143,1,,,,660
21c95a31ee8228009469a8d63f4f33d509f11819,0,Christopher Piro,2008-03-12 04:28:43+00:00,['85c44c559b01a7106e1033b1c55548f16c9f8328'],1,1,2,177145,1,,,,660
6d94390375e865e0c774df1dc072ea1774eba7b1,0,David Reiss,2008-03-14 00:51:42+00:00,['21c95a31ee8228009469a8d63f4f33d509f11819'],1,6,7,177152,1,1,1,0,660
8f3bce4153a17dbf6a188bb80f589eadbd0de5e2,0,David Reiss,2008-03-18 18:21:52+00:00,['6d94390375e865e0c774df1dc072ea1774eba7b1'],17,41,58,177210,2,1,1,1,660
b79acc9f60aabcc9ad203d65e758cb2445763854,0,David Reiss,2008-03-18 18:21:58+00:00,['8f3bce4153a17dbf6a188bb80f589eadbd0de5e2'],58,60,118,177328,1,0,0,1,660
cdfbeb8d756c3f76fa2ac8a62e48ca81e46674f1,0,David Reiss,2008-03-18 18:22:14+00:00,['b79acc9f60aabcc9ad203d65e758cb2445763854'],1,11,12,177340,1,0,0,1,660
968bed847ee347a6f1ff71ebc5172154dcc03182,0,David Reiss,2008-03-18 18:22:26+00:00,['cdfbeb8d756c3f76fa2ac8a62e48ca81e46674f1'],1,2,3,177343,1,1,1,1,660
c9d06ee2ddf02d7ae93c13d3121fb7bab88d22dc,0,David Reiss,2008-03-18 18:22:43+00:00,['968bed847ee347a6f1ff71ebc5172154dcc03182'],0,6,6,177349,6,1,1,0.5,660
fc78b2363387f6d139690edd3a9411369214b724,0,David Reiss,2008-03-18 18:22:52+00:00,['c9d06ee2ddf02d7ae93c13d3121fb7bab88d22dc'],5,21,26,177375,1,0,0,1,660
d92ca7dcea105837e3e576f797501c19929eced5,0,David Reiss,2008-03-18 19:32:00+00:00,['fc78b2363387f6d139690edd3a9411369214b724'],6,48,54,177429,1,0.7,0.7,0,660
dcdf25b003ea0caedcbeda5c700144416faaee52,0,Mark Slee,2008-03-19 20:16:35+00:00,['d92ca7dcea105837e3e576f797501c19929eced5'],1,1,2,177431,1,,,,660
9cc63b53ef0ed88ee96cb5584504ff1b38d62288,0,Christopher Piro,2008-03-21 00:40:42+00:00,['dcdf25b003ea0caedcbeda5c700144416faaee52'],0,36,36,177467,2,0.384615385,0.384615385,0.923076923,660
62f0d5428d00281ca412164c478c850cfa45305d,0,David Reiss,2008-03-21 21:50:41+00:00,['9cc63b53ef0ed88ee96cb5584504ff1b38d62288'],6,2,8,177475,1,1,1,0,660
0b8a382c00c6756bd4611e2aa7545d8fe8e82598,1,dweatherford,2008-03-25 03:15:10+00:00,['62f0d5428d00281ca412164c478c850cfa45305d'],0,3,3,177478,1,0,0,0,660
0c703cc2f8dd85016a2d7f19b31b09aee42361e0,1,David Reiss,2008-03-25 18:38:56+00:00,['0b8a382c00c6756bd4611e2aa7545d8fe8e82598'],3,5,8,177486,1,0,1,1,660
2d2aa145b4b9595fb128009536528ce533df1be1,1,David Reiss,2008-03-26 07:22:26+00:00,['0c703cc2f8dd85016a2d7f19b31b09aee42361e0'],26,38,64,177550,1,,,,660
4b83d6ddeb2d9b5a4102839cfe0d38fe2c72411d,0,David Reiss,2008-03-27 19:45:19+00:00,['2d2aa145b4b9595fb128009536528ce533df1be1'],6,40,46,177596,2,0.333333333,1,1,660
7502e0be13ca6748cb501de0c6c4eaaeba6ec499,1,David Reiss,2008-03-27 19:45:24+00:00,['4b83d6ddeb2d9b5a4102839cfe0d38fe2c72411d'],4,4,8,177604,2,,,,660
c93426824974594efb0332bb26be1cd35c67a842,0,David Reiss,2008-03-27 21:39:49+00:00,['7502e0be13ca6748cb501de0c6c4eaaeba6ec499'],0,1,1,177605,1,0,0,1,660
f10984b5890af0b662e46f6d594a8ebf3c35027a,0,David Reiss,2008-03-27 21:39:52+00:00,['c93426824974594efb0332bb26be1cd35c67a842'],0,1,1,177606,1,,,,660
d6609e2b627d69aa191376bcd47046a627aa91d3,1,David Reiss,2008-03-27 21:39:55+00:00,['f10984b5890af0b662e46f6d594a8ebf3c35027a'],2,6,8,177614,1,,,,660
237171ee8118396fd45db8ac039832932c69992a,0,David Reiss,2008-03-27 21:39:58+00:00,['d6609e2b627d69aa191376bcd47046a627aa91d3'],1,0,1,177615,1,,,,660
b4d7b89efd635c8ca2407c63a73ed7ab0983fbd1,0,David Reiss,2008-03-27 21:40:01+00:00,['237171ee8118396fd45db8ac039832932c69992a'],2,2,4,177619,1,,,,660
f0521b1305aaa0900f02a09ac743cef21f4befe7,0,David Reiss,2008-03-27 21:40:05+00:00,['b4d7b89efd635c8ca2407c63a73ed7ab0983fbd1'],12,14,26,177645,3,1,1,0,660
7bb71df6efb2529ea3f3d1baf86fb6f102ca3e4f,0,David Reiss,2008-03-27 21:40:08+00:00,['f0521b1305aaa0900f02a09ac743cef21f4befe7'],154,143,297,177942,3,,,,660
3d671b5e537482e40e4869dbe0235edf496b3184,0,David Reiss,2008-03-27 21:40:11+00:00,['7bb71df6efb2529ea3f3d1baf86fb6f102ca3e4f'],1,5,6,177948,2,,,,660
af3ab2619d7969ac5bb685d8a8915750dadc6c18,0,David Reiss,2008-03-27 21:40:16+00:00,['3d671b5e537482e40e4869dbe0235edf496b3184'],13,14,27,177975,3,1,1,0,660
42e6d5143761fc0e20254a46a15e3da59ca0ac51,0,David Reiss,2008-03-27 21:40:20+00:00,['af3ab2619d7969ac5bb685d8a8915750dadc6c18'],150,139,289,178264,3,,,,660
22812f8be82d2e2336a0a99950940c743375a76c,0,David Reiss,2008-03-27 21:40:26+00:00,['42e6d5143761fc0e20254a46a15e3da59ca0ac51'],1,5,6,178270,2,,,,660
73dc1431d1c3e9b6bd3d17dca597d1889b2ceaf4,0,David Reiss,2008-03-27 21:40:30+00:00,['22812f8be82d2e2336a0a99950940c743375a76c'],5,5,10,178280,2,1,1,1,660
a890b5714e2b556ba6f02140ce679117c183f985,0,David Reiss,2008-03-27 21:40:35+00:00,['73dc1431d1c3e9b6bd3d17dca597d1889b2ceaf4'],12,14,26,178306,3,1,1,0,660
2b6ba090dc895152efe2d9da4b15497e92429d18,1,David Reiss,2008-03-27 21:40:38+00:00,['a890b5714e2b556ba6f02140ce679117c183f985'],133,121,254,178560,3,,,,660
b3ac8a6c7278b26a207d7847211b61b98e84c54d,0,David Reiss,2008-03-27 21:40:42+00:00,['2b6ba090dc895152efe2d9da4b15497e92429d18'],1,5,6,178566,2,,,,660
3b45501b5220ac2e8ab159c6cd8163467300f406,1,David Reiss,2008-03-27 21:40:46+00:00,['b3ac8a6c7278b26a207d7847211b61b98e84c54d'],28,18,46,178612,6,0,0,0,660
be9757568f50ed79f2d9abf2a1acf97c9582eb5d,0,David Reiss,2008-03-27 21:40:52+00:00,['3b45501b5220ac2e8ab159c6cd8163467300f406'],1,1,2,178614,1,,,,660
d01c64dec53373a886fd1fd8de8e5c065db731c9,0,David Reiss,2008-03-27 21:40:55+00:00,['be9757568f50ed79f2d9abf2a1acf97c9582eb5d'],12,14,26,178640,3,1,1,0,660
e21ce4c6ca430f093bf626175088caf2178cc2c3,0,David Reiss,2008-03-27 21:40:59+00:00,['d01c64dec53373a886fd1fd8de8e5c065db731c9'],186,175,361,179001,3,,,,660
4b349aabc946289a200e5691140e7000b33b9583,0,David Reiss,2008-03-27 21:41:02+00:00,['e21ce4c6ca430f093bf626175088caf2178cc2c3'],1,5,6,179007,2,,,,660
54b602b7468dd1260a3d65d389e449b572cdff0f,0,David Reiss,2008-03-27 21:41:06+00:00,['4b349aabc946289a200e5691140e7000b33b9583'],15,7,22,179029,5,0,0,0,660
919ae80934969d9e6b44d537d5ca5cda7e75a9a9,0,David Reiss,2008-03-27 21:41:11+00:00,['54b602b7468dd1260a3d65d389e449b572cdff0f'],1,1,2,179031,1,,,,660
861869b73435d9673a2df94d1ddb480670192674,0,David Reiss,2008-03-27 21:41:23+00:00,['919ae80934969d9e6b44d537d5ca5cda7e75a9a9'],11,14,25,179056,3,1,1,0,660
2dfdb2d7f761417856ba984cf0d7c29a0bd15f04,1,David Reiss,2008-03-27 21:41:27+00:00,['861869b73435d9673a2df94d1ddb480670192674'],103,93,196,179252,3,,,,660
ce4f4f0cbdeafa355c282b2dd9fa2161c009128f,0,David Reiss,2008-03-27 21:41:31+00:00,['2dfdb2d7f761417856ba984cf0d7c29a0bd15f04'],1,5,6,179258,2,,,,660
9d65bf061f2c9876944e5eddea513a2f50d5e883,0,David Reiss,2008-03-27 21:41:37+00:00,['ce4f4f0cbdeafa355c282b2dd9fa2161c009128f'],17,7,24,179282,6,0,0,0,660
558e3993e1fe5ffacc8c6339cedf3c616c5e253f,0,David Reiss,2008-03-27 21:41:40+00:00,['9d65bf061f2c9876944e5eddea513a2f50d5e883'],14,20,34,179316,3,1,1,0,660
0d6eb969e1bc58d9955e0c48af6a78fb728dfdf8,1,David Reiss,2008-03-27 21:41:45+00:00,['558e3993e1fe5ffacc8c6339cedf3c616c5e253f'],177,166,343,179659,3,,,,660
bfd26dcecc4c2b67814ed6d69fff65121c3a471f,0,David Reiss,2008-03-27 21:41:49+00:00,['0d6eb969e1bc58d9955e0c48af6a78fb728dfdf8'],1,5,6,179665,2,,,,660
320e45ce8b1d2721a7f814c1e1a8288dba36dd14,0,David Reiss,2008-03-27 21:41:54+00:00,['bfd26dcecc4c2b67814ed6d69fff65121c3a471f'],16,7,23,179688,6,0,0,0,660
c53b184c1235eb66d87219fcf53d38a93e998e0f,0,David Reiss,2008-03-27 21:41:58+00:00,['320e45ce8b1d2721a7f814c1e1a8288dba36dd14'],5,0,5,179693,1,0,0,0,660
a640cea9aed3409bef99162434c22649aa239ede,0,David Reiss,2008-03-27 21:42:01+00:00,['c53b184c1235eb66d87219fcf53d38a93e998e0f'],13,14,27,179720,3,1,1,0,660
6e93b454ecc0def6e13cbcece578f9d420266966,1,David Reiss,2008-03-27 21:42:06+00:00,['a640cea9aed3409bef99162434c22649aa239ede'],176,167,343,180063,3,,,,660
ae253583e75b77177dd09533420561d22e1ace6b,0,David Reiss,2008-03-27 21:42:11+00:00,['6e93b454ecc0def6e13cbcece578f9d420266966'],1,5,6,180069,2,,,,660
6a4b82c4b7cc4d77daa6e11f8eb69f1a8f5e3218,0,David Reiss,2008-03-27 21:42:16+00:00,['ae253583e75b77177dd09533420561d22e1ace6b'],16,7,23,180092,6,0,0,0,660
2b386c50d7cf649c928a792bed73bcb938f8501f,0,David Reiss,2008-03-27 21:42:23+00:00,['6a4b82c4b7cc4d77daa6e11f8eb69f1a8f5e3218'],13,14,27,180119,3,1,1,0,660
fb63533c78a833d043b33fd2240076e22732cf19,0,David Reiss,2008-03-27 21:42:30+00:00,['2b386c50d7cf649c928a792bed73bcb938f8501f'],198,187,385,180504,3,,,,660
fdc21aa713ca8ddf19cd2104c4074bdd27211e05,0,David Reiss,2008-03-27 21:42:34+00:00,['fb63533c78a833d043b33fd2240076e22732cf19'],1,5,6,180510,2,,,,660
07ef3a930a8f99b41ce381f9fda3aa6785bd3956,0,David Reiss,2008-03-27 21:42:39+00:00,['fdc21aa713ca8ddf19cd2104c4074bdd27211e05'],19,10,29,180539,8,0,0,0,660
3000b5b1f1fe44cc8a23ca34540c1de4381ada83,1,David Reiss,2008-03-31 21:38:29+00:00,['07ef3a930a8f99b41ce381f9fda3aa6785bd3956'],0,109,109,180648,2,0.209677419,0.209677419,1,662
58b4fa7e26648cf5251029f6ebb73a4c86129354,0,David Reiss,2008-04-01 04:17:58+00:00,['3000b5b1f1fe44cc8a23ca34540c1de4381ada83'],3,3,6,180654,1,,,,662
f5ece05649298ee312841e8e16c6d7467316325c,0,David Reiss,2008-04-02 00:23:31+00:00,['58b4fa7e26648cf5251029f6ebb73a4c86129354'],1,4,5,180659,1,1,1,1,662
cfb23bb8db2aa69486775b957693f9f48d24598e,0,David Reiss,2008-04-02 22:09:03+00:00,['f5ece05649298ee312841e8e16c6d7467316325c'],1,1,2,180661,1,,,,662
d8217422c8bc5e865e0acbea92c47eed38865b2a,0,David Reiss,2008-04-02 22:09:43+00:00,['cfb23bb8db2aa69486775b957693f9f48d24598e'],1,0,1,180662,1,1,1,0,662
437c03bb3d8825bf64581869861c645b4f94908f,0,David Reiss,2008-04-02 22:10:06+00:00,['d8217422c8bc5e865e0acbea92c47eed38865b2a'],1,1,2,180664,1,,,,662
cee1e085b56866b4feb9b334da5d5d8f0b79d44d,1,David Reiss,2008-04-02 22:10:09+00:00,['437c03bb3d8825bf64581869861c645b4f94908f'],3,3,6,180670,3,,,,662
8bfba63dfb8c52cfb8c785c4b19f48a5745e1d6a,1,David Reiss,2008-04-02 22:10:13+00:00,['cee1e085b56866b4feb9b334da5d5d8f0b79d44d'],30,24,54,180724,1,1,1,0,662
3095aa1843310afc2427fd70b0f523e2c90c7690,1,David Reiss,2008-04-02 22:10:17+00:00,['8bfba63dfb8c52cfb8c785c4b19f48a5745e1d6a'],0,180,180,180904,2,0.177419355,0.685483871,1,664
99b000b48475efdfa68de26aeacd15cec01a81ca,1,pwyckoff,2008-04-03 19:30:55+00:00,['3095aa1843310afc2427fd70b0f523e2c90c7690'],0,7006,7006,187910,33,0.581913139,0.77899945,0.881528312,697
c631e98cad3f59565915c1cb10007ee61d960341,0,David Reiss,2008-04-03 20:16:10+00:00,['99b000b48475efdfa68de26aeacd15cec01a81ca'],0,0,0,187910,45,,,,697
04c6267aba644441330376e0d8d51a7338476c7c,0,David Reiss,2008-04-03 20:16:28+00:00,['c631e98cad3f59565915c1cb10007ee61d960341'],12,16,28,187938,10,,,,697
1dd17f5a530d93eb43a68020a630a3a5ef86f8c4,1,David Reiss,2008-04-03 20:16:45+00:00,['04c6267aba644441330376e0d8d51a7338476c7c'],2,684,686,188624,2,,,,698
e9aab10d859b9ce06f2048f4522cfe69c1a4bd3a,0,David Reiss,2008-04-03 20:16:53+00:00,['1dd17f5a530d93eb43a68020a630a3a5ef86f8c4'],1175,3,1178,189802,3,,,,698
c5c542538b7954c721fbd8007ebf0b482a86677a,0,David Reiss,2008-04-03 23:16:46+00:00,['e9aab10d859b9ce06f2048f4522cfe69c1a4bd3a'],4,4,8,189810,1,,,,698
2a4bfd6d0cdd32c9ade36a5c481b952f522f4fb2,1,David Reiss,2008-04-07 23:45:00+00:00,['c5c542538b7954c721fbd8007ebf0b482a86677a'],36,151,187,189997,11,0.25862069,1,1,700
a80f0fb47a43c83438150717a8246760642666f5,0,David Reiss,2008-04-08 05:06:15+00:00,['2a4bfd6d0cdd32c9ade36a5c481b952f522f4fb2'],1,24,25,190022,2,0.615384615,0.615384615,1,700
642f2d3fbec475de8dac8a70cfd972982ed3267f,0,David Reiss,2008-04-08 05:06:32+00:00,['a80f0fb47a43c83438150717a8246760642666f5'],4,12,16,190038,1,1,1,0,700
e0e3d1b232558bb0951a636a158ead8ec6773234,0,David Reiss,2008-04-08 05:06:45+00:00,['642f2d3fbec475de8dac8a70cfd972982ed3267f'],0,318,318,190356,3,1,1,0.8,701
e4db03d1106a3bb381942471be9fdce72f9e88b9,1,David Reiss,2008-04-08 05:06:59+00:00,['e0e3d1b232558bb0951a636a158ead8ec6773234'],0,174,174,190530,5,0.48,1,1,704
bbdb06eb24c3144d6f32f86c21910904013b89d9,0,David Reiss,2008-04-08 05:07:14+00:00,['e4db03d1106a3bb381942471be9fdce72f9e88b9'],0,77,77,190607,1,0.163265306,0.163265306,1,705
1ffb61beaafedb160a971732e599d5c6aa67a646,0,David Reiss,2008-04-08 05:07:26+00:00,['bbdb06eb24c3144d6f32f86c21910904013b89d9'],3,51,54,190661,3,0.090909091,1,1,706
22b1886dc7e4069e8cf838ebf7816a7ab697d091,1,David Reiss,2008-04-08 06:25:45+00:00,['1ffb61beaafedb160a971732e599d5c6aa67a646'],11,9,20,190681,1,1,1,0,706
9b20955b2d4f651eaaec63736cb8aeaaed011be7,1,David Reiss,2008-04-08 06:26:05+00:00,['22b1886dc7e4069e8cf838ebf7816a7ab697d091'],111,185,296,190977,10,0.06779661,0.13559322,0.949152542,706
1677ac9cc7550ea3eb4a4e46fbcf16790c2cb70c,1,David Reiss,2008-04-08 06:26:27+00:00,['9b20955b2d4f651eaaec63736cb8aeaaed011be7'],9,11,20,190997,1,0,0,1,706
b54deb1ca538b2f244225801408637aa8921d5db,0,David Reiss,2008-04-08 19:38:49+00:00,['1677ac9cc7550ea3eb4a4e46fbcf16790c2cb70c'],2,1,3,191000,1,1,1,0,706
8361bf05659f9d1e458d76f8ee0657ea5e009b6a,0,iproctor,2008-04-10 00:31:55+00:00,['b54deb1ca538b2f244225801408637aa8921d5db'],2,7,9,191009,4,0,0,1,706
e4dc4f53660c5386aaa8387f900164e262d9f11b,1,dweatherford,2008-04-11 02:51:44+00:00,['8361bf05659f9d1e458d76f8ee0657ea5e009b6a'],13,25,38,191047,1,0,1,1,706
2a9d6696d07e4bba22ec8d46629f95424c777f0c,0,David Reiss,2008-04-11 21:59:45+00:00,['e4dc4f53660c5386aaa8387f900164e262d9f11b'],1,0,1,191048,1,,,,706
99f193766f915dced2980c5b5f76d53970218c52,0,David Reiss,2008-04-11 22:00:00+00:00,['2a9d6696d07e4bba22ec8d46629f95424c777f0c'],0,0,0,191048,2,,,,706
1d106ae6f00b25684d701cb38bd6e51e5220ddcb,0,David Reiss,2008-04-11 22:00:06+00:00,['99f193766f915dced2980c5b5f76d53970218c52'],0,4,4,191052,1,,,,706
a1771097520d57cd84dcd5e06df6e5e4fae5e5c1,1,David Reiss,2008-04-11 22:36:31+00:00,['1d106ae6f00b25684d701cb38bd6e51e5220ddcb'],3,4,7,191059,3,,,,706
739cbe2b86c8b4a50f3305f7edefd142cad423f8,0,David Reiss,2008-04-15 05:44:00+00:00,['a1771097520d57cd84dcd5e06df6e5e4fae5e5c1'],0,4,4,191063,4,,,,706
2724c7a311dcab7422fd410444d89946ef759c0d,1,David Reiss,2008-04-18 17:48:03+00:00,['739cbe2b86c8b4a50f3305f7edefd142cad423f8'],1,1,2,191065,1,,,,706
0ff213741caa8af6cf88196730ecb90ac9577282,0,David Reiss,2008-04-20 05:28:14+00:00,['2724c7a311dcab7422fd410444d89946ef759c0d'],1,0,1,191066,1,,,,706
847a294b4e0ccdcf813b67954460e18dad6af54f,0,David Reiss,2008-04-21 18:07:43+00:00,['0ff213741caa8af6cf88196730ecb90ac9577282'],0,1,1,191067,1,,,,706
13c4380347beb33113cd578b3413b0c31a6c7033,0,David Reiss,2008-04-21 18:07:49+00:00,['847a294b4e0ccdcf813b67954460e18dad6af54f'],0,4,4,191071,1,,,,706
d80c06a1a1a4692affa620f505b783d3db2aec3c,1,David Reiss,2008-04-21 18:07:53+00:00,['13c4380347beb33113cd578b3413b0c31a6c7033'],1,1,2,191073,1,,,,706
94058454a043a9d310a6ae027dabad59d5e98e1d,0,David Reiss,2008-04-21 18:07:58+00:00,['d80c06a1a1a4692affa620f505b783d3db2aec3c'],0,2,2,191075,1,,,,706
c8abb0733fb400dee372fe6c05f9da9e9b26fc15,1,David Reiss,2008-04-21 18:08:01+00:00,['94058454a043a9d310a6ae027dabad59d5e98e1d'],0,2,2,191077,1,,,,706
10a22bf1f66f4851fffc45ce5c377e5c9df13eed,1,David Reiss,2008-04-21 18:08:07+00:00,['c8abb0733fb400dee372fe6c05f9da9e9b26fc15'],10,42,52,191129,3,,,,706
bd3b168e633cedf903aebf106651dbccf7423089,0,David Reiss,2008-04-28 02:42:28+00:00,['10a22bf1f66f4851fffc45ce5c377e5c9df13eed'],1,1,2,191131,1,,,,706
81c7fc01bf4c8a832626dc711b0b35c086f018cb,0,David Reiss,2008-04-28 02:51:44+00:00,['bd3b168e633cedf903aebf106651dbccf7423089'],0,1,1,191132,1,,,,706
1997f10e282e5d188b65b45190ceb5a7e1f95072,1,David Reiss,2008-04-29 00:29:41+00:00,['81c7fc01bf4c8a832626dc711b0b35c086f018cb'],17,87,104,191236,3,0.837209302,0.88372093,0.930232558,706
c17fe6b918015166d145936414a411589f03255c,0,David Reiss,2008-04-29 00:29:43+00:00,['1997f10e282e5d188b65b45190ceb5a7e1f95072'],3,7,10,191246,1,1,1,1,706
051fbd4e57ff6818231754143d67fa59b9746a4d,0,David Reiss,2008-04-29 00:29:45+00:00,['c17fe6b918015166d145936414a411589f03255c'],1,3,4,191250,1,0,0,1,706
74672b6719903332c0b5969fa0bffd12c13cf121,0,David Reiss,2008-04-29 23:09:11+00:00,['051fbd4e57ff6818231754143d67fa59b9746a4d'],5,1,6,191256,1,1,0,0,706
64120001437477569524be5cfc1f5054b27ee807,0,David Reiss,2008-04-29 23:12:24+00:00,['74672b6719903332c0b5969fa0bffd12c13cf121'],23,23,46,191302,11,,,,706
e39e9379119b99c2bad7613b8cd32c11482b9558,0,David Reiss,2008-05-01 05:52:48+00:00,['64120001437477569524be5cfc1f5054b27ee807'],2,2,4,191306,4,,,,706
372126079cb1e1bce5f186293980209a0e5629ec,0,David Reiss,2008-05-01 05:52:49+00:00,['e39e9379119b99c2bad7613b8cd32c11482b9558'],1,0,1,191307,1,1,0,0,706
9a4edfa07fe0c09865015a15d26695823cd4a5fd,0,David Reiss,2008-05-01 05:52:50+00:00,['372126079cb1e1bce5f186293980209a0e5629ec'],0,32,32,191339,11,0,0,0.620689655,706
28f298dd5d9b68c9c0dbaefa95c88d51ed8e430a,1,David Reiss,2008-05-01 06:17:36+00:00,['9a4edfa07fe0c09865015a15d26695823cd4a5fd'],848,1715,2563,193902,23,0.275,0.805,0.9725,710
f233e46a2dc705f017d5980baa6ad97922b72291,1,David Reiss,2008-05-01 06:21:04+00:00,['28f298dd5d9b68c9c0dbaefa95c88d51ed8e430a'],1,10,11,193913,1,0,1,1,710
de59292f38e11e738a34c8bd2f722beb128c752e,0,David Reiss,2008-05-01 20:51:03+00:00,['f233e46a2dc705f017d5980baa6ad97922b72291'],1,0,1,193914,1,,,,710
8df6c82aa751f65100b6b283dee205e251753aa8,0,David Reiss,2008-05-04 03:00:22+00:00,['de59292f38e11e738a34c8bd2f722beb128c752e'],390,463,853,194767,5,0,0,1,711
47714584327a9a8240f28e8ef4493534a1d047ba,0,David Reiss,2008-05-09 00:40:26+00:00,['8df6c82aa751f65100b6b283dee205e251753aa8'],1,1,2,194769,1,,,,711
80097936bd1258f074a226396f9546d98d060964,0,David Reiss,2008-05-09 07:14:10+00:00,['47714584327a9a8240f28e8ef4493534a1d047ba'],2,4,6,194775,1,1,1,1,711
33fc5adb2be8568b1279414a7bb33043ac875a2c,0,David Reiss,2008-05-09 07:17:34+00:00,['80097936bd1258f074a226396f9546d98d060964'],0,1,1,194776,1,,,,711
f9b5b12f4d7e86e9834dd39ae4393383cab809af,1,David Reiss,2008-05-09 07:17:35+00:00,['33fc5adb2be8568b1279414a7bb33043ac875a2c'],2,6,8,194784,2,,,,711
7dab93e23790f6a2d647ad5d4a7a34f24a464778,0,David Reiss,2008-05-09 19:18:29+00:00,['f9b5b12f4d7e86e9834dd39ae4393383cab809af'],5,5,10,194794,1,,,,711
c89e4de50947b91b658a952da4671033e333c9df,0,David Reiss,2008-06-10 22:54:32+00:00,['7dab93e23790f6a2d647ad5d4a7a34f24a464778'],1,1,2,194796,1,,,,711
af296954ea59369129b4129633e263fd65b503de,0,David Reiss,2008-06-10 22:54:40+00:00,['c89e4de50947b91b658a952da4671033e333c9df'],0,8,8,194804,1,0,0,1,711
665365490f3e14cf3e40205f16d9dc9b5a833f1e,0,David Reiss,2008-06-10 22:54:49+00:00,['af296954ea59369129b4129633e263fd65b503de'],0,81,81,194885,1,0.375,0.375,1,711
791a57f528e12829acd6d2950d50e65139080f49,0,David Reiss,2008-06-10 22:54:56+00:00,['665365490f3e14cf3e40205f16d9dc9b5a833f1e'],0,65,65,194950,1,1,1,1,712
e3a64923e9620ebf99ff51ed5bfcb366e503c79e,0,David Reiss,2008-06-10 22:55:04+00:00,['791a57f528e12829acd6d2950d50e65139080f49'],1,1,2,194952,1,,,,712
c6dab613003c704f072542f39214f7af64fc0412,1,David Reiss,2008-06-10 22:55:13+00:00,['e3a64923e9620ebf99ff51ed5bfcb366e503c79e'],5,57,62,195014,2,1,1,1,712
bcaa2ad0d6799066ed680f53051c469e4f58771b,1,David Reiss,2008-06-10 22:55:26+00:00,['c6dab613003c704f072542f39214f7af64fc0412'],22,49,71,195085,4,0.739130435,0.739130435,1,712
b04df765b5c9fe1b8fb6ded0ed2750188278fe50,1,David Reiss,2008-06-10 22:55:38+00:00,['bcaa2ad0d6799066ed680f53051c469e4f58771b'],10,11,21,195106,1,,,,712
c0092f973d79f309c1b89ae5e55ad8094b87763a,0,David Reiss,2008-06-10 22:55:46+00:00,['b04df765b5c9fe1b8fb6ded0ed2750188278fe50'],0,16,16,195122,1,0,0,1,712
d14f4f86d4a521dd2327789f9230ab239b1c342b,0,David Reiss,2008-06-10 22:55:54+00:00,['c0092f973d79f309c1b89ae5e55ad8094b87763a'],26,26,52,195174,1,,,,712
13aea4600c7e170a0f178d72d7d68d3bddd7ef9a,1,David Reiss,2008-06-10 22:56:04+00:00,['d14f4f86d4a521dd2327789f9230ab239b1c342b'],0,16,16,195190,2,0,0,1,712
0babe40d74f05e7a23ca72b44d74493f3b2fc1a4,0,David Reiss,2008-06-10 22:56:12+00:00,['13aea4600c7e170a0f178d72d7d68d3bddd7ef9a'],7,7,14,195204,2,,,,712
9d866ac23165206b2bdc72054d61df8cfd2be1c9,0,David Reiss,2008-06-10 22:56:19+00:00,['0babe40d74f05e7a23ca72b44d74493f3b2fc1a4'],3,3,6,195210,1,,,,712
5245f40b3e13c65ef6537a8121b74128a9e61ed4,0,David Reiss,2008-06-10 22:56:26+00:00,['9d866ac23165206b2bdc72054d61df8cfd2be1c9'],0,4,4,195214,1,0,0,1,712
87e9ac638241ca215846bb7643ef8af4ec6fe893,1,David Reiss,2008-06-10 22:56:34+00:00,['5245f40b3e13c65ef6537a8121b74128a9e61ed4'],1,9,10,195224,1,0,0,0,712
a1e0a6f0d8c419447fcb95fcb914a9543677bb32,0,David Reiss,2008-06-10 22:56:43+00:00,['87e9ac638241ca215846bb7643ef8af4ec6fe893'],0,4,4,195228,1,0,1,1,712
176ed368a30623a204f04f056b49c7ab9805ee8d,1,David Reiss,2008-06-10 22:56:48+00:00,['a1e0a6f0d8c419447fcb95fcb914a9543677bb32'],3,3,6,195234,1,,,,712
ac549554f425cf2b28ff391c6fefeaa0fe703a32,1,David Reiss,2008-06-10 22:56:59+00:00,['176ed368a30623a204f04f056b49c7ab9805ee8d'],0,673,673,195907,13,,,,725
ae756f4561047df087f7b1130d7e2b056b05e4b0,1,David Reiss,2008-06-10 22:57:11+00:00,['ac549554f425cf2b28ff391c6fefeaa0fe703a32'],41,382,423,196330,7,,,,728
1c1ca74237bee683cf05eff54ee844156ad5e905,1,David Reiss,2008-06-10 22:57:21+00:00,['ae756f4561047df087f7b1130d7e2b056b05e4b0'],31,68,99,196429,5,,,,730
76f0d11dc90ceb910375042d23509e6bc0c3a6ec,1,David Reiss,2008-06-10 22:57:35+00:00,['1c1ca74237bee683cf05eff54ee844156ad5e905'],41,952,993,197422,6,0.310344828,0.597701149,0.931034483,732
0c9b516506acf7074ac61f74525e1aaec3a35aa8,0,David Reiss,2008-06-10 22:57:44+00:00,['76f0d11dc90ceb910375042d23509e6bc0c3a6ec'],0,5,5,197427,1,0,1,1,732
11300fe8726715e068c00aeb6b85421c73e0c01a,1,David Reiss,2008-06-10 22:57:52+00:00,['0c9b516506acf7074ac61f74525e1aaec3a35aa8'],1,1,2,197429,1,,,,732
07a725f038acd66632502d54d3fa7129562365f4,0,David Reiss,2008-06-10 22:57:59+00:00,['11300fe8726715e068c00aeb6b85421c73e0c01a'],6,6,12,197441,1,,,,732
d93521b8807cc2431d4f2f873e366b4685a8d7cc,0,David Reiss,2008-06-10 22:58:07+00:00,['07a725f038acd66632502d54d3fa7129562365f4'],2,3,5,197446,2,,,,732
e1a7998837787ef4065337cb326586dc6a3cd0bf,0,David Reiss,2008-06-10 22:58:14+00:00,['d93521b8807cc2431d4f2f873e366b4685a8d7cc'],8,17,25,197471,1,,,,732
eea8298ee36ea7e9a04b71e059915e8e89f2886f,0,David Reiss,2008-06-10 22:58:21+00:00,['e1a7998837787ef4065337cb326586dc6a3cd0bf'],5,10,15,197486,1,,,,732
982c72de7b412c95de1878d0ab8b859977188ff0,1,David Reiss,2008-06-10 22:58:33+00:00,['eea8298ee36ea7e9a04b71e059915e8e89f2886f'],12,72,84,197570,2,,,,732
57b4d9a4acc1dee83097a8149ce8acac48bb3da1,1,David Reiss,2008-06-10 22:58:39+00:00,['982c72de7b412c95de1878d0ab8b859977188ff0'],0,151,151,197721,1,,,,733
90b4083d4cd468aa33bd441268c5069e5674da81,0,David Reiss,2008-06-10 22:58:52+00:00,['57b4d9a4acc1dee83097a8149ce8acac48bb3da1'],7,181,188,197909,7,,,,734
c0cce962ac7f440427ab211bc965bde0490aa5da,1,David Reiss,2008-06-10 22:58:58+00:00,['90b4083d4cd468aa33bd441268c5069e5674da81'],0,44,44,197953,1,,,,735
cc10b8a80cbd4b56f2953951b8c9485dbac21a24,0,David Reiss,2008-06-10 22:59:02+00:00,['c0cce962ac7f440427ab211bc965bde0490aa5da'],2,2,4,197957,1,,,,735
60b50cf3850cf88d6f6c4b23703b03f134f50b73,0,David Reiss,2008-06-10 22:59:10+00:00,['cc10b8a80cbd4b56f2953951b8c9485dbac21a24'],3,69,72,198029,2,,,,736
c308d6989eb29eab51224975ebc154dbffe7499a,0,David Reiss,2008-06-11 00:56:25+00:00,['60b50cf3850cf88d6f6c4b23703b03f134f50b73'],5,16,21,198050,1,,,,736
920959a655028e93409572f44535aaf6c5a398d7,1,David Reiss,2008-06-11 00:56:35+00:00,['c308d6989eb29eab51224975ebc154dbffe7499a'],9,43,52,198102,3,,,,736
da07067489851ce502e34393f073fe4709b30e64,0,David Reiss,2008-06-11 00:56:42+00:00,['920959a655028e93409572f44535aaf6c5a398d7'],1,4,5,198107,1,,,,736
f4761e324ea111d5e26c5c506286cc59306e581a,0,David Reiss,2008-06-11 00:56:49+00:00,['da07067489851ce502e34393f073fe4709b30e64'],8,13,21,198128,2,,,,736
c85a6955882467c97b28c45853af76985e95a1d2,0,David Reiss,2008-06-11 00:56:55+00:00,['f4761e324ea111d5e26c5c506286cc59306e581a'],0,1,1,198129,1,,,,736
abded23ed43bf025d5b78ad7f664ae996024592b,0,David Reiss,2008-06-11 00:57:01+00:00,['c85a6955882467c97b28c45853af76985e95a1d2'],0,5,5,198134,1,1,1,1,736
77f6f7f5676c82652ef40c7e618b2d23029c41a9,1,David Reiss,2008-06-11 00:57:11+00:00,['abded23ed43bf025d5b78ad7f664ae996024592b'],0,468,468,198602,8,,,,744
fc44c41253a5d56e15facadeef3677162ae6f90f,0,David Reiss,2008-06-11 00:57:19+00:00,['77f6f7f5676c82652ef40c7e618b2d23029c41a9'],6,4,10,198612,2,,,,744
cdf8d1994a4fb39029964af0d4dc4a636029ab92,0,David Reiss,2008-06-11 00:57:35+00:00,['fc44c41253a5d56e15facadeef3677162ae6f90f'],9,12,21,198633,3,1,0,0,744
5541d658643bbd2c2e1c62ee489e25a7706b9d62,1,David Reiss,2008-06-11 00:57:42+00:00,['cdf8d1994a4fb39029964af0d4dc4a636029ab92'],2,18,20,198653,1,,,,744
8cf694d62d314de3501872656a662a825ff6c98d,0,David Reiss,2008-06-11 00:57:54+00:00,['5541d658643bbd2c2e1c62ee489e25a7706b9d62'],43,60,103,198756,3,,,,744
2c534031ee16aa4889cbb98ab997bcce34912ad4,1,David Reiss,2008-06-11 00:58:00+00:00,['8cf694d62d314de3501872656a662a825ff6c98d'],0,218,218,198974,1,,,,745
8cadf3e0fa1a1b16a5ebc77217454d9b795e6419,0,David Reiss,2008-06-11 00:58:07+00:00,['2c534031ee16aa4889cbb98ab997bcce34912ad4'],2,0,2,198976,1,,,,745
702019c9144f910b7aa5040a37f886c36fb91746,0,David Reiss,2008-06-11 00:58:13+00:00,['8cadf3e0fa1a1b16a5ebc77217454d9b795e6419'],0,31,31,199007,1,,,,746
55ff70f8d65ca7f3aa3eaf906d95f82a17be7c92,0,David Reiss,2008-06-11 00:58:25+00:00,['702019c9144f910b7aa5040a37f886c36fb91746'],3,15,18,199025,2,0,1,1,746
1d8b75297176d810aa63b5f58f3269b8ddca133a,1,David Reiss,2008-06-11 00:58:33+00:00,['55ff70f8d65ca7f3aa3eaf906d95f82a17be7c92'],0,9,9,199034,1,0,1,1,746
81b473b4a15db38b9f0e9220cfb7a30e371dd273,0,David Reiss,2008-06-11 00:58:41+00:00,['1d8b75297176d810aa63b5f58f3269b8ddca133a'],4,4,8,199042,1,0,1,1,746
225db732c2195e183bcf95ed6b496d09054b0eba,0,David Reiss,2008-06-11 00:58:48+00:00,['81b473b4a15db38b9f0e9220cfb7a30e371dd273'],1,5,6,199048,1,,,,746
6563f3426318ccd702ae0d5fa31e4cf42b9b5126,1,David Reiss,2008-06-11 00:58:55+00:00,['225db732c2195e183bcf95ed6b496d09054b0eba'],9,12,21,199069,1,,,,746
6b3e40fd7362ee56dba1aa8004e3b2b6f21b89d7,0,David Reiss,2008-06-11 00:59:03+00:00,['6563f3426318ccd702ae0d5fa31e4cf42b9b5126'],41,32,73,199142,2,,,,746
11d855c83708eeed967b701db1ea1b057653d5e3,0,David Reiss,2008-06-11 00:59:12+00:00,['6b3e40fd7362ee56dba1aa8004e3b2b6f21b89d7'],30,20,50,199192,3,,,,746
3b9c342fa41d1c0d85cdf033b3bd392f41dbf6be,0,David Reiss,2008-06-11 00:59:19+00:00,['11d855c83708eeed967b701db1ea1b057653d5e3'],8,6,14,199206,1,,,,746
c525745c0e77daa03acb65739b26d1b87e50e496,0,David Reiss,2008-06-11 00:59:27+00:00,['3b9c342fa41d1c0d85cdf033b3bd392f41dbf6be'],6,3,9,199215,2,,,,746
a5a53dbfcc22df3e50aa419c5e317d609c90dc9e,0,David Reiss,2008-06-11 00:59:34+00:00,['c525745c0e77daa03acb65739b26d1b87e50e496'],1,1,2,199217,1,,,,746
c11734efaca5e67a394997548293d940124de42f,0,David Reiss,2008-06-11 00:59:48+00:00,['a5a53dbfcc22df3e50aa419c5e317d609c90dc9e'],246,111,357,199574,7,,,,746
80862313de217c0ce234730f7c92f8033ffc4537,0,David Reiss,2008-06-11 00:59:55+00:00,['c11734efaca5e67a394997548293d940124de42f'],0,235,235,199809,1,,,,747
7255ed4c46581996012e48fe20c7788b9f925e5c,0,David Reiss,2008-06-11 01:00:04+00:00,['80862313de217c0ce234730f7c92f8033ffc4537'],19,9,28,199837,4,,,,747
919a801a285b3ec158d0ff31b05c03d829e6bb3f,0,David Reiss,2008-06-11 01:00:12+00:00,['7255ed4c46581996012e48fe20c7788b9f925e5c'],2,2,4,199841,2,,,,747
b7c8802d36209e0ffb8af0cdb0a2c5422d8e8ad2,0,David Reiss,2008-06-11 01:00:20+00:00,['919a801a285b3ec158d0ff31b05c03d829e6bb3f'],13,35,48,199889,2,,,,747
80664fe23327544bfdfdee9a8f38f61761d5641e,0,David Reiss,2008-06-11 01:00:30+00:00,['b7c8802d36209e0ffb8af0cdb0a2c5422d8e8ad2'],9,8,17,199906,4,,,,747
06272addb16218249abd94833c78233d98991fdf,0,David Reiss,2008-06-11 01:00:37+00:00,['80664fe23327544bfdfdee9a8f38f61761d5641e'],1,1,2,199908,1,,,,747
464e3000540738f9864626f4afe6036bcf89d2f5,0,David Reiss,2008-06-11 01:00:45+00:00,['06272addb16218249abd94833c78233d98991fdf'],3,11,14,199922,2,,,,747
190d769481f30cc27a591ec5134d3fd3352d6e6f,0,David Reiss,2008-06-11 01:00:52+00:00,['464e3000540738f9864626f4afe6036bcf89d2f5'],3,2,5,199927,1,,,,747
4cf5a6a81f17d6ad16cb44c8f7b1f6c36554ebe8,0,David Reiss,2008-06-11 01:00:59+00:00,['190d769481f30cc27a591ec5134d3fd3352d6e6f'],1,1,2,199929,1,,,,747
af652d2f5141f5c8f53b16c1abe178c6a1c76768,0,David Reiss,2008-06-11 01:01:06+00:00,['4cf5a6a81f17d6ad16cb44c8f7b1f6c36554ebe8'],2,0,2,199931,1,,,,747
4fd7818efa089d8475a9dc54b71e6d3090ef2b74,0,David Reiss,2008-06-11 01:01:13+00:00,['af652d2f5141f5c8f53b16c1abe178c6a1c76768'],4,12,16,199947,1,,,,747
6f1cd53a1e4d364198922dc53deeb24baf9cd8c4,0,David Reiss,2008-06-11 01:01:21+00:00,['4fd7818efa089d8475a9dc54b71e6d3090ef2b74'],33,32,65,200012,2,,,,747
4ec777e9986b24f12a20fbe37775f3f59ef2a330,0,David Reiss,2008-06-11 01:01:29+00:00,['6f1cd53a1e4d364198922dc53deeb24baf9cd8c4'],5,6,11,200023,2,,,,747
1af1868457221f257bc5c4dd83028dd5628e67bd,0,David Reiss,2008-06-11 01:01:36+00:00,['4ec777e9986b24f12a20fbe37775f3f59ef2a330'],2,1,3,200026,1,,,,747
914ebb4b69dc8fe351efce4f029e68cde3c3ba3d,1,David Reiss,2008-06-11 01:01:48+00:00,['1af1868457221f257bc5c4dd83028dd5628e67bd'],47,305,352,200378,6,,,,748
c920faf0f0cb7075be3d290389d7b0eac98aae09,0,David Reiss,2008-06-11 01:01:56+00:00,['914ebb4b69dc8fe351efce4f029e68cde3c3ba3d'],21,24,45,200423,2,,,,748
672968d6e913e02931cc689f1221aa7e87ca4d8e,0,David Reiss,2008-06-11 01:02:03+00:00,['c920faf0f0cb7075be3d290389d7b0eac98aae09'],3,3,6,200429,1,,,,748
e5a4d0c576a30e7a324890ec552e190afdd6ac27,1,David Reiss,2008-06-11 01:02:10+00:00,['672968d6e913e02931cc689f1221aa7e87ca4d8e'],29,41,70,200499,1,,,,748
2fe905e366dfa4d83d71a2cf6b56d88bafd19553,0,David Reiss,2008-06-11 01:02:23+00:00,['e5a4d0c576a30e7a324890ec552e190afdd6ac27'],8,15,23,200522,2,,,,748
ddffed5ff4f5d03bbaccaa3070ac9b7b865b37cf,1,David Reiss,2008-06-11 01:02:31+00:00,['2fe905e366dfa4d83d71a2cf6b56d88bafd19553'],2,2,4,200526,1,,,,748
c49dd1e9e2bdeae5d48f7b9a4d57d3414fbe3dc0,0,David Reiss,2008-06-11 01:02:39+00:00,['ddffed5ff4f5d03bbaccaa3070ac9b7b865b37cf'],2,11,13,200539,3,,,,748
7956f23d4e5ae4be1da85d3fd91b9823531b19b6,1,David Reiss,2008-06-11 01:02:47+00:00,['c49dd1e9e2bdeae5d48f7b9a4d57d3414fbe3dc0'],1,2,3,200542,2,,,,748
d74b023d9aaa2dac8e63d07154acae95f2cb438a,0,David Reiss,2008-06-11 01:02:55+00:00,['7956f23d4e5ae4be1da85d3fd91b9823531b19b6'],2,3,5,200547,2,,,,748
daeed4d3b693765b5eabcf8420339f9081241252,0,David Reiss,2008-06-11 01:03:03+00:00,['d74b023d9aaa2dac8e63d07154acae95f2cb438a'],4,0,4,200551,2,,,,748
fe7ce1b3b380f29450d74db694147d560556b949,0,David Reiss,2008-06-11 01:03:10+00:00,['daeed4d3b693765b5eabcf8420339f9081241252'],2,1,3,200554,1,,,,748
8a162a5a01a0b9c6748028bcc9efd6e8dd9daf0c,1,David Reiss,2008-06-11 01:03:16+00:00,['fe7ce1b3b380f29450d74db694147d560556b949'],0,137,137,200691,4,,,,752
086c279722edf85fb95da929376bc41f0eeb5c1d,0,David Reiss,2008-06-11 01:03:22+00:00,['8a162a5a01a0b9c6748028bcc9efd6e8dd9daf0c'],1,1,2,200693,1,,,,752
ad74b320591c087690e4c43f5ff3bdb34aa98a26,1,David Reiss,2008-06-11 01:03:29+00:00,['086c279722edf85fb95da929376bc41f0eeb5c1d'],52,61,113,200806,2,,,,752
44f785ef6715a5a8466a3939de44ebd7810a38b6,0,David Reiss,2008-06-11 01:03:37+00:00,['ad74b320591c087690e4c43f5ff3bdb34aa98a26'],12,12,24,200830,2,,,,752
cd6248f73a7a4fbb8fe8239481e3f32dad4f2912,1,David Reiss,2008-06-11 01:03:44+00:00,['44f785ef6715a5a8466a3939de44ebd7810a38b6'],11,33,44,200874,1,,,,752
fc427afee9aa94de4392ea6821137a4098966c57,1,David Reiss,2008-06-11 01:11:57+00:00,['cd6248f73a7a4fbb8fe8239481e3f32dad4f2912'],19,73,92,200966,3,,,,752
6d477592fa05ec88d8cbcb75d62a65b98a87cf13,0,David Reiss,2008-06-11 01:12:09+00:00,['fc427afee9aa94de4392ea6821137a4098966c57'],1,114,115,201081,3,,,,754
65cf720b19f2dc2fc6a9cd18ee274a34f87c96b5,0,David Reiss,2008-06-11 01:12:20+00:00,['6d477592fa05ec88d8cbcb75d62a65b98a87cf13'],20,49,69,201150,2,,,,754
844540669eca6b2c65e2d916d261a02602026d92,0,David Reiss,2008-06-11 01:12:31+00:00,['65cf720b19f2dc2fc6a9cd18ee274a34f87c96b5'],1,87,88,201238,3,,,,755
d33ee46b8c75e8788c864529429e9efde67e5578,0,David Reiss,2008-06-11 01:12:38+00:00,['844540669eca6b2c65e2d916d261a02602026d92'],9,27,36,201274,1,,,,755
9ad6a316265c9f9af41efb65b3f9585fcae2e40e,0,David Reiss,2008-06-11 01:12:45+00:00,['d33ee46b8c75e8788c864529429e9efde67e5578'],1,10,11,201285,1,,,,755
0c8cb4aa9fc571846812e57239e251a025c06ec7,0,David Reiss,2008-06-11 01:12:52+00:00,['9ad6a316265c9f9af41efb65b3f9585fcae2e40e'],0,171,171,201456,1,,,,756
ddb6747ad90e0318e542dea3ea941745a8766601,1,David Reiss,2008-06-11 01:12:58+00:00,['0c8cb4aa9fc571846812e57239e251a025c06ec7'],0,3,3,201459,1,,,,756
47515b4b8fd17e5f58b1fb29a6f5fdac125db911,0,David Reiss,2008-06-11 01:13:05+00:00,['ddb6747ad90e0318e542dea3ea941745a8766601'],0,69,69,201528,1,,,,757
a863db62955465f1d9dfc28630cc73566c53ac07,1,David Reiss,2008-06-11 01:13:12+00:00,['47515b4b8fd17e5f58b1fb29a6f5fdac125db911'],11,8,19,201547,1,,,,757
58a961a26704075d1cba30a9b37d2914f685a0af,0,David Reiss,2008-06-11 01:13:19+00:00,['a863db62955465f1d9dfc28630cc73566c53ac07'],11,18,29,201576,1,,,,757
bab1f48a46e2edf107626bdf21e6e31378c757bb,0,David Reiss,2008-06-11 01:13:26+00:00,['58a961a26704075d1cba30a9b37d2914f685a0af'],1,1,2,201578,1,,,,757
a2f45970bb17e4aef9a578a15fdd176534d48581,0,David Reiss,2008-06-11 01:13:33+00:00,['bab1f48a46e2edf107626bdf21e6e31378c757bb'],1,18,19,201597,1,,,,757
61eec8f95c679078f5f5c3f91edc2178e59bfe34,0,David Reiss,2008-06-11 01:13:37+00:00,['a2f45970bb17e4aef9a578a15fdd176534d48581'],0,1,1,201598,1,,,,757
1a2f2187cd9891634080d4aa53a76f50849a1ed1,0,David Reiss,2008-06-11 01:14:01+00:00,['61eec8f95c679078f5f5c3f91edc2178e59bfe34'],72,72,144,201742,8,,,,757
52fe7a5bae19c23a71013d7c50958e93dc3879b4,1,David Reiss,2008-06-11 01:14:07+00:00,['1a2f2187cd9891634080d4aa53a76f50849a1ed1'],0,163,163,201905,1,,,,758
f2e66c1cb79ec0c1e2a515668f15410a60140011,0,David Reiss,2008-06-11 01:14:38+00:00,['52fe7a5bae19c23a71013d7c50958e93dc3879b4'],5926,2,5928,207833,81,0.794802867,0.495519713,0.309139785,758
9f2a5d77997cbfac2f46d267d326fa0e0886a77f,1,David Reiss,2008-06-11 01:15:45+00:00,['f2e66c1cb79ec0c1e2a515668f15410a60140011'],56,56,112,207945,46,,,,758
e20b97208885d40eb30638d4ee8dba2ab8629693,0,David Reiss,2008-06-11 01:15:54+00:00,['9f2a5d77997cbfac2f46d267d326fa0e0886a77f'],1,2,3,207948,1,0,1,1,758
37dbfef4789f44d115188c7e6dd2843840ad23f8,0,David Reiss,2008-06-11 01:16:01+00:00,['e20b97208885d40eb30638d4ee8dba2ab8629693'],1,1,2,207950,1,,,,758
a59191b5ef878f1ddb4ef9c204049bf53e39d35e,0,David Reiss,2008-06-11 01:16:09+00:00,['37dbfef4789f44d115188c7e6dd2843840ad23f8'],3,3,6,207956,1,,,,758
cb13729795173b2763e0ccec3412c9188bfba6a2,1,David Reiss,2008-06-11 01:16:15+00:00,['a59191b5ef878f1ddb4ef9c204049bf53e39d35e'],9,9,18,207974,1,,,,758
cc0c9e98b50b4d5510b485ddd0f44614671616fd,1,David Reiss,2008-06-11 01:16:29+00:00,['cb13729795173b2763e0ccec3412c9188bfba6a2'],6,13,19,207993,3,0,0,0,758
1a14091adc3380df570d01849b9b6002f7dc24c6,1,David Reiss,2008-06-11 01:16:37+00:00,['cc0c9e98b50b4d5510b485ddd0f44614671616fd'],5,16,21,208014,3,,,,758
c6c6498b0227119abf0fd7b41cf63b12f4c013b8,0,David Reiss,2008-06-11 01:16:45+00:00,['1a14091adc3380df570d01849b9b6002f7dc24c6'],18,9,27,208041,2,,,,758
82c1bab8f39c6bc67f968c5ecd379dc71607deee,1,David Reiss,2008-06-11 01:16:53+00:00,['c6c6498b0227119abf0fd7b41cf63b12f4c013b8'],10,10,20,208061,3,,,,758
ab55ed53e32d0efdfc6e4122631ea5d219acf185,0,David Reiss,2008-06-11 01:17:00+00:00,['82c1bab8f39c6bc67f968c5ecd379dc71607deee'],1,1,2,208063,1,,,,758
4d1c712ad173a66faafa2844bad9504e5f7bdfec,0,David Reiss,2008-06-11 01:18:03+00:00,['ab55ed53e32d0efdfc6e4122631ea5d219acf185'],2,2,4,208067,1,,,,758
77bb9167664b39ea8656aadf64537f6c4f109219,0,David Reiss,2008-06-11 01:18:11+00:00,['4d1c712ad173a66faafa2844bad9504e5f7bdfec'],41,51,92,208159,2,1,1,0,758
a4d7eef5cd5e946f30c386e1f4fe790f6d5574ad,0,David Reiss,2008-06-11 01:18:20+00:00,['77bb9167664b39ea8656aadf64537f6c4f109219'],1,1,2,208161,2,,,,758
fb1c5ace0afa13d91d744080abd2dac1fbaf2911,0,David Reiss,2008-06-11 01:18:28+00:00,['a4d7eef5cd5e946f30c386e1f4fe790f6d5574ad'],4,0,4,208165,1,,,,758
32e95f8bb9e124720beae6d4fe1897328dda5f83,0,David Reiss,2008-06-11 01:18:36+00:00,['fb1c5ace0afa13d91d744080abd2dac1fbaf2911'],0,1,1,208166,1,,,,758
a27c3cd0c92371a5d9a604a9a088bf53acd01f49,0,David Reiss,2008-06-11 01:18:44+00:00,['32e95f8bb9e124720beae6d4fe1897328dda5f83'],2,3,5,208171,1,,,,758
c88eb8c9dda2bd5100216458779f8bff7b1a9275,1,David Reiss,2008-06-11 01:18:54+00:00,['a27c3cd0c92371a5d9a604a9a088bf53acd01f49'],5,7,12,208183,2,,,,758
218c11f70164ef22de51f1abc05624f56418cad7,0,David Reiss,2008-06-11 01:19:02+00:00,['c88eb8c9dda2bd5100216458779f8bff7b1a9275'],0,0,0,208183,3,,,,758
8de1ffcb369a6174c13c945ea8ac8eb29481bb50,0,David Reiss,2008-06-11 01:19:07+00:00,['218c11f70164ef22de51f1abc05624f56418cad7'],0,1,1,208184,1,,,,758
710440f95a964c07a25f47066ffd9d7285390d7b,1,David Reiss,2008-06-11 01:19:12+00:00,['8de1ffcb369a6174c13c945ea8ac8eb29481bb50'],0,188,188,208372,1,,,,759
0a2e7a245d8609377d0f16811c0301649f492a83,1,David Reiss,2008-06-11 01:20:54+00:00,['710440f95a964c07a25f47066ffd9d7285390d7b'],6,19,25,208397,1,0,0,1,759
5d6cb0ce944641d963cbeaed65e7de1020333eaf,0,David Reiss,2008-06-11 05:31:09+00:00,['0a2e7a245d8609377d0f16811c0301649f492a83'],0,0,0,208397,1,,,,759
18cb21a125df42c6a7864769ce9710137c99f96e,0,Kevin Clark,2008-06-18 00:48:56+00:00,['5d6cb0ce944641d963cbeaed65e7de1020333eaf'],2,2,4,208401,1,,,,759
28580f4544659e3fba61fc613e6507ba8970e1ea,0,Kevin Clark,2008-06-18 00:49:17+00:00,['18cb21a125df42c6a7864769ce9710137c99f96e'],130,42,172,208573,8,0,0,0,761
104584ee7fcda914d08526f50eedd02ee374b7f8,0,Kevin Clark,2008-06-18 00:49:38+00:00,['28580f4544659e3fba61fc613e6507ba8970e1ea'],4,18,22,208595,1,0.75,0.75,0.75,761
a37d90e6cb0dae3a588a339d9529d93e07fdf8a0,0,Kevin Clark,2008-06-18 00:50:00+00:00,['104584ee7fcda914d08526f50eedd02ee374b7f8'],1,69,70,208665,4,1,1,1,763
52f23fa2a8f5a4b8246f2346ecb552d0f8487c54,0,Kevin Clark,2008-06-18 00:50:24+00:00,['a37d90e6cb0dae3a588a339d9529d93e07fdf8a0'],7,7,14,208679,1,,,,763
32a1114a64d2efef134c47649ae5d59e32d7abae,0,Kevin Clark,2008-06-18 00:50:44+00:00,['52f23fa2a8f5a4b8246f2346ecb552d0f8487c54'],0,83,83,208762,3,1,1,1,765
aaf6e38fcedad021c2052d572592adaa7d69f584,0,Kevin Clark,2008-06-18 00:51:06+00:00,['32a1114a64d2efef134c47649ae5d59e32d7abae'],8,8,16,208778,3,,,,765
720b5732cc7025a8647fe35342b7c425ceaf60e1,0,Kevin Clark,2008-06-18 00:51:25+00:00,['aaf6e38fcedad021c2052d572592adaa7d69f584'],2,2,4,208782,1,,,,765
d5c98eedc83aca595a8feea60a331c291fd7eeba,0,Kevin Clark,2008-06-18 00:51:45+00:00,['720b5732cc7025a8647fe35342b7c425ceaf60e1'],4,6,10,208792,2,,,,765
a7e7c04e9da4d740ddd48f17b22ed7e9aa493269,0,Kevin Clark,2008-06-18 00:52:05+00:00,['d5c98eedc83aca595a8feea60a331c291fd7eeba'],1,1,2,208794,1,,,,765
c669efa48ba7ade8cdaf77d4ca9a939db8a56f05,0,Kevin Clark,2008-06-18 00:52:26+00:00,['a7e7c04e9da4d740ddd48f17b22ed7e9aa493269'],10,58,68,208862,3,1,1,1,766
5e44bce98f289a196d2df0ec0d91fc1f9a3302be,0,Kevin Clark,2008-06-18 00:52:46+00:00,['c669efa48ba7ade8cdaf77d4ca9a939db8a56f05'],1,1,2,208864,1,,,,766
9bf3362ea576758dbd1b27ebc7b185c32e6acd6e,1,Kevin Clark,2008-06-18 00:53:07+00:00,['5e44bce98f289a196d2df0ec0d91fc1f9a3302be'],312,327,639,209503,7,,,,772
97d2166a341657931e43adfe140ffeba48239de0,1,Kevin Clark,2008-06-18 00:53:28+00:00,['9bf3362ea576758dbd1b27ebc7b185c32e6acd6e'],244,265,509,210012,7,,,,772
10cdf10a7bd5326680cc2384f8a812cff573a1df,0,Kevin Clark,2008-06-18 00:53:48+00:00,['97d2166a341657931e43adfe140ffeba48239de0'],3,3,6,210018,4,,,,772
2960044415917973aeeb8c6d9132319eef69139a,1,Kevin Clark,2008-06-18 00:54:13+00:00,['10cdf10a7bd5326680cc2384f8a812cff573a1df'],201,236,437,210455,13,0.2,1,1,773
4c69d3eecfb5220791a007fef5b2dc5ce2ab522d,0,Kevin Clark,2008-06-18 00:54:33+00:00,['2960044415917973aeeb8c6d9132319eef69139a'],135,137,272,210727,1,,,,773
3eca0785978e545530939e568ba3a7f47029f0ab,0,Kevin Clark,2008-06-18 00:54:53+00:00,['4c69d3eecfb5220791a007fef5b2dc5ce2ab522d'],15,205,220,210947,3,1,1,1,775
5a7103ae5d2d0727fd6ddb4a97304fb8c9968ff3,0,Kevin Clark,2008-06-18 00:55:11+00:00,['3eca0785978e545530939e568ba3a7f47029f0ab'],0,10,10,210957,1,,,,776
0d1849d88206b5205a8862471032d39206062f23,1,Kevin Clark,2008-06-18 00:55:29+00:00,['5a7103ae5d2d0727fd6ddb4a97304fb8c9968ff3'],21,9,30,210987,2,,,,776
6eaf814fcc9bb6ae40ea0f6f21cf9a60a90a40ae,0,Kevin Clark,2008-06-18 00:55:50+00:00,['0d1849d88206b5205a8862471032d39206062f23'],7,3,10,210997,3,,,,776
96cc5164928e589e23171e4a61437599748e55d2,0,Kevin Clark,2008-06-18 00:56:08+00:00,['6eaf814fcc9bb6ae40ea0f6f21cf9a60a90a40ae'],1,22,23,211020,2,1,1,1,776
c42231b6fa56318fa6d9dd43a7f717e095e331c0,0,Kevin Clark,2008-06-18 00:56:30+00:00,['96cc5164928e589e23171e4a61437599748e55d2'],15,10,25,211045,8,,,,776
f85e79349417c4a947dd01714fad3abdda840450,0,Kevin Clark,2008-06-18 00:56:48+00:00,['c42231b6fa56318fa6d9dd43a7f717e095e331c0'],5,13,18,211063,3,,,,776
c2a07b19ef333a03e6b6542a16ff39326b15423d,0,Kevin Clark,2008-06-18 00:57:06+00:00,['f85e79349417c4a947dd01714fad3abdda840450'],1,8,9,211072,1,,,,776
6fda4b76e2c8a963fcc28edac725da48fffd1784,1,Kevin Clark,2008-06-18 00:57:26+00:00,['c2a07b19ef333a03e6b6542a16ff39326b15423d'],422,423,845,211917,5,,,,778
fc964eed7abd7e762e2e6ae61af5137f8ce71c52,0,Kevin Clark,2008-06-18 00:57:46+00:00,['6fda4b76e2c8a963fcc28edac725da48fffd1784'],3,6,9,211926,2,1,1,1,778
da40e8d27c1f4a8c2f341927cacdccd1038bd467,0,Kevin Clark,2008-06-18 00:58:04+00:00,['fc964eed7abd7e762e2e6ae61af5137f8ce71c52'],0,12,12,211938,1,1,1,1,778
b8a7ad727e43be1d40a5532a490857a8d9189598,0,Kevin Clark,2008-06-18 00:58:23+00:00,['da40e8d27c1f4a8c2f341927cacdccd1038bd467'],130,160,290,212228,5,0,0,0,778
244b0d9c92567d6a50bcdfa6fb0dd0b42e8ab0c7,0,Kevin Clark,2008-06-18 00:58:40+00:00,['b8a7ad727e43be1d40a5532a490857a8d9189598'],7,7,14,212242,1,,,,778
e12b0f8445b00e6d0584b4aabf3e84fdaebbef07,0,Kevin Clark,2008-06-18 00:58:58+00:00,['244b0d9c92567d6a50bcdfa6fb0dd0b42e8ab0c7'],2,6,8,212250,2,,,,778
8943788f1f44deaf7735b8ed4bbea0b67958e1c6,1,Kevin Clark,2008-06-18 00:59:17+00:00,['e12b0f8445b00e6d0584b4aabf3e84fdaebbef07'],22,22,44,212294,2,,,,778
0d45617ec2be9376bb83381d69cc09a49bb1d975,0,Kevin Clark,2008-06-18 00:59:37+00:00,['8943788f1f44deaf7735b8ed4bbea0b67958e1c6'],63,65,128,212422,8,,,,778
adfdf39dd3ba215c6d76ca1a0def587b19005d76,0,Kevin Clark,2008-06-18 00:59:56+00:00,['0d45617ec2be9376bb83381d69cc09a49bb1d975'],7,7,14,212436,1,,,,778
f5754acff9db00b949b68b4208dc980d511acf7a,0,Kevin Clark,2008-06-18 01:00:12+00:00,['adfdf39dd3ba215c6d76ca1a0def587b19005d76'],3,21,24,212460,2,1,1,1,778
74df0bf429a29d85a2f252600f28ca652487953b,1,Kevin Clark,2008-06-18 01:00:33+00:00,['f5754acff9db00b949b68b4208dc980d511acf7a'],598,618,1216,213676,16,,,,783
2b1e10b21fc6f4a855235bc6774834b0510e8593,0,Kevin Clark,2008-06-18 01:00:50+00:00,['74df0bf429a29d85a2f252600f28ca652487953b'],0,2,2,213678,2,,,,783
2a8a7312032c38cb59125d232f67bfede2c11742,0,Kevin Clark,2008-06-18 01:01:07+00:00,['2b1e10b21fc6f4a855235bc6774834b0510e8593'],4,66,70,213748,2,0.1875,1,0.765625,783
03a5fb1dd7982367d733b43786935b982120b987,0,Kevin Clark,2008-06-18 01:01:25+00:00,['2a8a7312032c38cb59125d232f67bfede2c11742'],12,142,154,213902,2,1,1,0.89516129,783
eff97fc04276eb7789ff885a604cfd96cfd1581b,0,Kevin Clark,2008-06-18 01:01:40+00:00,['03a5fb1dd7982367d733b43786935b982120b987'],17,23,40,213942,2,0.666666667,1,0.5,783
fc311644864a8816cb874ef77d86bc84917c18ac,0,Kevin Clark,2008-06-18 01:01:57+00:00,['eff97fc04276eb7789ff885a604cfd96cfd1581b'],0,23,23,213965,1,0.25,1,1,783
de7864e7d5e5db1456c2178d9a764428e1c3ab48,0,Kevin Clark,2008-06-18 01:02:14+00:00,['fc311644864a8816cb874ef77d86bc84917c18ac'],33,73,106,214071,2,0.378378378,1,0.783783784,783
fe897d32f19a5c3a919b49669113587ad160badc,0,Kevin Clark,2008-06-18 01:02:31+00:00,['de7864e7d5e5db1456c2178d9a764428e1c3ab48'],5,5,10,214081,4,,,,783
7618fb42fb67ab505257d56558149f6b955430da,0,Kevin Clark,2008-06-18 01:02:46+00:00,['fe897d32f19a5c3a919b49669113587ad160badc'],2,2,4,214085,2,,,,783
5d2e7a9bc6952e00f97cdd8e1c840c579211ebd7,0,Kevin Clark,2008-06-18 01:03:03+00:00,['7618fb42fb67ab505257d56558149f6b955430da'],4,4,8,214093,2,,,,783
18e21565b3cac739de32ff9af56f09797b20e146,0,Kevin Clark,2008-06-18 01:03:17+00:00,['5d2e7a9bc6952e00f97cdd8e1c840c579211ebd7'],2,2,4,214097,1,,,,783
21411530da01343bc2da1d6036925494cc93744f,1,Kevin Clark,2008-06-18 01:03:33+00:00,['18e21565b3cac739de32ff9af56f09797b20e146'],9,9,18,214115,2,,,,783
dd8ef9ef53c3cf4da28e641d05a16b65af0c4bcc,0,Kevin Clark,2008-06-18 01:03:48+00:00,['21411530da01343bc2da1d6036925494cc93744f'],21,1,22,214137,1,1,0,0,783
9d33041a1be82e79c7bb89393bbe9c7f78fe93cd,1,Kevin Clark,2008-06-18 01:04:03+00:00,['dd8ef9ef53c3cf4da28e641d05a16b65af0c4bcc'],21,5,26,214163,2,0,0,0,783
d639ac13b5839c149b82e77621a631b3664310a4,1,Kevin Clark,2008-06-18 01:04:18+00:00,['9d33041a1be82e79c7bb89393bbe9c7f78fe93cd'],7,6,13,214176,1,,,,783
95833c52506a5bf7358d046ae950d53953e7a468,0,Kevin Clark,2008-06-18 01:04:34+00:00,['d639ac13b5839c149b82e77621a631b3664310a4'],1,24,25,214201,2,1,1,1,784
61387bf284575b1329c3864e9ba5904ce4699153,0,Kevin Clark,2008-06-18 01:04:48+00:00,['95833c52506a5bf7358d046ae950d53953e7a468'],15,107,122,214323,1,0.171052632,1,1,784
0ff9e8c55e0161a90e336e82a7f4db09799b230a,0,Kevin Clark,2008-06-18 01:05:03+00:00,['61387bf284575b1329c3864e9ba5904ce4699153'],3,67,70,214393,3,1,1,1,785
d47cd66f7dcfc799f35239b0896846fcdef8c50e,1,Kevin Clark,2008-06-18 01:05:17+00:00,['0ff9e8c55e0161a90e336e82a7f4db09799b230a'],0,120,120,214513,2,,,,786
b397bbb6b6078e96ff3149e97fe272c21e2996fb,0,Kevin Clark,2008-06-18 01:05:32+00:00,['d47cd66f7dcfc799f35239b0896846fcdef8c50e'],0,13,13,214526,1,1,1,1,786
4a2b841528130b866456181f2dd841061172e7ae,0,Kevin Clark,2008-06-18 01:05:47+00:00,['b397bbb6b6078e96ff3149e97fe272c21e2996fb'],0,64,64,214590,1,1,1,1,787
dfaada43ad8440a3a38fdd16abe2eaa358e745d6,0,Kevin Clark,2008-06-18 01:06:01+00:00,['4a2b841528130b866456181f2dd841061172e7ae'],0,8,8,214598,1,1,1,1,787
dc39973565ac92346123ae638881aed7e44d4b24,0,Kevin Clark,2008-06-18 01:06:15+00:00,['dfaada43ad8440a3a38fdd16abe2eaa358e745d6'],43,141,184,214782,2,0.075949367,1,1,788
962b8af59d867ca4b28fe857a2e63a03a2b60a84,0,Kevin Clark,2008-06-18 01:06:29+00:00,['dc39973565ac92346123ae638881aed7e44d4b24'],3,3,6,214788,1,,,,788
9db1c2e5b5dc1f81d527f4dec97461849e46bae8,0,Kevin Clark,2008-06-18 01:06:42+00:00,['962b8af59d867ca4b28fe857a2e63a03a2b60a84'],1,38,39,214827,1,1,1,1,788
d6cb44437502358cc95a39d0d82e0850aa2cc59f,0,Kevin Clark,2008-06-18 01:06:56+00:00,['9db1c2e5b5dc1f81d527f4dec97461849e46bae8'],31,27,58,214885,1,0,0,0,788
f18b643e5ebe4533b549e1a9d624401a05fa90c8,0,Kevin Clark,2008-06-18 01:07:10+00:00,['d6cb44437502358cc95a39d0d82e0850aa2cc59f'],0,160,160,215045,1,1,1,1,789
37d1149f7714b1d8296cbde5f5e541026d7cde86,0,Kevin Clark,2008-06-18 01:07:23+00:00,['f18b643e5ebe4533b549e1a9d624401a05fa90c8'],0,5,5,215050,1,1,1,1,789
5ae0384d8fe748866e0d61eadf2f1d1c5233903c,0,Kevin Clark,2008-06-18 01:07:37+00:00,['37d1149f7714b1d8296cbde5f5e541026d7cde86'],25,140,165,215215,1,1,1,1,789
e977a63293c65466d8d66baef12e5ea340d6a6f3,0,Kevin Clark,2008-06-18 01:07:50+00:00,['5ae0384d8fe748866e0d61eadf2f1d1c5233903c'],0,6,6,215221,1,1,1,1,789
356f861420c530c38acd5a56bb470df710a606ec,0,Kevin Clark,2008-06-18 01:08:05+00:00,['e977a63293c65466d8d66baef12e5ea340d6a6f3'],6,8,14,215235,6,,,,789
378191a64513e8ad382e0efa223a9f2068fb3729,0,Kevin Clark,2008-06-18 01:08:19+00:00,['356f861420c530c38acd5a56bb470df710a606ec'],13,22,35,215270,2,0,1,1,789
76c235bd480dffffac2b67d445524d5160bce9be,0,Kevin Clark,2008-06-18 01:08:35+00:00,['378191a64513e8ad382e0efa223a9f2068fb3729'],18,18,36,215306,1,,,,789
8206c1a3c5196c448d21e2fe6fc4429cff30f769,0,Kevin Clark,2008-06-18 01:08:47+00:00,['76c235bd480dffffac2b67d445524d5160bce9be'],1,1,2,215308,1,,,,789
ccc86583a3ca6888d76b8537c7a853bea1c498c7,1,Kevin Clark,2008-06-18 01:09:00+00:00,['8206c1a3c5196c448d21e2fe6fc4429cff30f769'],0,142,142,215450,2,0.802325581,1,1,790
8d79e3f9544d4b8d49b9ef6e596970a7c1f3e459,1,Kevin Clark,2008-06-18 01:09:15+00:00,['ccc86583a3ca6888d76b8537c7a853bea1c498c7'],7,15,22,215472,3,1,1,1,790
41c0a0266b9e3fb0432a9b927f9ddb46a15d6f26,0,Kevin Clark,2008-06-18 01:09:28+00:00,['8d79e3f9544d4b8d49b9ef6e596970a7c1f3e459'],5,7,12,215484,2,,,,790
03d7a479461a1537d3dd8a1b6782e56fc434e81a,1,Kevin Clark,2008-06-18 01:09:41+00:00,['41c0a0266b9e3fb0432a9b927f9ddb46a15d6f26'],0,219,219,215703,4,0.201550388,1,1,794
1ca1950f9bdbe555a59c2b49d90fe0b025418483,0,Kevin Clark,2008-06-18 01:09:53+00:00,['03d7a479461a1537d3dd8a1b6782e56fc434e81a'],2,2,4,215707,1,,,,794
080dd878bee33bf259513ff70167ba282acd4004,0,Kevin Clark,2008-06-18 01:10:05+00:00,['1ca1950f9bdbe555a59c2b49d90fe0b025418483'],0,98,98,215805,1,1,1,1,795
531e0205038e0eefc58aa9f16a39db884bda4aa8,0,Kevin Clark,2008-06-18 01:10:17+00:00,['080dd878bee33bf259513ff70167ba282acd4004'],0,199,199,216004,1,1,1,1,796
4c56c2c43fdd9d6207876551f9bf32b30df5e1c8,0,Kevin Clark,2008-06-18 01:10:30+00:00,['531e0205038e0eefc58aa9f16a39db884bda4aa8'],1,1,2,216006,1,,,,796
54d0d91c7ec5fcc8ab95647389fc420531416c5d,0,Kevin Clark,2008-06-18 01:10:43+00:00,['4c56c2c43fdd9d6207876551f9bf32b30df5e1c8'],4,0,4,216010,1,0,0,0,796
02ef842aa28c7b99ac5deb452027773d2d952bd7,0,Kevin Clark,2008-06-18 01:10:55+00:00,['54d0d91c7ec5fcc8ab95647389fc420531416c5d'],16,16,32,216042,1,,,,796
f6aa86a5067d3c32d6bfee8be81f87dbe543d24f,1,Kevin Clark,2008-06-18 01:11:07+00:00,['02ef842aa28c7b99ac5deb452027773d2d952bd7'],0,64,64,216106,1,1,1,1,796
dd330253ae03579fba90b87be7944f58d8394959,0,Kevin Clark,2008-06-18 01:11:18+00:00,['f6aa86a5067d3c32d6bfee8be81f87dbe543d24f'],0,30,30,216136,1,1,1,1,797
150af8b7c600808cf6f52d792bef36ea54022f02,0,Kevin Clark,2008-06-18 01:11:29+00:00,['dd330253ae03579fba90b87be7944f58d8394959'],2,2,4,216140,1,,,,797
d389f54f0a9fa736c62911a5e16cdc77ab9dcd21,1,Kevin Clark,2008-06-18 01:11:41+00:00,['150af8b7c600808cf6f52d792bef36ea54022f02'],38,38,76,216216,5,,,,797
da5d34602a17bf8f790e6878d0b133d19058a9c3,0,Kevin Clark,2008-06-18 01:11:52+00:00,['d389f54f0a9fa736c62911a5e16cdc77ab9dcd21'],6,4,10,216226,1,,,,797
3c87129dc0474941cc03d76e4ef0d60501c0258d,0,Kevin Clark,2008-06-18 01:12:05+00:00,['da5d34602a17bf8f790e6878d0b133d19058a9c3'],0,101,101,216327,1,1,1,1,798
eb0dd7fbe452adbdb9be7645647fc9fbcea5f64a,0,Kevin Clark,2008-06-18 01:12:15+00:00,['3c87129dc0474941cc03d76e4ef0d60501c0258d'],0,7,7,216334,1,,,,798
3f48333ad8c683337b8392a467976a089a3ba6d3,0,Kevin Clark,2008-06-18 01:12:26+00:00,['eb0dd7fbe452adbdb9be7645647fc9fbcea5f64a'],7,8,15,216349,1,0,1,1,798
7b0bc554fada27b8a5a0feb3fc0f61144b561060,0,Kevin Clark,2008-06-18 01:12:37+00:00,['3f48333ad8c683337b8392a467976a089a3ba6d3'],3,1,4,216353,1,,,,798
c13c33bfad64404d8e064a0f6c48eaa151a87c79,0,Kevin Clark,2008-06-18 01:12:48+00:00,['7b0bc554fada27b8a5a0feb3fc0f61144b561060'],1,6,7,216360,1,1,1,1,798
090b69ee631918ab3bc75632c93e461ba6913b46,0,Kevin Clark,2008-06-18 01:12:58+00:00,['c13c33bfad64404d8e064a0f6c48eaa151a87c79'],0,6,6,216366,1,1,1,1,798
dfe22b3e2a9ffbd0f102cc16efea64218d6d20ea,0,Kevin Clark,2008-06-18 01:13:09+00:00,['090b69ee631918ab3bc75632c93e461ba6913b46'],12,5,17,216383,1,0,0,0,798
fa4a958589f42e73c6348eb46da1ec69a0810ff4,0,Kevin Clark,2008-06-18 01:13:18+00:00,['dfe22b3e2a9ffbd0f102cc16efea64218d6d20ea'],0,13,13,216396,1,1,1,1,798
0d6007c717057b2dcc2e4a3b5d6dcfbbdc36e61b,0,Kevin Clark,2008-06-18 01:13:27+00:00,['fa4a958589f42e73c6348eb46da1ec69a0810ff4'],0,4,4,216400,1,1,1,1,798
9479b1a593fb027a3194ed4d4fb85712e1500857,0,Kevin Clark,2008-06-18 01:13:37+00:00,['0d6007c717057b2dcc2e4a3b5d6dcfbbdc36e61b'],0,11,11,216411,1,1,1,1,798
a7613dde90187112c5655ecdb6967d55d8ad5b1e,0,Kevin Clark,2008-06-18 01:13:48+00:00,['9479b1a593fb027a3194ed4d4fb85712e1500857'],4,7,11,216422,1,,,,798
1cfd693f3e4cbb697c0942299c43c081dfa3c820,1,Kevin Clark,2008-06-18 01:13:58+00:00,['a7613dde90187112c5655ecdb6967d55d8ad5b1e'],0,17,17,216439,3,1,1,1,798
f98286a8e4bf02df06f8c821d2a36b6254b77bb5,0,Kevin Clark,2008-06-18 01:14:08+00:00,['1cfd693f3e4cbb697c0942299c43c081dfa3c820'],0,9,9,216448,1,1,1,1,798
45671689eaddc7928f36103192851c766f8faaf5,0,Kevin Clark,2008-06-18 01:14:17+00:00,['f98286a8e4bf02df06f8c821d2a36b6254b77bb5'],1,1,2,216450,1,,,,798
ec9106f8543d036b5fbe2d34b8f8655763922c96,0,Kevin Clark,2008-06-18 01:14:26+00:00,['45671689eaddc7928f36103192851c766f8faaf5'],15,21,36,216486,2,1,1,1,798
01a514494d065bb0bd367afbe9604891cc188db8,0,Kevin Clark,2008-06-18 01:14:36+00:00,['ec9106f8543d036b5fbe2d34b8f8655763922c96'],10,8,18,216504,2,0,0,0,798
5a2d0ad20a12defdb688d78aad2c247b275ec2ea,1,Kevin Clark,2008-06-18 01:14:48+00:00,['01a514494d065bb0bd367afbe9604891cc188db8'],132,95,227,216731,9,0.837837838,1,0,798
3c4367ae4b1b0c300f970a7bef740a72ce481838,0,Kevin Clark,2008-06-18 01:14:57+00:00,['5a2d0ad20a12defdb688d78aad2c247b275ec2ea'],30,8,38,216769,1,0,0,0,798
7019070c92b345a201dc780007d610f101cd33db,0,Kevin Clark,2008-06-18 01:15:06+00:00,['3c4367ae4b1b0c300f970a7bef740a72ce481838'],5,5,10,216779,1,,,,798
63eb9979d604f06d4a342026ea12dfe623f70148,0,Kevin Clark,2008-06-18 01:15:15+00:00,['7019070c92b345a201dc780007d610f101cd33db'],4,0,4,216783,1,0,0,1,798
6c30dbbb9280c8b9a2a3b4f9265082cc111bef9f,1,Kevin Clark,2008-06-18 01:15:25+00:00,['63eb9979d604f06d4a342026ea12dfe623f70148'],10,36,46,216829,4,1,1,1,798
c78eeef184945b49b6d6e117760acc2fc43be31e,0,Kevin Clark,2008-06-18 01:15:36+00:00,['6c30dbbb9280c8b9a2a3b4f9265082cc111bef9f'],8,12,20,216849,2,1,1,1,798
c67587006f525dc158c3ed044883fabb7c70846e,0,Kevin Clark,2008-06-18 01:15:45+00:00,['c78eeef184945b49b6d6e117760acc2fc43be31e'],3,16,19,216868,2,1,1,1,798
90a2cbe0a410edab005f64096583504e9137a21e,0,Kevin Clark,2008-06-18 01:15:53+00:00,['c67587006f525dc158c3ed044883fabb7c70846e'],2,3,5,216873,2,,,,798
e0fdddea44ac97988c7aaf775961a02619eacd22,1,Kevin Clark,2008-06-18 01:16:02+00:00,['90a2cbe0a410edab005f64096583504e9137a21e'],0,495,495,217368,4,0.528571429,0.607142857,0.9,801
1d4b2d87f78b3aee51f95de3f7c416e3fd8dd9bf,0,Kevin Clark,2008-06-18 01:16:11+00:00,['e0fdddea44ac97988c7aaf775961a02619eacd22'],8,11,19,217387,2,0,1,1,801
6c4598bbc0d55f47dd01c896ecd2e5e3f029357f,0,Kevin Clark,2008-06-18 01:16:20+00:00,['1d4b2d87f78b3aee51f95de3f7c416e3fd8dd9bf'],5,3,8,217395,2,0,0,0,801
1535078231030df911551f44628ac8709628a5bb,0,Kevin Clark,2008-06-18 01:16:27+00:00,['6c4598bbc0d55f47dd01c896ecd2e5e3f029357f'],0,7,7,217402,1,1,1,1,801
75a15d886881b8fb1ed15ce3e6c241a215247d46,0,Kevin Clark,2008-06-18 01:16:35+00:00,['1535078231030df911551f44628ac8709628a5bb'],1,2,3,217405,1,,,,801
4eea89737abf01dbcfd8443aec8746ad0cb637d8,0,Kevin Clark,2008-06-18 01:16:42+00:00,['75a15d886881b8fb1ed15ce3e6c241a215247d46'],1,0,1,217406,1,0,0,0,801
2e4f9d61dc840ba04328bfecef084b995ab5e366,0,Kevin Clark,2008-06-18 01:16:50+00:00,['4eea89737abf01dbcfd8443aec8746ad0cb637d8'],3,22,25,217431,1,,,,801
e4489d3e698a2378038227f37d49212b52acf8b1,0,Kevin Clark,2008-06-18 01:16:58+00:00,['2e4f9d61dc840ba04328bfecef084b995ab5e366'],15,47,62,217493,1,0.129032258,0.129032258,0.870967742,801
ca8a1b3b99627773a3b09c6a34de28dd3234facd,1,Kevin Clark,2008-06-18 01:17:06+00:00,['e4489d3e698a2378038227f37d49212b52acf8b1'],3,357,360,217853,6,0.558139535,0.825581395,0.965116279,806
cb344a3b497a162d8858c683d99a1d72ac8ee74b,0,Kevin Clark,2008-06-18 01:17:14+00:00,['ca8a1b3b99627773a3b09c6a34de28dd3234facd'],5,3,8,217861,1,,,,806
7fb207f2f9cbfb7b276ed4c0651811d8e354f86f,0,Kevin Clark,2008-06-18 01:17:22+00:00,['cb344a3b497a162d8858c683d99a1d72ac8ee74b'],1,1,2,217863,1,,,,806
1067425ef7bb4fa81a28a39adc1a3153efaff306,0,Kevin Clark,2008-06-18 01:17:30+00:00,['7fb207f2f9cbfb7b276ed4c0651811d8e354f86f'],5,16,21,217884,2,0.75,0,1,806
3c59aff0b9119cb202b04e4b192e174ed9ee1fb1,0,Kevin Clark,2008-06-18 01:17:37+00:00,['1067425ef7bb4fa81a28a39adc1a3153efaff306'],0,4,4,217888,1,,,,806
e45bf59417f0e2594708d26e16b66ccba9d8bfee,1,Kevin Clark,2008-06-18 01:17:44+00:00,['3c59aff0b9119cb202b04e4b192e174ed9ee1fb1'],250,408,658,218546,2,1,1,0.76984127,806
2818b09c877cc726b6efde91b69d624074c65a3f,0,Kevin Clark,2008-06-18 01:17:51+00:00,['e45bf59417f0e2594708d26e16b66ccba9d8bfee'],0,98,98,218644,2,0.228571429,0.685714286,1,807
140b555bf481e2ca8edf532396ca54065a2cb406,0,Kevin Clark,2008-06-18 01:17:57+00:00,['2818b09c877cc726b6efde91b69d624074c65a3f'],146,148,294,218938,1,,,,807
23193757bc2d560d314fdd50e3b4093fdd6551a1,0,Kevin Clark,2008-06-18 01:18:07+00:00,['140b555bf481e2ca8edf532396ca54065a2cb406'],15,51,66,219004,6,1,1,1,807
c3783f4cdb94cb5ee28df8026e1bc4fa6b8ce3a0,0,Kevin Clark,2008-06-18 01:18:14+00:00,['23193757bc2d560d314fdd50e3b4093fdd6551a1'],3,10,13,219017,3,1,0,0,807
c83d4451b7ad8b654b1e7341a9d6100f553c601b,0,Kevin Clark,2008-06-18 01:18:21+00:00,['c3783f4cdb94cb5ee28df8026e1bc4fa6b8ce3a0'],3,1,4,219021,4,,,,807
138c0e126ffb9aa5d6408b44f82d902b7050a4eb,0,Kevin Clark,2008-06-18 01:18:28+00:00,['c83d4451b7ad8b654b1e7341a9d6100f553c601b'],0,77,77,219098,2,1,1,1,809
2ddd8ed40fabf1fc8b7c6fdf370b791e045951c7,1,Kevin Clark,2008-06-18 01:18:35+00:00,['138c0e126ffb9aa5d6408b44f82d902b7050a4eb'],87,217,304,219402,6,0.925373134,1,1,812
e1d35fa5557f0bbd5a2e672314933da315bd60f2,0,Kevin Clark,2008-06-18 01:18:41+00:00,['2ddd8ed40fabf1fc8b7c6fdf370b791e045951c7'],2,7,9,219411,1,0,1,0.8,812
2ddd9d7e2c8136831d0e2ec9b742f1138d1b197a,1,Kevin Clark,2008-06-18 01:18:47+00:00,['e1d35fa5557f0bbd5a2e672314933da315bd60f2'],0,27,27,219438,2,0.888888889,1,1,813
bfb198dae65cd2ccf707e75b0546f2abe6cd8c90,0,Kevin Clark,2008-06-18 01:18:52+00:00,['2ddd9d7e2c8136831d0e2ec9b742f1138d1b197a'],2,3,5,219443,1,,,,813
1aca9c4097a88eac003f1eee781f301d649f6be8,0,Kevin Clark,2008-06-18 01:18:57+00:00,['bfb198dae65cd2ccf707e75b0546f2abe6cd8c90'],0,10,10,219453,1,1,1,1,813
fb5c0eb2b3318dc5f0299a9d65c5a9761e0e359f,0,Kevin Clark,2008-06-18 01:19:04+00:00,['1aca9c4097a88eac003f1eee781f301d649f6be8'],16,14,30,219483,3,1,1,0,813
d3cee029c9f7075e85d8e100d01bc66b6829b727,1,Kevin Clark,2008-06-18 01:19:09+00:00,['fb5c0eb2b3318dc5f0299a9d65c5a9761e0e359f'],92,140,232,219715,4,1,1,0,815
75532eee4c065bccb44d0ec5936cfac233009864,0,Kevin Clark,2008-06-18 01:19:14+00:00,['d3cee029c9f7075e85d8e100d01bc66b6829b727'],5,23,28,219743,1,,,,815
66038a0afc3bdcd1000ac1fc192c965235373f2a,0,Kevin Clark,2008-06-18 01:19:18+00:00,['75532eee4c065bccb44d0ec5936cfac233009864'],2,11,13,219756,1,0.2,0.2,1,815
b679131a164fac07dac27ecfa49b56eaa7256b81,0,Kevin Clark,2008-06-18 01:19:23+00:00,['66038a0afc3bdcd1000ac1fc192c965235373f2a'],2,2,4,219760,2,,,,815
1a95a1d5adc25fe6e8ed0ad1afd58a271a4f3603,0,Kevin Clark,2008-06-18 01:19:28+00:00,['b679131a164fac07dac27ecfa49b56eaa7256b81'],2,6,8,219768,2,1,1,1,815
1e8f5208e64b54a5c683e730dbb296f7211427dd,0,Kevin Clark,2008-06-18 01:19:33+00:00,['1a95a1d5adc25fe6e8ed0ad1afd58a271a4f3603'],0,1,1,219769,1,,,,815
d271979bf23cde196fa5f6360240cdb987a72ce8,0,Kevin Clark,2008-06-18 01:19:37+00:00,['1e8f5208e64b54a5c683e730dbb296f7211427dd'],9,19,28,219797,2,0,0.625,1,815
e4644f11fa6054f15659c76debf40d9595e2ee17,0,Kevin Clark,2008-06-18 01:19:41+00:00,['d271979bf23cde196fa5f6360240cdb987a72ce8'],1,1,2,219799,1,,,,815
fdc9c976f9d219ee693674fe6a45fafe21796ac4,0,Kevin Clark,2008-06-18 01:19:46+00:00,['e4644f11fa6054f15659c76debf40d9595e2ee17'],12,26,38,219837,3,0.818181818,1,0.909090909,815
830f46a382b63a18e5ad4871894bdbe38139adb3,0,Kevin Clark,2008-06-18 01:19:51+00:00,['fdc9c976f9d219ee693674fe6a45fafe21796ac4'],7,7,14,219851,1,1,0,0,815
8c3e0932f27aa508eb2c6fcdff91086852111f3c,0,Kevin Clark,2008-06-18 01:19:54+00:00,['830f46a382b63a18e5ad4871894bdbe38139adb3'],9,40,49,219900,1,0.407407407,1,0.333333333,815
980e4453472bb4c552707e6627e76ee8e3ba020a,0,Kevin Clark,2008-06-18 01:19:59+00:00,['8c3e0932f27aa508eb2c6fcdff91086852111f3c'],16,39,55,219955,3,0,0.941176471,0.764705882,815
e4b780de3664ea6b5bdb18844cd060cb7e49c638,0,Kevin Clark,2008-06-18 01:20:02+00:00,['980e4453472bb4c552707e6627e76ee8e3ba020a'],0,1,1,219956,1,1,1,1,815
4b429ad86e62744652a47700e96e39e93e8f9ae2,0,Kevin Clark,2008-06-18 01:20:06+00:00,['e4b780de3664ea6b5bdb18844cd060cb7e49c638'],1,2,3,219959,1,,,,815
d8d0d603097dd6669f8d7d2c705959c189e052a2,0,Kevin Clark,2008-06-18 01:20:10+00:00,['4b429ad86e62744652a47700e96e39e93e8f9ae2'],1,5,6,219965,1,,,,815
f0940220c89e240e3af746c96cda5fed5305bb82,0,Kevin Clark,2008-06-18 01:20:13+00:00,['d8d0d603097dd6669f8d7d2c705959c189e052a2'],1,1,2,219967,1,,,,815
77b39b3fd818d18c8b8d8623f8a2448ca2e5ce13,0,Kevin Clark,2008-06-18 01:20:16+00:00,['f0940220c89e240e3af746c96cda5fed5305bb82'],1,1,2,219969,1,,,,815
f8ecb02ef4fae39f6f837508f75038afd4f69aa9,0,Kevin Clark,2008-06-18 01:20:22+00:00,['77b39b3fd818d18c8b8d8623f8a2448ca2e5ce13'],2,48,50,220019,6,0.918918919,1,1,815
f731b49b6954dd3006cf9039ed3b37c38d5b86ac,0,Kevin Clark,2008-06-18 01:20:25+00:00,['f8ecb02ef4fae39f6f837508f75038afd4f69aa9'],2,3,5,220024,1,1,1,1,815
be1dd3a0e1ee7c4e56334b4189e7ce05e32680fc,0,Doug Cutting,2008-06-20 22:21:19+00:00,['f731b49b6954dd3006cf9039ed3b37c38d5b86ac'],0,0,0,220024,0,,,,815
a058d02eda026c05a510c3f4011608c7d4ac5bed,0,Kevin Clark,2008-06-24 00:33:00+00:00,['be1dd3a0e1ee7c4e56334b4189e7ce05e32680fc'],20,49,69,220093,2,0.103448276,1,1,815
3836f9ba355e98ebe5bb9970f830bb7baa29bf22,0,Kevin Clark,2008-06-24 01:05:51+00:00,['a058d02eda026c05a510c3f4011608c7d4ac5bed'],3,3,6,220099,3,,,,815
cd72befc86f2861bbb3341bf506712265916884c,0,Kevin Clark,2008-06-24 01:05:55+00:00,['3836f9ba355e98ebe5bb9970f830bb7baa29bf22'],4,4,8,220107,1,,,,815
c06b015e22c6128872391dc022b634173fe75439,0,Kevin Clark,2008-06-24 01:05:57+00:00,['cd72befc86f2861bbb3341bf506712265916884c'],14,20,34,220141,1,,,,815
3a9ffbda08ce0dca4b095cbb87e0c069c5961685,1,Kevin Clark,2008-06-24 01:06:00+00:00,['c06b015e22c6128872391dc022b634173fe75439'],0,78,78,220219,3,,,,817
c5336ff6915c454b7f10c6fe473e2257a1303367,0,Kevin Clark,2008-06-24 01:06:06+00:00,['3a9ffbda08ce0dca4b095cbb87e0c069c5961685'],48,28,76,220295,8,,,,817
1b8fec10dbd4513adda091d1ae2b20d1dac017ef,1,Kevin Clark,2008-06-24 01:06:08+00:00,['c5336ff6915c454b7f10c6fe473e2257a1303367'],20,21,41,220336,1,,,,817
eaf8d034e7e408a8185975ca4194ece66bd7ea0c,0,Kevin Clark,2008-06-24 01:06:10+00:00,['1b8fec10dbd4513adda091d1ae2b20d1dac017ef'],1586,0,1586,221922,2,0.233716475,0.137931034,0.068007663,817
1ce8b3d7d502cff253b1ac761d2326763f144101,0,Kevin Clark,2008-06-24 01:32:03+00:00,['eaf8d034e7e408a8185975ca4194ece66bd7ea0c'],2,3,5,221927,2,1,1,1,817
1e0744d7a2daacaf5044427fa614268d1f4fcb2f,0,Kevin Clark,2008-06-24 20:46:32+00:00,['1ce8b3d7d502cff253b1ac761d2326763f144101'],7,8,15,221942,1,0,0,1,817
2bd3a30b91ef2a4a6c54b4a030a4955a65c96bc8,0,Kevin Clark,2008-06-26 17:49:49+00:00,['1e0744d7a2daacaf5044427fa614268d1f4fcb2f'],12,11,23,221965,10,,,,817
091fa95233d793e10a95ebcce9e12b135301a855,0,Kevin Clark,2008-06-26 18:10:56+00:00,['2bd3a30b91ef2a4a6c54b4a030a4955a65c96bc8'],3,23,26,221991,2,1,1,1,817
3387115fa3e49a11cf70d4e2cbfaf8875993bed4,0,Kevin Clark,2008-06-26 18:14:25+00:00,['091fa95233d793e10a95ebcce9e12b135301a855'],0,6,6,221997,1,,,,817
5da153b36a91c9ea6bda9a717dd1f5e55639addc,0,Kevin Clark,2008-06-26 18:35:15+00:00,['3387115fa3e49a11cf70d4e2cbfaf8875993bed4'],1,11,12,222009,2,0.888888889,0.888888889,1,817
f2e4d107af58ad806556cc289befa3b2cf694d3c,0,Kevin Clark,2008-06-26 18:45:19+00:00,['5da153b36a91c9ea6bda9a717dd1f5e55639addc'],5,22,27,222036,2,1,1,0.875,817
28744ab833688ffe95eb4634aae33ad6f57a9054,0,Kevin Clark,2008-06-26 18:45:29+00:00,['f2e4d107af58ad806556cc289befa3b2cf694d3c'],0,9,9,222045,3,1,1,1,817
fc0646481faaeccdc88bbd5d61b05a5da91f8a9b,1,David Reiss,2008-06-30 19:13:23+00:00,['28744ab833688ffe95eb4634aae33ad6f57a9054'],19,36,55,222100,5,0.5,0,0,817
6b082755f0cba0bb8469f5f262f01a4defce348d,0,David Reiss,2008-06-30 19:48:04+00:00,['fc0646481faaeccdc88bbd5d61b05a5da91f8a9b'],1,32,33,222133,1,0,0,1,817
dd08f6d5a5bbc39b4ab30a3cb6996b39f7605f06,1,David Reiss,2008-06-30 20:24:24+00:00,['6b082755f0cba0bb8469f5f262f01a4defce348d'],1,77,78,222211,3,0.272727273,0.363636364,1,818
f14541626d1c49cb1439d65e81fa3609c23b7cf0,1,David Reiss,2008-06-30 20:45:47+00:00,['dd08f6d5a5bbc39b4ab30a3cb6996b39f7605f06'],7,38,45,222256,4,,,,819
52cb7a7413a33a86079cf8e9b3561e33339aeb9d,0,David Reiss,2008-06-30 21:40:35+00:00,['f14541626d1c49cb1439d65e81fa3609c23b7cf0'],25,9,34,222290,2,1,1,0,819
4d8edc5269a6e72be6e4a1257b67646dfce932ae,0,David Reiss,2008-06-30 21:55:52+00:00,['52cb7a7413a33a86079cf8e9b3561e33339aeb9d'],2,2,4,222294,2,,,,819
aabfa63c479fb8a0c5003291697ec139b1ddfc79,0,David Reiss,2008-06-30 22:27:29+00:00,['4d8edc5269a6e72be6e4a1257b67646dfce932ae'],2,2,4,222298,1,,,,819
03b574feada3862d460c7fc15dd1fb90687ff428,1,David Reiss,2008-07-02 23:55:04+00:00,['aabfa63c479fb8a0c5003291697ec139b1ddfc79'],3,1480,1483,223781,11,0.808477237,0.861852433,0.769230769,827
af78778acd7fb551a84aaf63e604d969123bf85d,0,David Reiss,2008-07-03 20:29:34+00:00,['03b574feada3862d460c7fc15dd1fb90687ff428'],46,4,50,223831,4,0.787878788,0.727272727,0.060606061,827
4bd8916b1257378f8173c4ada41b4606e9c0226b,1,Kevin Clark,2008-07-08 00:47:49+00:00,['af78778acd7fb551a84aaf63e604d969123bf85d'],71,4197,4268,228099,30,0.62006717,0.769521411,0.828715365,841
bf2ff249b97b31822cb02c4850dae15966b70a6f,0,Kevin Clark,2008-07-08 23:20:15+00:00,['4bd8916b1257378f8173c4ada41b4606e9c0226b'],11,22,33,228132,2,1,1,1,841
615da249957987b39887eb12abe887ad6c883114,0,Kevin Clark,2008-07-08 23:30:13+00:00,['bf2ff249b97b31822cb02c4850dae15966b70a6f'],3,4,7,228139,3,1,1,1,841
53f18f01bea79d373d0bb1138b67c03e42f4143c,1,David Reiss,2008-07-11 00:45:29+00:00,['615da249957987b39887eb12abe887ad6c883114'],25,45,70,228209,3,,,,842
f0c21a72cd6b027779fa99e55ec21be06c3dee41,1,David Reiss,2008-07-11 01:26:16+00:00,['53f18f01bea79d373d0bb1138b67c03e42f4143c'],2,8,10,228219,3,,,,842
b87d84d753bfe92f376a9229834b900fe7d43253,1,David Reiss,2008-07-11 08:02:29+00:00,['f0c21a72cd6b027779fa99e55ec21be06c3dee41'],0,3,3,228222,1,,,,842
8d07e1d1524ce548bcd3b9b792af6f0af218a8bb,0,David Reiss,2008-07-11 08:04:12+00:00,['b87d84d753bfe92f376a9229834b900fe7d43253'],3,3,6,228228,3,,,,842
2be87f3ab036183d49ad7a9af274c797839ef342,0,David Reiss,2008-07-11 21:39:58+00:00,['8d07e1d1524ce548bcd3b9b792af6f0af218a8bb'],2,2,4,228232,1,,,,842
01e55c1c28547eaac74636790bb86617c890c4c2,1,David Reiss,2008-07-13 22:18:51+00:00,['2be87f3ab036183d49ad7a9af274c797839ef342'],112,114,226,228458,7,1,1,0.117647059,842
db65e3dd68ad1a335996d319bee6c923974872f1,1,David Reiss,2008-07-13 23:15:55+00:00,['01e55c1c28547eaac74636790bb86617c890c4c2'],0,11,11,228469,1,0,1,1,842
70e329f0b8ed79df2c7b1de0366a8841eeeabd85,0,David Reiss,2008-07-14 19:35:50+00:00,['db65e3dd68ad1a335996d319bee6c923974872f1'],2,15,17,228486,1,0.2,0.2,0.4,842
7a4ff6be4d7ce6726bcd4573a00669678697f1d9,1,David Reiss,2008-07-16 05:13:30+00:00,['70e329f0b8ed79df2c7b1de0366a8841eeeabd85'],12,18,30,228516,1,,,,842
1931b12be037fe3e0e70f09510497aa78e2b586a,0,David Reiss,2008-07-17 19:36:34+00:00,['7a4ff6be4d7ce6726bcd4573a00669678697f1d9'],1,1,2,228518,1,,,,842
5ae0bab24791b48caab35a820be19567134f1256,1,Kevin Clark,2008-07-18 21:49:50+00:00,['1931b12be037fe3e0e70f09510497aa78e2b586a'],7,89,96,228614,5,0.180555556,0.180555556,0.902777778,842
8d1918be78aa932dc398b7f51c83dc03ca04d920,0,Kevin Clark,2008-07-18 21:57:07+00:00,['5ae0bab24791b48caab35a820be19567134f1256'],0,1,1,228615,1,,,,842
b58633945386f0a879d8da58b271fe1bf0de3cd5,0,Kevin Clark,2008-07-18 22:03:48+00:00,['8d1918be78aa932dc398b7f51c83dc03ca04d920'],30,39,69,228684,4,1,1,0,842
f4e700883b943775233b75770a12fd7affa9ef31,0,Kevin Clark,2008-07-18 22:27:03+00:00,['b58633945386f0a879d8da58b271fe1bf0de3cd5'],5,18,23,228707,2,1,1,1,842
0ee93eaa464d524efcfda4f243d2c456a4dfac5e,0,David Reiss,2008-07-21 19:03:11+00:00,['f4e700883b943775233b75770a12fd7affa9ef31'],24,0,24,228731,12,,,,842
f6c6c9c09d9d785bb37da5d87d880d4122c9452f,0,David Reiss,2008-07-21 19:03:31+00:00,['0ee93eaa464d524efcfda4f243d2c456a4dfac5e'],2,0,2,228733,1,,,,842
46e8d0b8fb18e25baf45a51715d7e3129a17fdb6,0,David Reiss,2008-07-22 06:57:41+00:00,['f6c6c9c09d9d785bb37da5d87d880d4122c9452f'],1,1,2,228735,1,,,,842
5317b1ecd23bc6ba29905cff6f8e411fbfe287f8,1,David Reiss,2008-07-24 19:10:16+00:00,['46e8d0b8fb18e25baf45a51715d7e3129a17fdb6'],1,1,2,228737,1,,,,842
5ff21a4df610cf7a5b35563169dddf1f68325ba4,0,David Reiss,2008-07-24 19:13:54+00:00,['5317b1ecd23bc6ba29905cff6f8e411fbfe287f8'],1,6,7,228744,1,,,,842
6144e428d5f55ef5cb81dbef1af8a140f94ad53c,0,David Reiss,2008-07-24 19:20:32+00:00,['5ff21a4df610cf7a5b35563169dddf1f68325ba4'],2,10,12,228756,1,1,1,1,842
400a543b04d12b3d97c7ba50143ef7b21c7166fb,0,David Reiss,2008-07-25 19:48:39+00:00,['6144e428d5f55ef5cb81dbef1af8a140f94ad53c'],0,1,1,228757,1,,,,842
3899248d29369196473df36697f834d772faff74,0,David Reiss,2008-07-25 21:05:59+00:00,['400a543b04d12b3d97c7ba50143ef7b21c7166fb'],2,2,4,228761,1,,,,842
72754e198f9b4bbba49bd38a58321d211ab9aed4,1,David Reiss,2008-07-25 21:06:03+00:00,['3899248d29369196473df36697f834d772faff74'],273,367,640,229401,4,1,1,1,844
0c7d38cf835b53d6d1b44fc099d3eab8cf3c5259,0,David Reiss,2008-07-25 21:06:06+00:00,['72754e198f9b4bbba49bd38a58321d211ab9aed4'],4,13,17,229418,2,1,1,0.428571429,844
1f5ce50186de5dcd753b68d8a80428dd4913ba75,0,David Reiss,2008-07-27 23:41:13+00:00,['0c7d38cf835b53d6d1b44fc099d3eab8cf3c5259'],2,10,12,229430,1,1,1,0,844
5ebb23b3e11dbae53afc395336b165455e1ff12c,0,Kevin Clark,2008-07-28 22:16:28+00:00,['1f5ce50186de5dcd753b68d8a80428dd4913ba75'],1,18,19,229449,2,1,1,0.6875,844
c8190174dc638f5b60dc19785c8beca04d0ac7af,0,Kevin Clark,2008-07-28 22:16:34+00:00,['5ebb23b3e11dbae53afc395336b165455e1ff12c'],0,2,2,229451,1,,,,844
3af9287a743b6c8a4964032059dd67d6c9e023fc,1,Kevin Clark,2008-07-28 22:20:36+00:00,['c8190174dc638f5b60dc19785c8beca04d0ac7af'],3,65,68,229519,2,1,1,1,844
e29995e75be58281975def90935c5894e3eb98c7,1,David Reiss,2008-07-31 20:15:17+00:00,['3af9287a743b6c8a4964032059dd67d6c9e023fc'],22,36,58,229577,1,0,0,0.545454545,844
a2693c135edef13a5f4816921c26cf1c33f025ce,1,Kevin Clark,2008-08-01 22:04:09+00:00,['e29995e75be58281975def90935c5894e3eb98c7'],48,91,139,229716,3,1,1,1,844
4ad40d7c23f35e48fef4836e30741c1087d018ed,0,David Reiss,2008-08-04 18:38:36+00:00,['a2693c135edef13a5f4816921c26cf1c33f025ce'],1,1,2,229718,1,,,,844
14fe791ef36d84a16abdafd67d87ff85e8780924,1,Kevin Clark,2008-08-04 18:46:19+00:00,['4ad40d7c23f35e48fef4836e30741c1087d018ed'],8,131,139,229857,5,0.916666667,0.916666667,0.916666667,844
38a2ce635de89fe2e3686e04b8f146c853c4bfa0,0,Kevin Clark,2008-08-25 21:34:19+00:00,['14fe791ef36d84a16abdafd67d87ff85e8780924'],6,44,50,229907,2,0.483870968,1,1,844
969c04b912c774e6f9c6f0f3356b8eff5b5947b4,0,Kevin Clark,2008-08-25 22:16:45+00:00,['38a2ce635de89fe2e3686e04b8f146c853c4bfa0'],0,45,45,229952,2,1,1,1,844
5ad6d4a7e35dc8f7078529e8e8004eb90dae31e9,1,Kevin Clark,2008-08-26 20:02:07+00:00,['969c04b912c774e6f9c6f0f3356b8eff5b5947b4'],14,33,47,229999,5,0.733333333,0.8,0.8,844
f67ad9e68a390a7096d0d657f7c7d6ad884c611f,0,David Reiss,2008-09-04 18:23:29+00:00,['5ad6d4a7e35dc8f7078529e8e8004eb90dae31e9'],40,0,40,230039,1,0.772727273,0,0.545454545,844
7c28b33194e3c9c67b09a0053efb51f9fc69eb83,1,David Reiss,2008-09-20 00:14:01+00:00,['f67ad9e68a390a7096d0d657f7c7d6ad884c611f'],15,231,246,230285,9,1,1,1,846
6341d13a1f87c3426965bd51cba6bf331ed0c36b,0,Mark Slee,2008-09-29 22:01:30+00:00,['7c28b33194e3c9c67b09a0053efb51f9fc69eb83'],1,1,2,230287,1,,,,846
5af01bcbdc0aa34486f235294b32674c37192575,0,David Reiss,2008-10-01 03:24:50+00:00,['6341d13a1f87c3426965bd51cba6bf331ed0c36b'],1,7,8,230295,1,0,0,1,846
931d69be9e40250823997adac67866d10aefe377,0,David Reiss,2008-10-01 03:24:54+00:00,['5af01bcbdc0aa34486f235294b32674c37192575'],8,33,41,230336,1,0,0,1,846
8684554e2947b7b0e6b38ebd4f5f80b0be83ddfe,0,David Reiss,2008-10-01 18:32:47+00:00,['931d69be9e40250823997adac67866d10aefe377'],6,13,19,230355,1,0,1,1,846
58434e698865101096e28fb2ea98282133d55e2c,0,David Reiss,2008-10-07 21:08:10+00:00,['8684554e2947b7b0e6b38ebd4f5f80b0be83ddfe'],1,1,2,230357,1,,,,846
e11f3073f7411e7b0508047850fcb42b331a2e5e,0,David Reiss,2008-10-07 21:39:19+00:00,['58434e698865101096e28fb2ea98282133d55e2c'],1,9,10,230367,1,0,0,1,846
9837aaf097729beb2d3c656bb68c9c373faa84e9,1,David Reiss,2008-10-07 23:03:47+00:00,['e11f3073f7411e7b0508047850fcb42b331a2e5e'],2,6,8,230375,1,0.5,0.5,1,846
c53a5944eda576d1920cf44359e310b1205361cb,0,David Reiss,2008-10-07 23:55:24+00:00,['9837aaf097729beb2d3c656bb68c9c373faa84e9'],1,1,2,230377,1,,,,846
a0b4409f57461bef7e0266ff46ed9602f3d222c2,0,David Reiss,2008-10-08 04:49:25+00:00,['c53a5944eda576d1920cf44359e310b1205361cb'],1,7,8,230385,1,0,0,0,846
31997ca9ee2ac234358b3cb9dc5792d95efe0f19,1,David Reiss,2008-10-09 00:08:46+00:00,['a0b4409f57461bef7e0266ff46ed9602f3d222c2'],3,101,104,230489,1,0.349206349,0.968253968,0.682539683,846
fc8a1e04693c95ccad02bfa760064606c2358f5a,0,Mark Slee,2008-10-14 22:00:36+00:00,['31997ca9ee2ac234358b3cb9dc5792d95efe0f19'],2,11,13,230502,2,1,1,1,846
4f1bbc7e8a28cdc1621f6cc9627a7cbd5cc74546,0,Mark Slee,2008-10-14 22:05:11+00:00,['fc8a1e04693c95ccad02bfa760064606c2358f5a'],3,6,9,230511,1,1,1,1,846
c2485608976036d50b0066018f8d3dbb80291f6c,1,Kevin Clark,2008-10-15 19:06:18+00:00,['4f1bbc7e8a28cdc1621f6cc9627a7cbd5cc74546'],1,4,5,230516,1,1,1,1,846
6ca3881f518b093c8b21b6a94523151e05a0ecbc,1,Kevin Clark,2008-10-16 19:14:47+00:00,['c2485608976036d50b0066018f8d3dbb80291f6c'],1,2,3,230519,1,1,1,1,846
7dc7f75e7c15061e3dd6bf133bb837f1d96cc6b3,1,Kevin Clark,2008-10-16 19:15:20+00:00,['6ca3881f518b093c8b21b6a94523151e05a0ecbc'],34,91,125,230644,6,0.909090909,1,0.909090909,846
1cc0c5e6d6088849cca2987af39f0d9a965c0d60,0,David Reiss,2008-10-17 19:30:35+00:00,['7dc7f75e7c15061e3dd6bf133bb837f1d96cc6b3'],6,6,12,230656,2,,,,846
826e648354c4e2e37abe5d8dda04e6497d76e16a,0,David Reiss,2008-10-20 21:29:07+00:00,['1cc0c5e6d6088849cca2987af39f0d9a965c0d60'],1,1,2,230658,1,,,,846
dc0aada96102265565368db6996ddb5cd37b5e3f,1,David Reiss,2008-10-21 00:09:23+00:00,['826e648354c4e2e37abe5d8dda04e6497d76e16a'],0,614,614,231272,3,0.091106291,0.321041215,0.982646421,847
ad8ce354acc30777fad8d6d0b89b512f5a13d689,0,David Reiss,2008-10-22 21:59:12+00:00,['dc0aada96102265565368db6996ddb5cd37b5e3f'],64,64,128,231400,1,,,,847
ce426240abe65365c3cbc8a162e93a698b7949e1,0,David Reiss,2008-10-22 21:59:15+00:00,['ad8ce354acc30777fad8d6d0b89b512f5a13d689'],0,11,11,231411,1,,,,847
80096e278c9700d4dcbe1050aca8bef987cc425f,0,David Reiss,2008-10-22 22:07:00+00:00,['ce426240abe65365c3cbc8a162e93a698b7949e1'],0,2,2,231413,1,,,,847
66f5e9ba0bd9e4605c48913e29bd6bed79f5a579,0,David Reiss,2008-10-22 22:07:03+00:00,['80096e278c9700d4dcbe1050aca8bef987cc425f'],1,1,2,231415,1,,,,847
babaea2f0f2700bd46760d06f35095f89cd33d57,0,Mark Slee,2008-10-27 22:45:26+00:00,['66f5e9ba0bd9e4605c48913e29bd6bed79f5a579'],14,25,39,231454,1,0,0,0,847
f011bd4312a8b780a91ad011d6e1f16a36448af8,0,David Reiss,2008-10-29 00:07:45+00:00,['babaea2f0f2700bd46760d06f35095f89cd33d57'],17,3,20,231474,1,0,0,0,847
f33e03c6fad10465ac4867b27c63a35cb2de0cbe,1,David Reiss,2008-10-29 00:07:49+00:00,['f011bd4312a8b780a91ad011d6e1f16a36448af8'],10,29,39,231513,2,0,0,0,847
d90cd1f539f5837858aa64256d187b4444560b81,0,David Reiss,2008-10-29 22:50:34+00:00,['f33e03c6fad10465ac4867b27c63a35cb2de0cbe'],8,10,18,231531,1,0,0,0,847
080991bf988ead697afed3d4567d30615609bf08,1,David Reiss,2008-10-30 04:28:42+00:00,['d90cd1f539f5837858aa64256d187b4444560b81'],2,2,4,231535,1,,,,847
cfca336fad004b6a41b13d02b3f1da86d2e7cae0,1,Kevin Clark,2008-10-31 00:32:25+00:00,['080991bf988ead697afed3d4567d30615609bf08'],1,15,16,231551,1,0.75,1,0.875,847
762e9bd15f84e8dc45eec60308a0519be3bdda9a,0,Kevin Clark,2008-10-31 00:39:20+00:00,['cfca336fad004b6a41b13d02b3f1da86d2e7cae0'],9,18,27,231578,1,0,1,1,847
74421273ad97359402556428f23afacfe31ce978,1,David Reiss,2008-11-07 23:09:31+00:00,['762e9bd15f84e8dc45eec60308a0519be3bdda9a'],21,349,370,231948,5,0.78,0.78,0.785,848
159383f789651150ae33748d7d68ef22108d614c,1,Kevin Clark,2008-11-11 05:46:04+00:00,['74421273ad97359402556428f23afacfe31ce978'],3,76,79,232027,5,0.574074074,1,0.981481481,848
713623bee6105f6b8ee946cecde4dd98847f6a2b,0,Kevin Clark,2008-11-14 17:09:52+00:00,['159383f789651150ae33748d7d68ef22108d614c'],1,1,2,232029,1,,,,848
031baf70860ade4096953d1c0838408ca0ecee96,1,Kevin Clark,2008-11-14 17:11:39+00:00,['713623bee6105f6b8ee946cecde4dd98847f6a2b'],13,28,41,232070,6,0,1,1,848
1d5a1f6500c0c40fe3ba06b7a63ed02b16675f45,0,Kevin Clark,2008-11-19 23:24:12+00:00,['031baf70860ade4096953d1c0838408ca0ecee96'],1,0,1,232071,1,1,0,0,848
8c28df256913e8c2fdfb64538ffcb7f9f4b9bd91,0,David Reiss,2008-11-20 21:24:18+00:00,['1d5a1f6500c0c40fe3ba06b7a63ed02b16675f45'],1,3,4,232075,1,,,,848
466b3fafcdcc52aa6423738caf83676acc65f916,1,David Reiss,2008-11-20 21:24:32+00:00,['8c28df256913e8c2fdfb64538ffcb7f9f4b9bd91'],1,1,2,232077,1,,,,848
c26da0a391cc8ae4d7e2c54d088006c72f60a274,0,David Reiss,2008-11-20 22:22:23+00:00,['466b3fafcdcc52aa6423738caf83676acc65f916'],8,1,9,232086,1,1,1,0,848
7f5e184785f3e219b6e30436479ca3e7ae63ed12,1,David Reiss,2008-11-21 20:25:14+00:00,['c26da0a391cc8ae4d7e2c54d088006c72f60a274'],0,1,1,232087,1,0,0,1,848
30a9360e3ffd30afd5122af75cefa349a79e3aaf,1,David Reiss,2008-11-21 21:31:36+00:00,['7f5e184785f3e219b6e30436479ca3e7ae63ed12'],1,92,93,232180,3,0,0.357142857,1,849
e31b77e90e54709dfb0020cd5fe468c0998d6d81,0,David Reiss,2008-11-21 21:36:41+00:00,['30a9360e3ffd30afd5122af75cefa349a79e3aaf'],1,1,2,232182,1,,,,849
fd71808e35af5ba82a29320abfcbc30ef7fc6b87,1,David Reiss,2008-11-21 21:55:52+00:00,['e31b77e90e54709dfb0020cd5fe468c0998d6d81'],0,33,33,232215,1,0,0.321428571,1,849
04c315946c68034a51376bab368a4c4c2c8a8ba5,1,David Reiss,2008-11-21 23:07:05+00:00,['fd71808e35af5ba82a29320abfcbc30ef7fc6b87'],14,140,154,232369,5,0.527272727,0.836363636,0.654545455,850
603d50437cbe9c76be942f863f2db9526459fce2,1,David Reiss,2008-12-02 02:06:31+00:00,['04c315946c68034a51376bab368a4c4c2c8a8ba5'],2,258,260,232629,3,0.039772727,0.465909091,0.426136364,851
0c87ad41ee8dc669f8e1cbe0b17f8382844a0497,0,David Reiss,2008-12-02 02:11:13+00:00,['603d50437cbe9c76be942f863f2db9526459fce2'],7,7,14,232643,5,,,,851
428d5695ab6dd8a598b1be5bb29cfb7c90aa9414,0,David Reiss,2008-12-02 02:22:01+00:00,['0c87ad41ee8dc669f8e1cbe0b17f8382844a0497'],1,3,4,232647,1,1,0,0,851
fbb14ef1b33db23cb0862975af58bbba957d2378,0,David Reiss,2008-12-02 02:32:25+00:00,['428d5695ab6dd8a598b1be5bb29cfb7c90aa9414'],3,2,5,232652,1,,,,851
322e595c2ac8a7ff4ef53cc472882d85e36000a0,0,David Reiss,2008-12-05 02:54:09+00:00,['fbb14ef1b33db23cb0862975af58bbba957d2378'],38,38,76,232728,6,,,,851
a2309996679350a249beeac34efd65ff703f5b23,0,David Reiss,2008-12-10 01:52:48+00:00,['322e595c2ac8a7ff4ef53cc472882d85e36000a0'],6,84,90,232818,3,,,,852
083c07a26579e685bd62b085471f8720ef0aa822,0,Kevin Clark,2008-12-13 02:39:20+00:00,['a2309996679350a249beeac34efd65ff703f5b23'],1,6,7,232825,2,1,1,1,852
a8efac862a847ea4c2c2983704ef875a12f92080,1,David Reiss,2008-12-16 20:28:13+00:00,['083c07a26579e685bd62b085471f8720ef0aa822'],5,16,21,232846,3,0,0,0,852
681e04e47c8d0587702f046d41d8e29fd4599cdb,0,David Reiss,2008-12-16 20:31:26+00:00,['a8efac862a847ea4c2c2983704ef875a12f92080'],0,0,0,232846,0,,,,852
a60df1fab4545031645cd972fa27695286887da4,0,T Jake Luciani,2008-12-22 13:13:56+00:00,['681e04e47c8d0587702f046d41d8e29fd4599cdb'],1,2,3,232849,1,,,,852
0a136c8ca8d9bc38d57024636f2ff703ccc80345,0,David Reiss,2008-12-22 19:54:12+00:00,['a60df1fab4545031645cd972fa27695286887da4'],104,81,185,233034,1,,,,852
0d738890ba9236060c1c500c6f44ba1b7133b3d3,0,T Jake Luciani,2008-12-23 03:12:50+00:00,['0a136c8ca8d9bc38d57024636f2ff703ccc80345'],2,17,19,233053,1,,,,852
41687fc6cfa179883da9b18d094ad56f6be669da,1,T Jake Luciani,2008-12-23 03:45:43+00:00,['0d738890ba9236060c1c500c6f44ba1b7133b3d3'],37,52,89,233142,4,0.714285714,0.785714286,0.928571429,852
888f88b05d25eb7b07541ed916f05234e1229138,0,David Reiss,2009-01-05 20:14:52+00:00,['41687fc6cfa179883da9b18d094ad56f6be669da'],4,3,7,233149,1,1,1,1,852
5455f00348b7cce553dc3f7bec40d297d112216a,1,David Reiss,2009-01-05 21:02:48+00:00,['888f88b05d25eb7b07541ed916f05234e1229138'],10,30,40,233189,2,0.277777778,0.555555556,0.277777778,852
b936ffdbd1740fda3686cd71bdcb1f865b709d07,0,David Reiss,2009-01-05 21:02:52+00:00,['5455f00348b7cce553dc3f7bec40d297d112216a'],0,37,37,233226,2,0.894736842,0.947368421,0.947368421,853
2db737df8fa19f5fcb2f926b0fe2594f0154d7f4,1,David Reiss,2009-01-05 21:02:55+00:00,['b936ffdbd1740fda3686cd71bdcb1f865b709d07'],39,20,59,233285,1,1,1,0.208333333,853
25be92bf0d9ef587f24696caf182788705fa1119,1,David Reiss,2009-01-05 21:02:58+00:00,['2db737df8fa19f5fcb2f926b0fe2594f0154d7f4'],1,148,149,233434,4,0,0.198019802,0.99009901,855
8eaebfedc12bfc95ba3069bf99fe73375b1f8152,1,David Reiss,2009-01-05 21:03:01+00:00,['25be92bf0d9ef587f24696caf182788705fa1119'],1,1,2,233436,1,,,,855
bcb4cf83e56ecbe5167d8c6ae79248c35020afe4,0,Kevin Clark,2009-01-05 23:00:22+00:00,['8eaebfedc12bfc95ba3069bf99fe73375b1f8152'],0,9,9,233445,1,1,1,1,855
41baeaba96302e480265542340532842bc5ab0c9,1,Kevin Clark,2009-01-05 23:10:17+00:00,['bcb4cf83e56ecbe5167d8c6ae79248c35020afe4'],9,20,29,233474,3,1,1,1,855
d6b7182df59ae7cb1849c36b5d9513fce681ce35,1,Kevin Clark,2009-01-06 01:34:28+00:00,['41baeaba96302e480265542340532842bc5ab0c9'],1,57,58,233532,5,0.944444444,1,1,855
6319133cacb49c815aa1783c129aa427c762b2fd,1,David Reiss,2009-01-06 19:49:22+00:00,['d6b7182df59ae7cb1849c36b5d9513fce681ce35'],55,1448,1503,235035,17,0.249183896,0.519042437,0.881392818,862
b0f31ef92fae72f60162b9ef03b498551d529cb5,0,David Reiss,2009-01-06 19:49:29+00:00,['6319133cacb49c815aa1783c129aa427c762b2fd'],1,2,3,235038,1,0,0,1,862
c654416843d84a9bd43add0dbc4567920947ea73,0,David Reiss,2009-01-06 19:49:33+00:00,['b0f31ef92fae72f60162b9ef03b498551d529cb5'],4,28,32,235070,3,,,,863
7bcf866c16525ee7ca709e250178a61333db27c4,1,David Reiss,2009-01-06 20:54:27+00:00,['c654416843d84a9bd43add0dbc4567920947ea73'],0,27,27,235097,1,0,1,1,863
46bb4aeb5e792b72810062f289151fde7d27a73b,1,David Reiss,2009-01-14 22:34:15+00:00,['7bcf866c16525ee7ca709e250178a61333db27c4'],34,52,86,235183,2,1,1,1,863
c85fd50e2b3308e84345e5e0045507c20e6c5626,0,Kevin Clark,2009-01-14 23:55:10+00:00,['46bb4aeb5e792b72810062f289151fde7d27a73b'],0,54,54,235237,1,1,1,1,863
afa80ea73d4cbf83afee807e5d9f9034fa177ade,1,Bryan Duxbury,2009-01-15 23:47:51+00:00,['c85fd50e2b3308e84345e5e0045507c20e6c5626'],249,249,498,235735,72,,,,863
6713e1b126c8734ae9daafb4a63f76f26ca7fb7b,0,David Reiss,2009-01-15 23:56:19+00:00,['afa80ea73d4cbf83afee807e5d9f9034fa177ade'],1,1,2,235737,1,,,,863
4c266ccc2cd6598891dfd8955cf0dc8ff4b97976,0,David Reiss,2009-01-15 23:56:24+00:00,['6713e1b126c8734ae9daafb4a63f76f26ca7fb7b'],1,1,2,235739,1,,,,863
9c983c2db0856293715fe64bd84272bf3fbdfb87,1,T Jake Luciani,2009-01-16 01:04:27+00:00,['4c266ccc2cd6598891dfd8955cf0dc8ff4b97976'],1,1,2,235741,1,,,,863
46b77c4be6c0cbd336f4e4501b9722de6ce25666,1,Bryan Duxbury,2009-01-16 22:34:40+00:00,['9c983c2db0856293715fe64bd84272bf3fbdfb87'],0,25,25,235766,1,0,0,1,863
8bbd8447b9de8a31ce50e6611d8f513d281897a3,1,Bryan Duxbury,2009-01-20 01:54:14+00:00,['46b77c4be6c0cbd336f4e4501b9722de6ce25666'],32,88,120,235886,1,0,0,0.973684211,863
4371038cd1e1a0a0ef5283bfd540c7623fbe7514,0,Bryan Duxbury,2009-01-22 16:27:16+00:00,['8bbd8447b9de8a31ce50e6611d8f513d281897a3'],1,1,2,235888,1,,,,863
8bb593e69a639246e56c4ee547f53e4269133d10,0,David Reiss,2009-01-24 19:37:41+00:00,['4371038cd1e1a0a0ef5283bfd540c7623fbe7514'],2,2,4,235892,2,,,,863
369417a5f15b54738d4954908fbb4908b8603295,1,Bryan Duxbury,2009-01-27 22:09:33+00:00,['8bb593e69a639246e56c4ee547f53e4269133d10'],3,4,7,235899,1,0,0,0,863
249d7cb199b5c08e7a7a51189a733cc8fef12cf9,1,Bryan Duxbury,2009-01-29 01:21:20+00:00,['369417a5f15b54738d4954908fbb4908b8603295'],65,52,117,236016,16,,,,863
9a75aa51922c53d2dd010cbf962bdcd2302833aa,0,Bryan Duxbury,2009-01-29 01:37:01+00:00,['249d7cb199b5c08e7a7a51189a733cc8fef12cf9'],1,1,2,236018,1,,,,863
986d705578f7c3189b076b43097da0ff2f5d648e,1,Bryan Duxbury,2009-01-29 01:51:08+00:00,['9a75aa51922c53d2dd010cbf962bdcd2302833aa'],11,286,297,236315,12,0.189542484,0.54248366,0.901960784,871
1f6302fab0f338547c3a8bbb24b2ea548a9b6550,1,Bryan Duxbury,2009-01-29 05:38:10+00:00,['986d705578f7c3189b076b43097da0ff2f5d648e'],4,4,8,236323,1,,,,871
9f427ee0e14fbc3a1e3c91a9f423bcbd8648e407,0,Bryan Duxbury,2009-01-29 05:47:21+00:00,['1f6302fab0f338547c3a8bbb24b2ea548a9b6550'],5,6,11,236334,1,0,0,0,871
50119f15aa034f5dde7113df112e6694246cfa76,0,Bryan Duxbury,2009-01-29 21:31:25+00:00,['9f427ee0e14fbc3a1e3c91a9f423bcbd8648e407'],14,4,18,236352,4,,,,871
796381d857f3a51fd1b059200425c84326cbcfe3,1,Bryan Duxbury,2009-01-29 22:13:56+00:00,['50119f15aa034f5dde7113df112e6694246cfa76'],2,2,4,236356,1,,,,871
c04452eff2db9b5c524522f0dcf0b2e776115efd,0,David Reiss,2009-01-29 23:46:46+00:00,['796381d857f3a51fd1b059200425c84326cbcfe3'],0,14,14,236370,1,1,1,1,872
b96d5288e80df60f84acc3509a7bd3b043b2b2fa,0,Bryan Duxbury,2009-01-29 23:53:34+00:00,['c04452eff2db9b5c524522f0dcf0b2e776115efd'],0,0,0,236370,0,,,,872
8341344b8605a6656a3953af37ffb588142d7b18,0,David Reiss,2009-01-29 23:54:41+00:00,['b96d5288e80df60f84acc3509a7bd3b043b2b2fa'],0,2,2,236372,1,,,,872
f0d35d220a339431a757c2ea8fb6316f4a24e0de,0,Greg Stein,2009-01-30 19:10:27+00:00,['8341344b8605a6656a3953af37ffb588142d7b18'],10,7,17,236389,1,,,,872
c1eb2a71c3fecadfb8eee1b59dfedb91659a9873,0,Greg Stein,2009-01-30 19:19:45+00:00,['f0d35d220a339431a757c2ea8fb6316f4a24e0de'],4188,0,4188,240577,9,0.391655886,0.187257439,0.101552393,872
ca823297fa14c738f9f84edafde62f6c26e64886,0,Greg Stein,2009-01-31 03:54:03+00:00,['c1eb2a71c3fecadfb8eee1b59dfedb91659a9873'],0,0,0,240577,0,,,,872
3166141fbd2152ae7281de95745089dcc4759d7d,1,David Reiss,2009-01-31 21:39:08+00:00,['ca823297fa14c738f9f84edafde62f6c26e64886'],2,3,5,240582,2,1,1,1,872
9813cbeda6f15be9bcbfb163ce475f82d7f02839,0,David Reiss,2009-01-31 21:39:11+00:00,['3166141fbd2152ae7281de95745089dcc4759d7d'],1,1,2,240584,1,,,,872
fb695b77d3b5ac69ba7011cddd066d55e23c3b0f,0,David Reiss,2009-01-31 21:39:16+00:00,['9813cbeda6f15be9bcbfb163ce475f82d7f02839'],15,3,18,240602,1,0,0,0.833333333,872
647d30d218d206474d583d0189bb8169f741e7d9,0,David Reiss,2009-01-31 21:39:20+00:00,['fb695b77d3b5ac69ba7011cddd066d55e23c3b0f'],8,8,16,240618,1,0,0,0,872
4c591c95a51368a817bf40157e46831ecffef71c,1,David Reiss,2009-01-31 21:39:25+00:00,['647d30d218d206474d583d0189bb8169f741e7d9'],1,53,54,240672,2,0.28125,1,0.8125,872
1fe17774eb1059bc784a5c3be46b208a2fc0a63c,0,David Reiss,2009-01-31 21:59:27+00:00,['4c591c95a51368a817bf40157e46831ecffef71c'],0,22,22,240694,1,1,1,1,872
f78ec2bc66d3a9fcfd63b9bdf49fc9bdc68b4cf7,1,David Reiss,2009-01-31 21:59:32+00:00,['1fe17774eb1059bc784a5c3be46b208a2fc0a63c'],17,87,104,240798,4,0.428571429,1,0.642857143,873
3fa89e33f3e7e76a2f79546c72d1728492f12bef,0,David Reiss,2009-01-31 22:12:34+00:00,['f78ec2bc66d3a9fcfd63b9bdf49fc9bdc68b4cf7'],1,1,2,240800,1,,,,873
b5e6221eb5cbabab25d5c9badb7262b15c42cfdd,1,T Jake Luciani,2009-01-31 22:36:20+00:00,['3fa89e33f3e7e76a2f79546c72d1728492f12bef'],513,513,1026,241826,95,,,,873
4704d4383c6e50a3231f0e5bc1fe866727bf23d4,0,David Reiss,2009-02-01 00:42:10+00:00,['b5e6221eb5cbabab25d5c9badb7262b15c42cfdd'],11,13,24,241850,1,0,1,1,873
1952e5494db6b773df6012de2d6ed889301a8d7b,1,T Jake Luciani,2009-02-01 04:47:30+00:00,['4704d4383c6e50a3231f0e5bc1fe866727bf23d4'],1,106,107,241957,7,,,,877
c2c8ad8f0b14d53b06d53e062eadfe5e4868c9f8,0,David Reiss,2009-02-01 05:36:10+00:00,['1952e5494db6b773df6012de2d6ed889301a8d7b'],0,10,10,241967,1,0,0.222222222,1,877
df20bb9c7c747cb20f96bd9723b086b3a356f2f6,0,Bryan Duxbury,2009-02-01 06:08:35+00:00,['c2c8ad8f0b14d53b06d53e062eadfe5e4868c9f8'],0,0,0,241967,0,,,,877
7003f876edf2aa4aef5e2550852cb707e9e6d57c,0,Bryan Duxbury,2009-02-01 06:21:13+00:00,['df20bb9c7c747cb20f96bd9723b086b3a356f2f6'],2,4,6,241973,3,,,,877
056bcb69477a12381bdb007debf55e654c1be257,1,Bryan Duxbury,2009-02-01 16:56:29+00:00,['7003f876edf2aa4aef5e2550852cb707e9e6d57c'],6,12,18,241991,4,0,0,0,877
c016628a8a05aecefb3718e74a04a6e59882d537,1,Bryan Duxbury,2009-02-02 00:48:17+00:00,['056bcb69477a12381bdb007debf55e654c1be257'],1548,1768,3316,245307,24,0.878504673,1,1,887
dc9092ab1a2953c282b1add4a2500467eb9e3c9d,0,Bryan Duxbury,2009-02-03 00:31:55+00:00,['c016628a8a05aecefb3718e74a04a6e59882d537'],1,1,2,245309,1,,,,887
f5383b663ecbfdf46d3a76553bfb3db3ea0af228,1,Bryan Duxbury,2009-02-03 00:49:25+00:00,['dc9092ab1a2953c282b1add4a2500467eb9e3c9d'],6,26,32,245341,2,1,1,1,887
1e80d4465a01869b7455b31f53a0aff42d939f6d,0,Bryan Duxbury,2009-02-03 18:16:54+00:00,['f5383b663ecbfdf46d3a76553bfb3db3ea0af228'],13,32,45,245386,10,1,1,0,887
3d0abc36a9921fb42601a0738bf686a1acce0798,1,Bryan Duxbury,2009-02-03 19:18:57+00:00,['1e80d4465a01869b7455b31f53a0aff42d939f6d'],3,3,6,245392,1,,,,887
2cdfd3705e6cef569d53baf1e1b2de42bb6f9aa7,0,David Reiss,2009-02-03 21:20:27+00:00,['3d0abc36a9921fb42601a0738bf686a1acce0798'],1,1,2,245394,1,,,,887
670cb0f18d5b1e1c297486e341a7e262eaaa8399,0,David Reiss,2009-02-03 21:20:55+00:00,['2cdfd3705e6cef569d53baf1e1b2de42bb6f9aa7'],0,1,1,245395,1,,,,887
80a44e7e82533d79e0ee664819004a60591809e9,0,David Reiss,2009-02-03 22:16:46+00:00,['670cb0f18d5b1e1c297486e341a7e262eaaa8399'],0,2,2,245397,1,,,,887
ead3382915e3e50845a2c6d0acdd75dc00dd3be3,1,Kevin Clark,2009-02-04 22:43:59+00:00,['80a44e7e82533d79e0ee664819004a60591809e9'],22,111,133,245530,6,0.357142857,1,0.742857143,887
d73774f53e3c48da30eaafc625a629764f9d699f,1,Bryan Duxbury,2009-02-05 00:24:42+00:00,['ead3382915e3e50845a2c6d0acdd75dc00dd3be3'],0,68,68,245598,1,0.636363636,1,0.704545455,888
d20a1d3619efa9edef51364d927bc9a78b37217f,0,Bryan Duxbury,2009-02-07 01:08:58+00:00,['d73774f53e3c48da30eaafc625a629764f9d699f'],5,13,18,245616,2,0,0,1,888
0b7d6fa5ee27dcfe60ed946c99fbc1c664bb4057,0,David Reiss,2009-02-07 02:36:35+00:00,['d20a1d3619efa9edef51364d927bc9a78b37217f'],2559,7,2566,248182,31,0.752955083,0.605200946,0.057328605,888
0b36a2d9c0a40ca51014e723dddd74e4bbb5d291,0,David Reiss,2009-02-07 02:36:43+00:00,['0b7d6fa5ee27dcfe60ed946c99fbc1c664bb4057'],0,69,69,248251,1,1,1,0.947368421,889
f4335dfdbe965c95cfca83d2299e00b96bb92b55,0,David Reiss,2009-02-07 02:36:46+00:00,['0b36a2d9c0a40ca51014e723dddd74e4bbb5d291'],4,4,8,248259,3,,,,889
858519aac58560a5b15f0c939ab4398dc33fbd4f,0,David Reiss,2009-02-07 02:36:50+00:00,['f4335dfdbe965c95cfca83d2299e00b96bb92b55'],9,9,18,248277,4,,,,889
f6dffcdc651b9513652ca2c74c19ba85c92339fd,0,David Reiss,2009-02-07 02:36:52+00:00,['858519aac58560a5b15f0c939ab4398dc33fbd4f'],852,0,852,249129,1,,,,889
cd5284c735bec7ee98dfc27ba4d3e4d2bc9bf0e4,0,David Reiss,2009-02-07 02:36:54+00:00,['f6dffcdc651b9513652ca2c74c19ba85c92339fd'],1,6,7,249136,1,,,,889
4bec874d826338bb925146610aef807670afc0f7,0,David Reiss,2009-02-07 02:36:57+00:00,['cd5284c735bec7ee98dfc27ba4d3e4d2bc9bf0e4'],0,2,2,249138,1,,,,889
576dfdcda75667d6e892df0b5a4508d7bddbcef4,0,David Reiss,2009-02-07 02:37:00+00:00,['4bec874d826338bb925146610aef807670afc0f7'],1,1,2,249140,1,,,,889
8cee47cf5e7f0b17aadd5895d632901d828b0554,1,David Reiss,2009-02-07 02:37:05+00:00,['576dfdcda75667d6e892df0b5a4508d7bddbcef4'],2,19,21,249161,4,0,1,1,890
a7fc092ee1e0f77b818b0e4bcc8954f9f746b21a,1,David Reiss,2009-02-07 02:37:09+00:00,['8cee47cf5e7f0b17aadd5895d632901d828b0554'],5,9,14,249175,3,0,0,0,890
f28f82631abd81f312a505214adc9bffe427db06,0,Bryan Duxbury,2009-02-07 17:17:43+00:00,['a7fc092ee1e0f77b818b0e4bcc8954f9f746b21a'],2,2,4,249179,1,,,,890
d83e250838705ad23444a8e6cda6d0aab5ef2e5b,0,Bryan Duxbury,2009-02-07 20:06:09+00:00,['f28f82631abd81f312a505214adc9bffe427db06'],147,148,295,249474,2,,,,890
bb7826da704c979257b280608f65c3a85bd6883d,1,Bryan Duxbury,2009-02-08 00:12:38+00:00,['d83e250838705ad23444a8e6cda6d0aab5ef2e5b'],122,134,256,249730,12,1,1,0,890
6ad6251951598e88f87245e325e29e31ba7126d2,0,David Reiss,2009-02-08 22:46:38+00:00,['bb7826da704c979257b280608f65c3a85bd6883d'],1,1,2,249732,1,,,,890
538e344122315036f0abdd8f3fa89b7f9dd1d310,1,Bryan Duxbury,2009-02-10 04:49:39+00:00,['6ad6251951598e88f87245e325e29e31ba7126d2'],5,1352,1357,251089,9,0.671091445,0.954277286,0.985250737,893
c707855048258ab60e78d602509513b1394ec962,1,Bryan Duxbury,2009-02-10 18:10:57+00:00,['538e344122315036f0abdd8f3fa89b7f9dd1d310'],6,162,168,251257,2,0.703296703,0.527472527,1,894
30e1de9fd5c11e5df3fc3673620ccac3299d8b86,0,Bryan Duxbury,2009-02-10 18:36:56+00:00,['c707855048258ab60e78d602509513b1394ec962'],18,8,26,251283,1,1,1,0,894
7d3df42bb5eefc740724537d802597668ab1a955,0,David Reiss,2009-02-10 21:38:44+00:00,['30e1de9fd5c11e5df3fc3673620ccac3299d8b86'],1,15,16,251299,2,1,1,1,895
035aed90c0a7e54cd9e0f2ac70dc7c1bb303a4b0,0,David Reiss,2009-02-10 21:38:48+00:00,['7d3df42bb5eefc740724537d802597668ab1a955'],0,6,6,251305,1,1,1,1,895
067c9aff285f3922d3e13b46ca52e4ec8c68b586,0,David Reiss,2009-02-11 01:11:54+00:00,['035aed90c0a7e54cd9e0f2ac70dc7c1bb303a4b0'],2,4,6,251311,1,,,,895
d831a21773d789fae1b1d0b52b3d6378f377b8b1,1,David Reiss,2009-02-13 03:09:52+00:00,['067c9aff285f3922d3e13b46ca52e4ec8c68b586'],120,235,355,251666,38,1,1,1,897
fdd8b5ab013be680eca7d6a241e6ebb39be0ff7c,0,David Reiss,2009-02-17 20:06:08+00:00,['d831a21773d789fae1b1d0b52b3d6378f377b8b1'],0,10,10,251676,1,,,,897
bbbbe880a08517a1b34f1526381e077b5a2168f6,0,David Reiss,2009-02-17 20:27:48+00:00,['fdd8b5ab013be680eca7d6a241e6ebb39be0ff7c'],0,1,1,251677,1,,,,897
a204783a0625eb9cc8bdfe5ee86e31251b563369,0,David Reiss,2009-02-17 20:27:54+00:00,['bbbbe880a08517a1b34f1526381e077b5a2168f6'],12,12,24,251701,3,1,1,0,897
9f16d785531a408cc48d8bb0e63b6b6058c55d59,1,David Reiss,2009-02-17 20:27:58+00:00,['a204783a0625eb9cc8bdfe5ee86e31251b563369'],141,136,277,251978,3,,,,897
f3b0db3735f4f441eedc46548c96199eba3e2486,0,David Reiss,2009-02-17 20:28:01+00:00,['9f16d785531a408cc48d8bb0e63b6b6058c55d59'],1,5,6,251984,2,,,,897
4ba6710ea1a9bfb3def8aeeccb38c32b110098a8,0,David Reiss,2009-02-17 20:28:06+00:00,['f3b0db3735f4f441eedc46548c96199eba3e2486'],12,13,25,252009,3,1,1,0,897
3ac5b6aa85b5d1526b22518045c756b4027e6d7c,0,David Reiss,2009-02-17 20:28:10+00:00,['4ba6710ea1a9bfb3def8aeeccb38c32b110098a8'],81,71,152,252161,3,,,,897
782cb67a3b90c85efeb6d23badab9ddbe18987b6,0,David Reiss,2009-02-17 20:28:13+00:00,['3ac5b6aa85b5d1526b22518045c756b4027e6d7c'],1,5,6,252167,2,,,,897
92e10d829778b21cfa9d1b38242704ca1392b7ab,0,David Reiss,2009-02-17 20:28:19+00:00,['782cb67a3b90c85efeb6d23badab9ddbe18987b6'],14,5,19,252186,4,0,0,0,897
a9ea68b907fe5fc2f5f06ba742e9fc1d849c7775,0,David Reiss,2009-02-17 20:28:24+00:00,['92e10d829778b21cfa9d1b38242704ca1392b7ab'],36,53,89,252275,4,0,0.2,0,897
bba692833dd045d2d60a4d3fd7ae52723258fc05,1,David Reiss,2009-02-17 20:28:28+00:00,['a9ea68b907fe5fc2f5f06ba742e9fc1d849c7775'],210,199,409,252684,3,,,,897
32272d9bd81f3d05b2dbfd3f504b29aeb9289964,0,David Reiss,2009-02-17 20:28:30+00:00,['bba692833dd045d2d60a4d3fd7ae52723258fc05'],1,5,6,252690,2,,,,897
554ea6f936c3ad2c3317e6ba94356c65b088536f,0,David Reiss,2009-02-17 20:28:37+00:00,['32272d9bd81f3d05b2dbfd3f504b29aeb9289964'],16,5,21,252711,6,0,0,0,897
b139f64448f4ae89a24029f0588a494308e84e74,1,David Reiss,2009-02-17 20:28:46+00:00,['554ea6f936c3ad2c3317e6ba94356c65b088536f'],21,15,36,252747,12,,,,897
d11f2411e204bbcf81bcd28dfa2897dbac7e2f01,1,Bryan Duxbury,2009-02-19 21:21:44+00:00,['b139f64448f4ae89a24029f0588a494308e84e74'],1362,184,1546,254293,3,1,0.995545657,0.001113586,897
f9d105c51997d0cc77ab5c30e3f1616359026fde,0,Bryan Duxbury,2009-02-21 01:57:46+00:00,['d11f2411e204bbcf81bcd28dfa2897dbac7e2f01'],1,1,2,254295,1,,,,897
f4c71c73d0d3438d5eb8c72dc889fb292bc23cc8,0,Bryan Duxbury,2009-02-23 17:49:24+00:00,['f9d105c51997d0cc77ab5c30e3f1616359026fde'],1,1,2,254297,1,,,,897
57b500610f34d15e7261c6460144ec88f710af85,0,David Reiss,2009-02-25 00:59:55+00:00,['f4c71c73d0d3438d5eb8c72dc889fb292bc23cc8'],0,1,1,254298,1,1,1,1,897
b5c9c546d817cdb9e316cc1076e3d6becff9ab06,1,Kevin Clark,2009-03-02 23:29:54+00:00,['57b500610f34d15e7261c6460144ec88f710af85'],1,1,2,254300,1,,,,897
6b40711896d28613cebcc484eed4be69e75c23d4,0,T Jake Luciani,2009-03-02 23:47:20+00:00,['b5c9c546d817cdb9e316cc1076e3d6becff9ab06'],1,1,2,254302,1,,,,897
120ff31d11a077c3ba7dc981762f35392e6c93fb,1,Kevin Clark,2009-03-03 02:25:50+00:00,['6b40711896d28613cebcc484eed4be69e75c23d4'],126,413,539,254841,1,0.044715447,0,0.991869919,897
e43f7e0925ae2a5c172596dd404a7d44e1cfc8f0,1,Kevin Clark,2009-03-03 22:03:57+00:00,['120ff31d11a077c3ba7dc981762f35392e6c93fb'],0,154,154,254995,1,1,1,0.670886076,898
e8d3c47944139364d0573fa82c3d5ba877df13e9,0,Kevin Clark,2009-03-03 22:13:46+00:00,['e43f7e0925ae2a5c172596dd404a7d44e1cfc8f0'],1,4,5,255000,1,1,1,0.5,898
5ace1780abe8f62e6e6be789ae53637f3a35b195,0,Kevin Clark,2009-03-04 21:10:58+00:00,['e8d3c47944139364d0573fa82c3d5ba877df13e9'],2,59,61,255061,3,0,0.342105263,0.947368421,898
c289608e1928cc8c6db482aafe7262a428b6f32e,1,Kevin Clark,2009-03-04 21:32:54+00:00,['5ace1780abe8f62e6e6be789ae53637f3a35b195'],22,22,44,255105,4,,,,898
af99b5c398bddbc70136e123135a912a3a342741,0,Kevin Clark,2009-03-04 21:42:46+00:00,['c289608e1928cc8c6db482aafe7262a428b6f32e'],4,11,15,255120,2,1,1,1,899
586f0a0f01458f5691382249d2899dbd7da84dd3,0,Kevin Clark,2009-03-04 22:06:59+00:00,['af99b5c398bddbc70136e123135a912a3a342741'],275,0,275,255395,1,0.5,0,0,899
022b224ebdd932bb8e4fe54beea02589c3661b8b,1,Kevin Clark,2009-03-05 21:05:37+00:00,['586f0a0f01458f5691382249d2899dbd7da84dd3'],92,92,184,255579,2,0,0,0,899
f4d6fa408ff8a6d52e69fe9a1d26f94822fc4576,0,Bryan Duxbury,2009-03-05 23:11:37+00:00,['022b224ebdd932bb8e4fe54beea02589c3661b8b'],1,1,2,255581,1,,,,899
3637645c9e2804fdca98c9ac70786c40efec07c2,1,Kevin Clark,2009-03-07 00:03:15+00:00,['f4d6fa408ff8a6d52e69fe9a1d26f94822fc4576'],9,28,37,255618,2,0,1,1,899
e3c3d19c7ad23ec7636f1da1a039d4c826b8fe80,0,Bryan Duxbury,2009-03-07 03:08:37+00:00,['3637645c9e2804fdca98c9ac70786c40efec07c2'],2,7,9,255627,1,1,1,1,899
56c48362202ef2f247f06c59e5824f2e979ab0a9,1,Bryan Duxbury,2009-03-11 23:40:57+00:00,['e3c3d19c7ad23ec7636f1da1a039d4c826b8fe80'],3,9,12,255639,1,0,0,1,899
0096b20883acf08c46389c8d232a49d8886074dc,1,Bryan Duxbury,2009-03-13 00:28:06+00:00,['56c48362202ef2f247f06c59e5824f2e979ab0a9'],146,99,245,255884,14,1,1,0,899
42336c19b2a34708feb4bcddd5cde083cabb0d0d,0,Bryan Duxbury,2009-03-13 18:28:40+00:00,['0096b20883acf08c46389c8d232a49d8886074dc'],2,5,7,255891,1,1,1,0,899
d9cdf42ec5edce6572265240276bce013d9b3ebc,0,David Reiss,2009-03-13 21:25:29+00:00,['42336c19b2a34708feb4bcddd5cde083cabb0d0d'],256,86,342,256233,3,,,,900
19d3d0a03a05979ec76a29161921e439b74ab244,0,David Reiss,2009-03-13 21:25:31+00:00,['d9cdf42ec5edce6572265240276bce013d9b3ebc'],2,2,4,256237,1,,,,900
e0a11c44ab44eab3d4662716a70bfc5f9d272b77,0,David Reiss,2009-03-14 07:37:28+00:00,['19d3d0a03a05979ec76a29161921e439b74ab244'],0,0,0,256237,4,,,,900
45d56965c29850ae8d86b7d822ee8f3169ab57f1,0,David Reiss,2009-03-14 23:35:16+00:00,['e0a11c44ab44eab3d4662716a70bfc5f9d272b77'],0,16,16,256253,2,1,1,0,900
65f7e60b7b259c5b8893a243679604d869cc97a2,1,Bryan Duxbury,2009-03-17 21:55:36+00:00,['45d56965c29850ae8d86b7d822ee8f3169ab57f1'],1,1,2,256255,1,,,,900
97592b40b1ae6d00911ab5e76dd951b011c63863,1,Bryan Duxbury,2009-03-18 01:50:50+00:00,['65f7e60b7b259c5b8893a243679604d869cc97a2'],2,2,4,256259,1,,,,900
11727d2445573eab9fa86824ffcde9a3f5441b46,0,Bryan Duxbury,2009-03-18 02:40:54+00:00,['97592b40b1ae6d00911ab5e76dd951b011c63863'],1,3,4,256263,1,1,1,1,900
e8ee12242dbb8fa2d6189288f095b82912897316,0,Bryan Duxbury,2009-03-18 02:47:02+00:00,['11727d2445573eab9fa86824ffcde9a3f5441b46'],61,0,61,256324,1,,,,900
3696d643d0bf233fc2b57e5941cf8d416999a166,1,Bryan Duxbury,2009-03-18 03:14:56+00:00,['e8ee12242dbb8fa2d6189288f095b82912897316'],8,35,43,256367,1,0.363636364,0.363636364,1,900
4980910100f67b1353040529257825af946f8e6b,0,David Reiss,2009-03-18 23:14:13+00:00,['3696d643d0bf233fc2b57e5941cf8d416999a166'],0,19,19,256386,1,,,,900
48141bf5a686453b7a1b5b5b506617669b7cc748,1,David Reiss,2009-03-18 23:59:56+00:00,['4980910100f67b1353040529257825af946f8e6b'],5,44,49,256435,6,,,,900
cbcd63ab4984336ecebae485bd8b3186a0444d39,0,Kevin Clark,2009-03-19 03:50:05+00:00,['48141bf5a686453b7a1b5b5b506617669b7cc748'],4,88,92,256527,2,0.882352941,1,0.882352941,900
00a8dd633c4ebdd2536b70901343d0beb36da0f1,0,David Reiss,2009-03-19 08:14:12+00:00,['cbcd63ab4984336ecebae485bd8b3186a0444d39'],3,1,4,256531,1,,,,900
d815c218c8c48ab7bd930aa0ea8913bc9b2ce872,1,Bryan Duxbury,2009-03-19 18:57:43+00:00,['00a8dd633c4ebdd2536b70901343d0beb36da0f1'],143,1546,1689,258220,21,0.684834123,0.92535545,0.889810427,910
1f804a80c2d677b8d7aa3f60f6146b7246a55edf,1,David Reiss,2009-03-19 20:33:15+00:00,['d815c218c8c48ab7bd930aa0ea8913bc9b2ce872'],1,1,2,258222,1,,,,910
ae0631a844968eefd10aa00863b0c26fc1f54b83,0,Bryan Duxbury,2009-03-20 01:49:53+00:00,['1f804a80c2d677b8d7aa3f60f6146b7246a55edf'],27,81,108,258330,1,1,1,0.888888889,910
afa1b47e60c4ffba554f6187d84fd20cd514f51d,0,Bryan Duxbury,2009-03-20 01:51:16+00:00,['ae0631a844968eefd10aa00863b0c26fc1f54b83'],0,4,4,258334,1,0,0,0,910
13083d6d52d2b5bd3d5a9368a04503c5b21eabab,0,Bryan Duxbury,2009-03-20 02:19:46+00:00,['afa1b47e60c4ffba554f6187d84fd20cd514f51d'],193,0,193,258527,151,,,,910
d40731edb2744d9b1234c6bcea22788b65e81a23,0,Bryan Duxbury,2009-03-20 02:21:05+00:00,['13083d6d52d2b5bd3d5a9368a04503c5b21eabab'],1,1,2,258529,1,,,,910
ab4460dc974586407cb3d9382e6b079c8449a8ca,0,Kevin Clark,2009-03-20 02:28:41+00:00,['d40731edb2744d9b1234c6bcea22788b65e81a23'],282,551,833,259362,31,,,,910
916f353f9f9577d48c764e856bef9b6ba41a7550,0,Kevin Clark,2009-03-20 04:21:39+00:00,['ab4460dc974586407cb3d9382e6b079c8449a8ca'],51,773,824,260186,41,,,,910
ade070ffdf02ff75c9a083dfb51aa6dd47464344,0,David Reiss,2009-03-20 07:02:52+00:00,['916f353f9f9577d48c764e856bef9b6ba41a7550'],8,6,14,260200,1,,,,910
f2422b606702b8f2097c5f138430f64d150adb5d,0,David Reiss,2009-03-20 07:14:50+00:00,['ade070ffdf02ff75c9a083dfb51aa6dd47464344'],0,3,3,260203,1,,,,910
fc30667671cfb9c1adbf03a797952d52d3d6f21a,0,David Reiss,2009-03-20 07:15:04+00:00,['f2422b606702b8f2097c5f138430f64d150adb5d'],11,2,13,260216,1,,,,910
32e04b423d01e3d37ab72685407313da6a4416f6,1,Bryan Duxbury,2009-03-20 16:43:06+00:00,['fc30667671cfb9c1adbf03a797952d52d3d6f21a'],8,31,39,260255,5,,,,910
74c3de61a1e08e8c2491d9c90a3f2e53c307b344,0,Bryan Duxbury,2009-03-20 16:54:33+00:00,['32e04b423d01e3d37ab72685407313da6a4416f6'],1,1,2,260257,1,,,,910
6e26d3d9d21c9da91f9d71b8c72147e947939ac0,0,Bryan Duxbury,2009-03-23 23:36:16+00:00,['74c3de61a1e08e8c2491d9c90a3f2e53c307b344'],0,4,4,260261,1,1,1,1,910
4287c36aabd6abcb99a12d667a6f9604ad89a124,0,Bryan Duxbury,2009-03-24 00:08:45+00:00,['6e26d3d9d21c9da91f9d71b8c72147e947939ac0'],77,0,77,260338,1,,,,910
ff58a9aecde963cb1a4c8214f6516796f694b5cb,0,Bryan Duxbury,2009-03-24 00:28:40+00:00,['4287c36aabd6abcb99a12d667a6f9604ad89a124'],2,3,5,260343,1,0,1,0,910
f3c83cf88e2a1978d68b1e74dbd7d7b04569dfd5,0,Bryan Duxbury,2009-03-24 00:34:16+00:00,['ff58a9aecde963cb1a4c8214f6516796f694b5cb'],7,10,17,260360,3,,,,910
3fb4f1ec92052c2615fe489747509ce74e9f808a,1,Bryan Duxbury,2009-03-24 00:36:00+00:00,['f3c83cf88e2a1978d68b1e74dbd7d7b04569dfd5'],4,23,27,260387,2,,,,910
261441c0afdc467db012ca4506ecca352dca513b,1,Bryan Duxbury,2009-03-24 00:39:27+00:00,['3fb4f1ec92052c2615fe489747509ce74e9f808a'],1,1,2,260389,1,,,,910
2ad9eb7c5ec9db4c9c9ca334e7f04959154db56b,1,Bryan Duxbury,2009-03-24 00:43:33+00:00,['261441c0afdc467db012ca4506ecca352dca513b'],6,5,11,260400,1,1,0,0,910
127d01cb0635dcf9c4650c00ef822b9f6bd7be85,0,Kevin Clark,2009-03-24 01:40:56+00:00,['2ad9eb7c5ec9db4c9c9ca334e7f04959154db56b'],0,2,2,260402,1,0,0,0,910
e8ae5d3728de07e880d6477db0f63ed9a7c65415,0,Bryan Duxbury,2009-03-24 05:23:52+00:00,['127d01cb0635dcf9c4650c00ef822b9f6bd7be85'],1106,18,1124,261526,29,0.209106239,0,0.099494098,910
db3a83a799de34c85fd1330b9833c7ca0af2c359,0,Kevin Clark,2009-03-24 14:47:31+00:00,['e8ae5d3728de07e880d6477db0f63ed9a7c65415'],54,0,54,261580,1,1,1,0,910
38c8b5b92a45d050e235b2231a25ce7c13cd4361,0,Kevin Clark,2009-03-24 14:51:51+00:00,['db3a83a799de34c85fd1330b9833c7ca0af2c359'],17,18,35,261615,1,1,1,1,910
4798a7ad12f3c1a0cea7495bbbbc7d3e253601d8,0,Kevin Clark,2009-03-24 15:56:19+00:00,['38c8b5b92a45d050e235b2231a25ce7c13cd4361'],14,19,33,261648,1,1,1,0,910
9a863ee551ffc75224113a2095ee5f2468f843ca,0,Kevin Clark,2009-03-24 16:04:36+00:00,['4798a7ad12f3c1a0cea7495bbbbc7d3e253601d8'],3,9,12,261660,2,,,,910
6985a4205b4a4aa18e580025134726e34269aecf,0,David Reiss,2009-03-24 20:00:47+00:00,['9a863ee551ffc75224113a2095ee5f2468f843ca'],6,6,12,261672,2,,,,910
473292500dc553e537aad0544f9fbb31d0fbf3d0,1,David Reiss,2009-03-24 20:01:02+00:00,['6985a4205b4a4aa18e580025134726e34269aecf'],91,91,182,261854,13,,,,910
c51986f43897a64531935653cb4a2462f6cd7e11,0,David Reiss,2009-03-24 20:01:25+00:00,['473292500dc553e537aad0544f9fbb31d0fbf3d0'],32,32,64,261918,18,,,,910
6ce401dd555cf7928e1129d9ab31aa7be4bc7e9f,1,David Reiss,2009-03-24 20:01:58+00:00,['c51986f43897a64531935653cb4a2462f6cd7e11'],41,41,82,262000,17,,,,910
fe931d152695950fe1115abcc2bd779a96be239a,0,David Reiss,2009-03-24 20:02:08+00:00,['6ce401dd555cf7928e1129d9ab31aa7be4bc7e9f'],4,4,8,262008,3,,,,910
cecbed81c806e40ca0342d7b8e265d2bf55a2f04,0,David Reiss,2009-03-24 20:02:22+00:00,['fe931d152695950fe1115abcc2bd779a96be239a'],9,13,22,262030,7,,,,910
7c1f6f8e338e9491a2bbe777bfd30d7f1748a727,0,David Reiss,2009-03-24 20:10:24+00:00,['cecbed81c806e40ca0342d7b8e265d2bf55a2f04'],0,4,4,262034,1,1,1,1,910
2f20ae45fbab56b502e67c0ae818e010ab37a562,0,Bryan Duxbury,2009-03-24 21:10:14+00:00,['7c1f6f8e338e9491a2bbe777bfd30d7f1748a727'],1,1,2,262036,1,,,,910
a528f54eeb40608e266fcb968e43b26ba57489c6,1,David Reiss,2009-03-24 22:48:40+00:00,['2f20ae45fbab56b502e67c0ae818e010ab37a562'],2,8,10,262046,3,0,0.2,0.2,910
d73255d1acfd83ca65d3293a0d6a6c8f25c834f4,0,David Reiss,2009-03-24 22:51:02+00:00,['a528f54eeb40608e266fcb968e43b26ba57489c6'],1,1,2,262048,1,,,,910
e3ab50d0f300da7aa3bf018de805fa154afeb53f,1,Bryan Duxbury,2009-03-25 21:06:53+00:00,['d73255d1acfd83ca65d3293a0d6a6c8f25c834f4'],51,90,141,262189,13,1,1,1,912
d1c86825585a33b42309979c6014460e1930bc9d,0,David Reiss,2009-03-25 22:15:18+00:00,['e3ab50d0f300da7aa3bf018de805fa154afeb53f'],2,3,5,262194,1,,,,912
264e9426b9647bb4cc8956128c4e6d687fa831da,0,Kevin Clark,2009-03-26 03:46:58+00:00,['d1c86825585a33b42309979c6014460e1930bc9d'],8,15,23,262217,1,1,1,0.8,912
5ab303c16594ceba1e4e60ffde47653fb9d2cd3e,0,David Reiss,2009-03-26 04:27:47+00:00,['264e9426b9647bb4cc8956128c4e6d687fa831da'],2,2,4,262221,1,,,,912
6b771d2c628c7fd527d6667dd26150ac155cbc8d,0,Bryan Duxbury,2009-03-26 04:55:34+00:00,['5ab303c16594ceba1e4e60ffde47653fb9d2cd3e'],0,14,14,262235,3,,,,912
4438ca57593e9ec82f2a427b57834da1f82845d5,0,David Reiss,2009-03-26 06:14:17+00:00,['6b771d2c628c7fd527d6667dd26150ac155cbc8d'],1,1,2,262237,1,,,,912
be648eee8c120b64d6a2dd1d1faa62dbf0ba72b2,0,David Reiss,2009-03-26 06:14:45+00:00,['4438ca57593e9ec82f2a427b57834da1f82845d5'],1,8,9,262246,1,1,1,1,912
755c8156e816a9c93b635d7a997fb1954aee45c5,1,David Reiss,2009-03-26 06:15:05+00:00,['be648eee8c120b64d6a2dd1d1faa62dbf0ba72b2'],1,132,133,262379,3,0.282608696,0.282608696,1,914
f33c7c670b189fbb58eb9cb868703ca99a107b7c,0,David Reiss,2009-03-26 06:15:26+00:00,['755c8156e816a9c93b635d7a997fb1954aee45c5'],2,2,4,262383,1,,,,914
2aa289072b0ca427b2afc79793310c910596a8b5,1,David Reiss,2009-03-26 06:22:18+00:00,['f33c7c670b189fbb58eb9cb868703ca99a107b7c'],6,32,38,262421,1,0,0,0.176470588,914
abb56a4a0dbeaedf0e71cf206db8e7e16932ab6b,1,David Reiss,2009-03-26 06:23:57+00:00,['2aa289072b0ca427b2afc79793310c910596a8b5'],0,71,71,262492,3,0,0,0,916
39aa00d2e0e978cb7da1caf7c201e26ea33cdb97,0,David Reiss,2009-03-26 08:40:18+00:00,['abb56a4a0dbeaedf0e71cf206db8e7e16932ab6b'],19,23,42,262534,3,,,,916
885c82d75a7c08f0679b11ddf943710828d0251d,0,David Reiss,2009-03-26 08:40:55+00:00,['39aa00d2e0e978cb7da1caf7c201e26ea33cdb97'],1,92,93,262627,1,0.288135593,0.355932203,0.389830508,916
e211393964cc1083ec0cc11d3ccf6f1666bfd521,1,David Reiss,2009-03-26 08:47:07+00:00,['885c82d75a7c08f0679b11ddf943710828d0251d'],2,4,6,262633,1,,,,916
8852720e70e77669fa5ffff494dd641f6fff06f2,0,Bryan Duxbury,2009-03-26 18:41:44+00:00,['e211393964cc1083ec0cc11d3ccf6f1666bfd521'],16,7,23,262656,4,,,,917
4a05434d0b007d412ffc363e2d6e574f25d59315,0,David Reiss,2009-03-26 23:32:27+00:00,['8852720e70e77669fa5ffff494dd641f6fff06f2'],0,3,3,262659,1,,,,917
82e6fc0266e21905358e286074437c7c17cafadc,1,David Reiss,2009-03-26 23:32:36+00:00,['4a05434d0b007d412ffc363e2d6e574f25d59315'],26,105,131,262790,16,0.965517241,1,0.689655172,917
f0377e2ffeb9b260a809f5d2c8ffef73b77755ec,0,Bryan Duxbury,2009-03-30 17:14:06+00:00,['82e6fc0266e21905358e286074437c7c17cafadc'],415,4,419,263209,4,0,0,0.233333333,917
64f87529db1be48cc23eb454683b10d240f81557,0,David Reiss,2009-03-30 19:31:36+00:00,['f0377e2ffeb9b260a809f5d2c8ffef73b77755ec'],1,3,4,263213,1,0,1,1,917
0f2ad6069ab94119fc446d7d42da7921182b8277,0,Bryan Duxbury,2009-03-30 19:52:39+00:00,['64f87529db1be48cc23eb454683b10d240f81557'],14,0,14,263227,1,,,,917
72737e4c967fdf3457d7dc7de42640cd9a5f65c8,0,Bryan Duxbury,2009-03-30 20:11:45+00:00,['0f2ad6069ab94119fc446d7d42da7921182b8277'],1,1,2,263229,1,,,,917
bfc57a04026d9f5b3436baf4452eb262883b7310,1,David Reiss,2009-03-30 20:46:37+00:00,['72737e4c967fdf3457d7dc7de42640cd9a5f65c8'],1,181,182,263411,3,,,,919
233ace53f04abe48b974aa0b51002ecb7134837b,1,David Reiss,2009-03-30 20:46:47+00:00,['bfc57a04026d9f5b3436baf4452eb262883b7310'],10,48,58,263469,3,,,,919
b3c5f6e25f3f39aa32fa65477633b5871e5b534f,1,David Reiss,2009-03-30 20:46:52+00:00,['233ace53f04abe48b974aa0b51002ecb7134837b'],1,17,18,263487,1,,,,919
4c0234f815578f0e313d4509b1de80078fc49923,0,David Reiss,2009-03-30 20:46:56+00:00,['b3c5f6e25f3f39aa32fa65477633b5871e5b534f'],20,33,53,263540,1,,,,919
2d8563ed6eea9b840956a9801804d95650fa95ad,0,David Reiss,2009-03-30 20:47:01+00:00,['4c0234f815578f0e313d4509b1de80078fc49923'],4,9,13,263553,1,,,,919
45c27793cf7d87dd9513af6968891754886d4a98,0,David Reiss,2009-03-30 20:47:05+00:00,['2d8563ed6eea9b840956a9801804d95650fa95ad'],1,1,2,263555,1,,,,919
06a9312baf7ee31d2b3b1cb2bbf34ebbe211e1fa,0,David Reiss,2009-03-30 21:22:52+00:00,['45c27793cf7d87dd9513af6968891754886d4a98'],178,178,356,263911,2,,,,919
3a25cac228c5bf0c9267710db76ab29d80fd31df,0,David Reiss,2009-03-30 21:22:54+00:00,['06a9312baf7ee31d2b3b1cb2bbf34ebbe211e1fa'],2,2,4,263915,1,,,,919
ea0d126f320960bc58b82dd89d86a5f577d059cf,0,Bryan Duxbury,2009-03-30 21:24:34+00:00,['3a25cac228c5bf0c9267710db76ab29d80fd31df'],1,1,2,263917,1,,,,919
4bc4231040186d9e0c35ff4d8211ce7b7e43aab5,0,Bryan Duxbury,2009-03-30 21:25:20+00:00,['ea0d126f320960bc58b82dd89d86a5f577d059cf'],13,14,27,263944,1,,,,919
ea2cba8ba8484a8d4e669c02dd97b3b2445ef322,1,David Reiss,2009-03-30 21:35:00+00:00,['4bc4231040186d9e0c35ff4d8211ce7b7e43aab5'],1479,8673,10152,274096,498,,,,919
566a987dacfda8a85cdc55c5a0577ff6453da9d4,1,David Reiss,2009-03-30 22:24:30+00:00,['ea2cba8ba8484a8d4e669c02dd97b3b2445ef322'],36,33,69,274165,4,0.5,0.5,0.5,919
f82aee5087bd62989482f5c532cbd80f97a39b7f,0,David Reiss,2009-03-30 22:52:29+00:00,['566a987dacfda8a85cdc55c5a0577ff6453da9d4'],0,20,20,274185,4,,,,919
54740b2aed031f83e31ea8758ca475d3956ccda0,0,David Reiss,2009-03-30 22:52:35+00:00,['f82aee5087bd62989482f5c532cbd80f97a39b7f'],16,752,768,274953,4,,,,922
887bd33772249cef3cc42dda9f8622e25a15d830,0,David Reiss,2009-03-30 22:52:39+00:00,['54740b2aed031f83e31ea8758ca475d3956ccda0'],413,0,413,275366,3,0.772908367,0.697211155,0.569721116,922
e48e55447f61ae4041166b47ec3ebfc79e749931,0,David Reiss,2009-03-30 22:52:42+00:00,['887bd33772249cef3cc42dda9f8622e25a15d830'],0,57,57,275423,3,,,,922
feab773ae61139d0fa578bd00a400c4d61509728,0,David Reiss,2009-03-30 22:52:44+00:00,['e48e55447f61ae4041166b47ec3ebfc79e749931'],0,19,19,275442,1,,,,922
eaaf45c0e0ace00808f3c422076d7398f24cb98b,0,David Reiss,2009-03-30 22:52:46+00:00,['feab773ae61139d0fa578bd00a400c4d61509728'],0,56,56,275498,3,,,,922
16f5cd177d59222f6c2d9dd0427583ff892e1499,0,David Reiss,2009-03-30 22:52:51+00:00,['eaaf45c0e0ace00808f3c422076d7398f24cb98b'],0,136,136,275634,8,,,,922
1adbab031d1a452653a37c8bc220bddee334ff8d,0,Bryan Duxbury,2009-03-31 21:09:26+00:00,['16f5cd177d59222f6c2d9dd0427583ff892e1499'],0,5,5,275639,1,1,1,1,922
ac002d32a787ae1245fd27f43ad7de185845e32c,0,Bryan Duxbury,2009-03-31 23:48:36+00:00,['1adbab031d1a452653a37c8bc220bddee334ff8d'],1,7,8,275647,2,1,1,1,922
16b29a989e9af77130b626c011c56f07d197b8b5,0,Bryan Duxbury,2009-03-31 23:51:07+00:00,['ac002d32a787ae1245fd27f43ad7de185845e32c'],159,0,159,275806,3,0,0,0.25,922
5b8b4845488b07007a311a0702107d6d8abe0052,0,Bryan Duxbury,2009-04-01 20:10:15+00:00,['16b29a989e9af77130b626c011c56f07d197b8b5'],32,124,156,275962,10,0.868852459,1,1,922
5bd7192dc3277d348dcf23147a9f0d62520f0918,0,Bryan Duxbury,2009-04-01 21:01:56+00:00,['5b8b4845488b07007a311a0702107d6d8abe0052'],1,1,2,275964,1,,,,922
b5714ef91ec7210c65e07c8d635c224795f22919,1,David Reiss,2009-04-02 00:48:11+00:00,['5bd7192dc3277d348dcf23147a9f0d62520f0918'],3,1,4,275968,3,,,,922
deda141392d0b242e1fce0c0682ceedb45642a18,1,David Reiss,2009-04-02 19:22:31+00:00,['b5714ef91ec7210c65e07c8d635c224795f22919'],4,23,27,275995,13,,,,922
bb4613629b53f91164a0d63d6676edaf70f26cd0,0,David Reiss,2009-04-02 19:23:59+00:00,['deda141392d0b242e1fce0c0682ceedb45642a18'],1,1,2,275997,1,,,,922
689c9ad49843879b957d975e24fbb01404bfff79,0,David Reiss,2009-04-02 19:24:02+00:00,['bb4613629b53f91164a0d63d6676edaf70f26cd0'],13,6,19,276016,4,1,0,0,922
a7d63f5f7013ab90999d715b1f9c311296fa2d19,0,David Reiss,2009-04-02 21:37:12+00:00,['689c9ad49843879b957d975e24fbb01404bfff79'],1,1,2,276018,1,,,,922
e4d4ea0e834ed4d022bb38e53daae4985c04ee04,1,David Reiss,2009-04-02 21:37:17+00:00,['a7d63f5f7013ab90999d715b1f9c311296fa2d19'],43,1588,1631,277649,11,0.650095602,0.76290631,0.755258126,928
7247b8cfd63147287f613f4af56339db89d879b7,0,David Reiss,2009-04-02 23:05:40+00:00,['e4d4ea0e834ed4d022bb38e53daae4985c04ee04'],0,4,4,277653,4,,,,928
356d570f36b06cbffea514070a0c347751dcf3f4,1,David Reiss,2009-04-02 23:49:18+00:00,['7247b8cfd63147287f613f4af56339db89d879b7'],4,4,8,277661,1,,,,928
d0251dd85281c018f7667083436b5d6aa204c814,0,David Reiss,2009-04-02 23:49:20+00:00,['356d570f36b06cbffea514070a0c347751dcf3f4'],0,0,0,277661,2,,,,928
260fa93aaa50e8e6431de682f2d172515a4c8d58,0,David Reiss,2009-04-02 23:51:39+00:00,['d0251dd85281c018f7667083436b5d6aa204c814'],2,2,4,277665,1,,,,928
141eab41474c18dd5509446a71f63b62d4b4035c,0,Bryan Duxbury,2009-04-03 15:05:28+00:00,['260fa93aaa50e8e6431de682f2d172515a4c8d58'],0,1,1,277666,1,,,,928
a145b4d58ad8e91933e6548128d83a18dff3bb9b,0,Bryan Duxbury,2009-04-03 17:29:25+00:00,['141eab41474c18dd5509446a71f63b62d4b4035c'],0,15,15,277681,3,0,0,1,928
cf8c94acb4ca63d92b73fda6351b6a8f315f4895,1,David Reiss,2009-04-03 19:07:19+00:00,['a145b4d58ad8e91933e6548128d83a18dff3bb9b'],2,2,4,277685,1,,,,928
d1d1542e1e307756f7637de0d759d9fc02677a93,1,Bryan Duxbury,2009-04-04 00:58:03+00:00,['cf8c94acb4ca63d92b73fda6351b6a8f315f4895'],762,1001,1763,279448,54,0.5,0,0,942
65043d6fbdbe9bb8a101e440d59567acefd7a70c,0,David Reiss,2009-04-05 06:19:51+00:00,['d1d1542e1e307756f7637de0d759d9fc02677a93'],0,1,1,279449,1,0,0,1,942
07f38ff531c44148a5ca66838d3a22f91fb0f7bc,0,Bryan Duxbury,2009-04-07 04:37:28+00:00,['65043d6fbdbe9bb8a101e440d59567acefd7a70c'],16,3,19,279468,11,,,,942
9b1f5a6f1a1426a33a3c6808d2e9ade273797f7f,1,Bryan Duxbury,2009-04-07 04:40:50+00:00,['07f38ff531c44148a5ca66838d3a22f91fb0f7bc'],17,17,34,279502,1,,,,942
ec47358d23c5fd3ee41d8081f53c25d5f713bcf8,0,Bryan Duxbury,2009-04-07 16:31:04+00:00,['9b1f5a6f1a1426a33a3c6808d2e9ade273797f7f'],0,7,7,279509,2,,,,942
8407cfd4664ddcf607303b60ac4dabc86d136655,0,Bryan Duxbury,2009-04-07 16:35:49+00:00,['ec47358d23c5fd3ee41d8081f53c25d5f713bcf8'],0,3,3,279512,1,0.333333333,1,1,942
19f8d1febe7566bef5927423c9bf5080d6e09763,1,Kevin Clark,2009-04-07 19:09:28+00:00,['8407cfd4664ddcf607303b60ac4dabc86d136655'],12,22,34,279546,7,1,1,1,942
38919c5721d59c0d4478e72f9f6a01130ff6c35c,1,Kevin Clark,2009-04-07 19:12:01+00:00,['19f8d1febe7566bef5927423c9bf5080d6e09763'],0,25,25,279571,1,,,,943
b53471caeafc64bef4de0a2fd59954838ee69a64,0,Kevin Clark,2009-04-07 20:03:09+00:00,['38919c5721d59c0d4478e72f9f6a01130ff6c35c'],2,2,4,279575,2,,,,943
2bcf3995ef7ff3db554c550b2d760d870a64d389,0,David Reiss,2009-04-07 20:51:37+00:00,['b53471caeafc64bef4de0a2fd59954838ee69a64'],8,2,10,279585,1,1,1,1,943
fe5b77d728feec094a086e516d3a185796397072,1,David Reiss,2009-04-07 20:51:48+00:00,['2bcf3995ef7ff3db554c550b2d760d870a64d389'],46,99,145,279730,2,,,,943
0bbef922eed20be3b7e58f0dc5bb6e8f2feae353,0,Bryan Duxbury,2009-04-07 22:23:40+00:00,['fe5b77d728feec094a086e516d3a185796397072'],6,4,10,279740,4,,,,943
ffd4bafc7ff4e1cd4988b516f1f20e9512276007,0,Kevin Clark,2009-04-07 22:47:34+00:00,['0bbef922eed20be3b7e58f0dc5bb6e8f2feae353'],1,1,2,279742,1,,,,943
6a3705c8801f06b2405c9de6a60c260a69936fa7,1,Bryan Duxbury,2009-04-07 23:23:39+00:00,['ffd4bafc7ff4e1cd4988b516f1f20e9512276007'],13,64,77,279819,3,,,,943
c8c088cc524f6a8fd532f885859e7a2127c9f2fd,1,Bryan Duxbury,2009-04-07 23:27:01+00:00,['6a3705c8801f06b2405c9de6a60c260a69936fa7'],0,22,22,279841,3,,,,946
0781f2b549903cad62846aa5ac1ae4a25ab49508,1,Bryan Duxbury,2009-04-07 23:29:42+00:00,['c8c088cc524f6a8fd532f885859e7a2127c9f2fd'],616,655,1271,281112,16,0,1,0,951
c6adf050dfd5fd4b656300cdb49af791a6a19d88,0,David Reiss,2009-04-07 23:38:39+00:00,['0781f2b549903cad62846aa5ac1ae4a25ab49508'],2,5,7,281119,1,,,,951
c42485a62f8d7f6797b0b4bed5367ec0d57f140b,0,David Reiss,2009-04-07 23:44:01+00:00,['c6adf050dfd5fd4b656300cdb49af791a6a19d88'],9,19,28,281147,1,,,,951
9e4c04125e4e4e113ceba64116acfccd7a8f7f04,1,Bryan Duxbury,2009-04-07 23:45:15+00:00,['c42485a62f8d7f6797b0b4bed5367ec0d57f140b'],14,5,19,281166,2,0,0,0,951
def30a60723625ebb5e884fdf259aeeb24346d15,1,Bryan Duxbury,2009-04-08 00:19:37+00:00,['9e4c04125e4e4e113ceba64116acfccd7a8f7f04'],28,470,498,281664,23,,,,953
7d64c0a330975b8785d780656ea7857b23633e5c,0,David Reiss,2009-04-08 20:46:13+00:00,['def30a60723625ebb5e884fdf259aeeb24346d15'],9,9,18,281682,1,,,,953
ebb6cc4cf1345aee0f64e400a3d4c08a93cfe96c,1,David Reiss,2009-04-09 20:02:56+00:00,['7d64c0a330975b8785d780656ea7857b23633e5c'],33,36,69,281751,4,0.5,0.5,0.5,953
5a5608893018529dfa5dba66070b26d7b33e9d7b,1,Bryan Duxbury,2009-04-10 17:20:51+00:00,['ebb6cc4cf1345aee0f64e400a3d4c08a93cfe96c'],43,41,84,281835,7,,,,953
ff219acb6c6ec434d48ceb78ec4b7e03141e27b5,1,Bryan Duxbury,2009-04-10 21:51:00+00:00,['5a5608893018529dfa5dba66070b26d7b33e9d7b'],50,65,115,281950,13,1,1,1,953
256f704d9d2b9c5e8f09c8bfd890af47aedf1d6b,0,Bryan Duxbury,2009-04-13 17:48:23+00:00,['ff219acb6c6ec434d48ceb78ec4b7e03141e27b5'],2,2,4,281954,1,,,,953
4650144f52549345efb3bb2886bd7b1805ea2a66,0,Bryan Duxbury,2009-04-13 18:12:07+00:00,['256f704d9d2b9c5e8f09c8bfd890af47aedf1d6b'],1,1,2,281956,1,,,,953
66bc154aea3f9ce545ae3fc624e449e2a9a5a01b,0,Bryan Duxbury,2009-04-15 17:37:52+00:00,['4650144f52549345efb3bb2886bd7b1805ea2a66'],0,0,0,281956,0,,,,953
aac5bd4b13ba8fbb07c2fa2d2db1bdab6187600c,1,T Jake Luciani,2009-04-20 01:38:42+00:00,['66bc154aea3f9ce545ae3fc624e449e2a9a5a01b'],1,2,3,281959,1,,,,953
fae0e781582c827a12ba3ee5b83afe7a9a291cf3,0,T Jake Luciani,2009-04-21 00:50:11+00:00,['aac5bd4b13ba8fbb07c2fa2d2db1bdab6187600c'],0,1,1,281960,1,0,0,1,953
d90063f29b2ced950b831853a8411faf79cbbf82,0,David Reiss,2009-04-27 19:25:23+00:00,['fae0e781582c827a12ba3ee5b83afe7a9a291cf3'],1,1,2,281962,1,,,,953
1cc8995c1402a78e19fba6e6f33fea9ea9c903f7,1,David Reiss,2009-04-27 19:36:50+00:00,['d90063f29b2ced950b831853a8411faf79cbbf82'],2,3,5,281967,1,0,0,0,953
62a3fba792eaa486b0848452b547b119cf4901aa,0,David Reiss,2009-04-29 04:54:24+00:00,['1cc8995c1402a78e19fba6e6f33fea9ea9c903f7'],0,1,1,281968,1,,,,953
36a5a25a211f7b11c005676bf5c0f359e94677b4,1,David Reiss,2009-04-29 23:20:56+00:00,['62a3fba792eaa486b0848452b547b119cf4901aa'],15,87,102,282070,2,,,,954
4f3192093d819d7933342d9dd2560b00b95c55c0,0,David Reiss,2009-04-29 23:35:01+00:00,['36a5a25a211f7b11c005676bf5c0f359e94677b4'],0,10,10,282080,1,0,0,0,954
0a2dc64c4928ee0e75bcde5128d2da2d791164cb,0,Andrew McGeachie,2009-05-04 21:17:55+00:00,['4f3192093d819d7933342d9dd2560b00b95c55c0'],0,7,7,282087,1,1,1,1,954
657538d4df66fdeef7d67e124e5bfb38c77963a8,1,Kevin Clark,2009-05-04 22:00:47+00:00,['0a2dc64c4928ee0e75bcde5128d2da2d791164cb'],0,6,6,282093,1,,,,955
f93f7a661160caf0536d7c7d54c155d0a1330da4,0,Kevin Clark,2009-05-05 00:43:59+00:00,['657538d4df66fdeef7d67e124e5bfb38c77963a8'],17,26,43,282136,2,,,,955
853bdfea38cf713b0461f6442883547a11d682ec,0,Andrew McGeachie,2009-05-05 00:44:48+00:00,['f93f7a661160caf0536d7c7d54c155d0a1330da4'],1,1,2,282138,1,,,,955
50e030ad77af9390f36e3174ebc507d40bfe5a95,1,Kevin Clark,2009-05-05 00:53:01+00:00,['853bdfea38cf713b0461f6442883547a11d682ec'],1,1,2,282140,1,,,,955
1cc7a1369ee6c6b1bcdcf8f7ef7845e5c4ad1205,1,Bryan Duxbury,2009-05-05 18:50:26+00:00,['50e030ad77af9390f36e3174ebc507d40bfe5a95'],2,2,4,282144,1,,,,955
b7b8af9e61991101f3a944032206f5add7d0649d,0,Bryan Duxbury,2009-05-05 18:59:49+00:00,['1cc7a1369ee6c6b1bcdcf8f7ef7845e5c4ad1205'],2,2,4,282148,2,,,,955
787538943be3c40a55b971c47882e8b19d4b5823,0,Bryan Duxbury,2009-05-06 17:22:11+00:00,['b7b8af9e61991101f3a944032206f5add7d0649d'],1,1,2,282150,1,,,,955
8db8980fa106d585bad706e503f7d9baa89cf7cb,0,David Reiss,2009-05-06 22:00:33+00:00,['787538943be3c40a55b971c47882e8b19d4b5823'],2,2,4,282154,1,,,,955
be378f232b3b4ea5007a6665d3815a63a10ece65,0,David Reiss,2009-05-07 00:41:18+00:00,['8db8980fa106d585bad706e503f7d9baa89cf7cb'],0,2,2,282156,1,,,,955
16514d0a724f9a7ad4a3fe7a854335f949ba25fa,1,David Reiss,2009-05-10 05:14:44+00:00,['be378f232b3b4ea5007a6665d3815a63a10ece65'],4,5,9,282165,1,,,,955
9aa716cf0f5fee6ebf549ef0949b0bbc2bf325dc,0,Bryan Duxbury,2009-05-11 18:09:24+00:00,['16514d0a724f9a7ad4a3fe7a854335f949ba25fa'],1,3,4,282169,1,1,1,1,955
a043be31fc88b5f3777b3311c64e9fffbe9de5b1,1,David Reiss,2009-05-12 02:17:43+00:00,['9aa716cf0f5fee6ebf549ef0949b0bbc2bf325dc'],0,2,2,282171,1,1,1,1,955
c2a9245d2589d235eacefbea5029fb1bea003c21,0,Bryan Duxbury,2009-05-12 16:44:52+00:00,['a043be31fc88b5f3777b3311c64e9fffbe9de5b1'],4,4,8,282179,1,,,,955
af3b6309b5fcb2c650a730ed8d655c9d3205a178,1,Bryan Duxbury,2009-05-12 16:53:23+00:00,['c2a9245d2589d235eacefbea5029fb1bea003c21'],0,6,6,282185,1,0,0,0.5,955
eaa8d7e565a4ee4a1aa9357bebdaec023a540717,1,David Reiss,2009-05-12 23:16:53+00:00,['af3b6309b5fcb2c650a730ed8d655c9d3205a178'],5,28,33,282218,1,,,,955
4ca0c8eaee40c305e11c09005f6f4555be833fe4,0,David Reiss,2009-05-12 23:16:55+00:00,['eaa8d7e565a4ee4a1aa9357bebdaec023a540717'],4,10,14,282232,2,,,,955
32194ab4425c5db1a6406427df0251ebd96186d6,0,Bryan Duxbury,2009-05-20 18:22:19+00:00,['4ca0c8eaee40c305e11c09005f6f4555be833fe4'],3,3,6,282238,1,,,,955
d28ce1035b6880f73a39e993280c7358e114d88f,1,David Reiss,2009-05-21 02:28:14+00:00,['32194ab4425c5db1a6406427df0251ebd96186d6'],1,1,2,282240,1,,,,955
85a8f7b4c22344da3f8e4d259b2cdf591e31d048,0,David Reiss,2009-05-21 02:28:16+00:00,['d28ce1035b6880f73a39e993280c7358e114d88f'],0,10,10,282250,1,,,,955
e4ca1795ead89b5ae79557775163bee6b505ffcc,1,David Reiss,2009-05-21 02:28:19+00:00,['85a8f7b4c22344da3f8e4d259b2cdf591e31d048'],4,18,22,282272,2,1,1,1,955
2ff956c605561d70a3e9a2748ab44b259234eb7f,0,David Reiss,2009-05-21 02:28:23+00:00,['e4ca1795ead89b5ae79557775163bee6b505ffcc'],3,2,5,282277,2,,,,955
5105b2e79d21204d13f2351dc6b973061e66b215,0,David Reiss,2009-05-21 02:28:27+00:00,['2ff956c605561d70a3e9a2748ab44b259234eb7f'],0,5,5,282282,4,,,,955
e5eef13e6f509ad60cd2076d37f9ddfe54df7785,0,David Reiss,2009-05-21 02:28:30+00:00,['5105b2e79d21204d13f2351dc6b973061e66b215'],2,2,4,282286,2,,,,955
08d2f11cbec8147e8fb13c06a1b1a91317a8272d,0,David Reiss,2009-05-21 02:28:36+00:00,['e5eef13e6f509ad60cd2076d37f9ddfe54df7785'],0,2,2,282288,2,,,,955
fdfcebda522c4c84f9c81cebdfb43d878d37a35a,0,David Reiss,2009-05-22 19:50:29+00:00,['08d2f11cbec8147e8fb13c06a1b1a91317a8272d'],1,3,4,282292,1,,,,955
089164a2e9ad58d44c7e841e25f02360fe8bd047,0,David Reiss,2009-05-22 19:50:32+00:00,['fdfcebda522c4c84f9c81cebdfb43d878d37a35a'],0,3,3,282295,1,,,,955
fff84d1466d1848cc19054a56f1d4dc91f6d8326,0,David Reiss,2009-05-22 19:50:33+00:00,['089164a2e9ad58d44c7e841e25f02360fe8bd047'],0,3,3,282298,2,,,,955
dc0a94142699ebf90a4a35a3e1ca64c7b875125f,0,David Reiss,2009-05-22 19:52:02+00:00,['fff84d1466d1848cc19054a56f1d4dc91f6d8326'],1,1,2,282300,2,,,,955
4b86e62eb6bb9230985c53c121e6aa34642162cb,1,David Reiss,2009-05-22 19:52:06+00:00,['dc0a94142699ebf90a4a35a3e1ca64c7b875125f'],6,8,14,282314,6,,,,955
e043a9ec4b91ef5373681e966753d5172d56e79f,1,Bryan Duxbury,2009-05-22 20:17:04+00:00,['4b86e62eb6bb9230985c53c121e6aa34642162cb'],0,4,4,282318,1,1,1,1,955
1deddc799a177ac07acbad90ccd6df655876f85d,0,Bryan Duxbury,2009-05-29 20:11:27+00:00,['e043a9ec4b91ef5373681e966753d5172d56e79f'],7,7,14,282332,6,,,,955
9e347410049ea20bf69f5fcf79d36d89e44f6121,1,Bryan Duxbury,2009-05-29 20:15:02+00:00,['1deddc799a177ac07acbad90ccd6df655876f85d'],5,4,9,282341,1,1,1,0,955
2fb877a794ce3df3eb488926f991e210f419ebf6,0,Bryan Duxbury,2009-05-29 20:18:58+00:00,['9e347410049ea20bf69f5fcf79d36d89e44f6121'],2,6,8,282349,1,1,1,1,955
840e75205bf4c7da635bd40dd10867073ca1d51e,1,David Reiss,2009-06-04 00:10:50+00:00,['2fb877a794ce3df3eb488926f991e210f419ebf6'],8,10,18,282367,1,0,0,1,955
5fa20da4a5a21a90cdf4ee7000c56d254d77f066,0,David Reiss,2009-06-04 00:32:47+00:00,['840e75205bf4c7da635bd40dd10867073ca1d51e'],3,1,4,282371,1,1,1,0,955
8584b6ffe799c19e0b843be4ded394934112c01b,0,David Reiss,2009-06-04 00:32:50+00:00,['5fa20da4a5a21a90cdf4ee7000c56d254d77f066'],4,0,4,282375,1,1,1,0,955
9fcacc8ff6e856bd55929763b5026181413806f1,1,David Reiss,2009-06-04 00:32:54+00:00,['8584b6ffe799c19e0b843be4ded394934112c01b'],0,13,13,282388,1,0,0,1,955
52687eb3b9aa8982cab5e11fae2ae879c6bc1b69,1,David Reiss,2009-06-04 00:32:57+00:00,['9fcacc8ff6e856bd55929763b5026181413806f1'],2,20,22,282410,2,0,1,1,955
5e530af5878ce7650e94ee662951b49358100984,0,David Reiss,2009-06-04 02:01:24+00:00,['52687eb3b9aa8982cab5e11fae2ae879c6bc1b69'],15,153,168,282578,3,,,,956
bb97fd90a501ce7a7b37170295c4d02c719a2150,0,David Reiss,2009-06-04 02:01:28+00:00,['5e530af5878ce7650e94ee662951b49358100984'],13,33,46,282624,2,,,,956
1e1a6976723b37c44b1eff5cc3f4df1a52b95e0b,0,David Reiss,2009-06-04 02:01:32+00:00,['bb97fd90a501ce7a7b37170295c4d02c719a2150'],7,53,60,282684,2,,,,956
fad60657a3b64894b56b56f7c23b2dcfa8cf4647,0,David Reiss,2009-06-04 02:01:35+00:00,['1e1a6976723b37c44b1eff5cc3f4df1a52b95e0b'],15,33,48,282732,1,,,,956
56c2c21f4ef2c0d2052b956a000ed3a6321ea394,0,David Reiss,2009-06-04 02:05:25+00:00,['fad60657a3b64894b56b56f7c23b2dcfa8cf4647'],3,3,6,282738,1,,,,956
ef73b0e67ad4f5238417a60ec41176c1a6095b8d,1,Bryan Duxbury,2009-06-17 16:43:25+00:00,['56c2c21f4ef2c0d2052b956a000ed3a6321ea394'],2,17,19,282757,2,0,0.076923077,1,956
3d6babc05c011896d1be0adac980853280020376,1,David Reiss,2009-06-18 23:30:03+00:00,['ef73b0e67ad4f5238417a60ec41176c1a6095b8d'],1,1,2,282759,1,,,,956
6fcaf84287d746c59f3ba126521fce3138bace12,1,Bryan Duxbury,2009-06-24 17:55:53+00:00,['3d6babc05c011896d1be0adac980853280020376'],1,24,25,282784,2,0.3125,0,1,956
281d9dacb6d6ff20630e0fabb98384d91ea55d17,1,Bryan Duxbury,2009-07-02 20:15:05+00:00,['6fcaf84287d746c59f3ba126521fce3138bace12'],1,1,2,282786,1,,,,956
f45977fef80d5fb2dc6ab6e8320ef4c72da33afb,0,Bryan Duxbury,2009-07-02 20:18:12+00:00,['281d9dacb6d6ff20630e0fabb98384d91ea55d17'],28,0,28,282814,4,,,,956
e8f38f47c8bfdb8738e016222c45a1cb08335299,0,Bryan Duxbury,2009-07-02 20:28:33+00:00,['f45977fef80d5fb2dc6ab6e8320ef4c72da33afb'],8,8,16,282830,1,,,,956
70c89d4ae002b324c891be30f625365d09420c27,1,David Reiss,2009-07-13 17:21:03+00:00,['e8f38f47c8bfdb8738e016222c45a1cb08335299'],0,2,2,282832,1,,,,956
8f5827358be83cc9dd8ddef04dc79ef2c2ac2775,1,Bryan Duxbury,2009-07-14 01:42:09+00:00,['70c89d4ae002b324c891be30f625365d09420c27'],1,1,2,282834,1,,,,956
f1fd2954b5e3646fe98f0faa06a0ab9f2c61e98c,1,T Jake Luciani,2009-07-17 01:34:50+00:00,['8f5827358be83cc9dd8ddef04dc79ef2c2ac2775'],5,5,10,282844,3,,,,956
fdcb710cc48cd3a28df89c6cb3d2fe55ad529275,0,T Jake Luciani,2009-07-17 01:37:01+00:00,['f1fd2954b5e3646fe98f0faa06a0ab9f2c61e98c'],0,104,104,282948,1,,,,957
c5a7c151e109869f4c7f70d2a4b745d3fed91b77,1,Esteve Fernandez,2009-07-17 18:18:19+00:00,['fdcb710cc48cd3a28df89c6cb3d2fe55ad529275'],0,4,4,282952,1,,,,957
d3571c2acef1663e15a925b871b42f1bd2555378,0,Esteve Fernandez,2009-07-17 18:35:52+00:00,['c5a7c151e109869f4c7f70d2a4b745d3fed91b77'],2,2,4,282956,1,,,,957
330cfc13bc587487fac0c51f65438152cb1f7361,1,Andrew McGeachie,2009-07-21 14:33:17+00:00,['d3571c2acef1663e15a925b871b42f1bd2555378'],8,28,36,282992,1,0,1,0,957
6db89f29782b8487e7cae1ea77c9300aedb5c86b,0,Andrew McGeachie,2009-07-21 14:45:12+00:00,['330cfc13bc587487fac0c51f65438152cb1f7361'],12,12,24,283016,12,,,,957
645d7b8d5026f18a61f38213a02a27cbfc9286ab,0,Andrew McGeachie,2009-07-21 15:30:16+00:00,['6db89f29782b8487e7cae1ea77c9300aedb5c86b'],7,19,26,283042,1,0.428571429,0,0.571428571,957
59ace01f3f15e2babc952cafa86310abdd29b114,1,Andrew McGeachie,2009-07-21 15:34:07+00:00,['645d7b8d5026f18a61f38213a02a27cbfc9286ab'],9,11,20,283062,1,1,1,1,957
7564925daa68bbc0ae6d986aabe63c8130379884,0,Andrew McGeachie,2009-07-21 16:12:33+00:00,['59ace01f3f15e2babc952cafa86310abdd29b114'],2,2,4,283066,1,,,,957
f2e03ba2e36335069e73b6cecf5b7218771c4a4a,1,Andrew McGeachie,2009-07-21 16:51:49+00:00,['7564925daa68bbc0ae6d986aabe63c8130379884'],4,52,56,283122,1,0.5,0.5,0.5,957
38e1a10c0d9cffee5aa014a2043791d0388cf804,0,Andrew McGeachie,2009-07-21 17:22:03+00:00,['f2e03ba2e36335069e73b6cecf5b7218771c4a4a'],1,1,2,283124,1,,,,957
6efefc023aeb48db6b6ac875bd35b2e895d8311a,0,Andrew McGeachie,2009-07-21 20:14:31+00:00,['38e1a10c0d9cffee5aa014a2043791d0388cf804'],4,13,17,283141,1,0.5,1,0,957
0c8957114abc809b5db6a4b945a85d8e500a0c27,1,Andrew McGeachie,2009-07-21 21:14:19+00:00,['6efefc023aeb48db6b6ac875bd35b2e895d8311a'],38,380,418,283559,8,0.153439153,0.386243386,1,960
061722b4fd8a6aed2e8dbc98f0bbbffc9e71e72c,1,Andrew McGeachie,2009-07-23 18:12:18+00:00,['0c8957114abc809b5db6a4b945a85d8e500a0c27'],4,12,16,283575,1,1,1,1,960
bbd55ad8da7141ec5339944b6f497555ba2a4f6b,0,Andrew McGeachie,2009-07-24 15:58:07+00:00,['061722b4fd8a6aed2e8dbc98f0bbbffc9e71e72c'],15,26,41,283616,1,0,1,1,960
c8e300533cc9d12ecb2325ec89b581647cb7707e,0,David Reiss,2009-07-27 17:02:42+00:00,['bbd55ad8da7141ec5339944b6f497555ba2a4f6b'],1,17,18,283634,2,,,,960
e657eb43117437b8a2b2036982ec3d4cd953b437,0,David Reiss,2009-07-29 19:07:27+00:00,['c8e300533cc9d12ecb2325ec89b581647cb7707e'],2,22,24,283658,1,,,,960
ad557420b980c0c5a82ffce13e82cb4b0edde051,0,David Reiss,2009-07-29 19:07:33+00:00,['e657eb43117437b8a2b2036982ec3d4cd953b437'],0,1,1,283659,1,,,,960
52297d5e2c306ff33daf312cb81cb02f19601ed1,0,Bryan Duxbury,2009-07-29 19:46:00+00:00,['ad557420b980c0c5a82ffce13e82cb4b0edde051'],70,0,70,283729,1,1,1,0,960
3d5db203d5a1a43c39dd51aa8a6e7dc283d1fad8,1,Bryan Duxbury,2009-07-29 23:44:44+00:00,['52297d5e2c306ff33daf312cb81cb02f19601ed1'],5,27,32,283761,2,0.923076923,0.923076923,1,960
ba71f8c7fcd0ae0a0177ee0e308a8a92abe64106,1,Bryan Duxbury,2009-07-29 23:47:38+00:00,['3d5db203d5a1a43c39dd51aa8a6e7dc283d1fad8'],1,2,3,283764,1,0,0,1,960
05528138256fa6a5b92bf3a04aa01f33d2dc700d,0,Bryan Duxbury,2009-07-30 15:52:25+00:00,['ba71f8c7fcd0ae0a0177ee0e308a8a92abe64106'],0,1,1,283765,1,,,,960
684b4f9aeeef501ff45790b4ff8fb574211a7797,1,Bryan Duxbury,2009-07-31 00:12:21+00:00,['05528138256fa6a5b92bf3a04aa01f33d2dc700d'],1,74,75,283840,1,0.403508772,0.877192982,0.877192982,960
4184e2be546d19ece83c8132a03f08a5de6656a6,0,T Jake Luciani,2009-07-31 01:31:00+00:00,['684b4f9aeeef501ff45790b4ff8fb574211a7797'],70,87,157,283997,2,1,1,0,960
ccae88473962261d28d1ef56dd05637ca1445df6,0,Bryan Duxbury,2009-07-31 18:47:09+00:00,['4184e2be546d19ece83c8132a03f08a5de6656a6'],45,46,91,284088,1,0.125,0,0,960
293086cacc60f24d45359ed93c5ec224562b4ddd,1,Bryan Duxbury,2009-07-31 18:53:14+00:00,['ccae88473962261d28d1ef56dd05637ca1445df6'],21,35,56,284144,4,0.727272727,1,1,960
82e96f5d96833d0af5495405444bace82b2214d7,1,Bryan Duxbury,2009-07-31 19:32:34+00:00,['293086cacc60f24d45359ed93c5ec224562b4ddd'],0,102,102,284246,1,0.779069767,1,1,961
3efce2336983ae9cb91e70d73827fa377ca3a3a7,1,Bryan Duxbury,2009-08-03 19:37:26+00:00,['82e96f5d96833d0af5495405444bace82b2214d7'],39,61,100,284346,1,1,1,1,961
3029786ce1dda4bb625e72ebb5202c0b89e233a2,0,David Reiss,2009-08-05 16:42:59+00:00,['3efce2336983ae9cb91e70d73827fa377ca3a3a7'],2,2,4,284350,1,,,,961
f5a0b3dfc8b0d6f7d85de4f9b18f14d6584d3d3a,0,Mark Slee,2009-08-13 19:21:40+00:00,['3029786ce1dda4bb625e72ebb5202c0b89e233a2'],0,1,1,284351,1,,,,961
c27cda57a0347d3b7496a8ccbaf8071ead1f898e,0,Bryan Duxbury,2009-08-14 20:04:15+00:00,['f5a0b3dfc8b0d6f7d85de4f9b18f14d6584d3d3a'],19,30,49,284400,9,0,1,1,961
2f45e789f6f87d95cd17be91900476f6a50bb1c1,0,Bryan Duxbury,2009-08-20 00:55:12+00:00,['c27cda57a0347d3b7496a8ccbaf8071ead1f898e'],0,5,5,284405,1,,,,961
2c8cd944e50d4d69f00fde70ecee9c75ab924e2b,1,Bryan Duxbury,2009-08-20 01:00:18+00:00,['2f45e789f6f87d95cd17be91900476f6a50bb1c1'],253,47,300,284705,7,0.988095238,0.630952381,0,961
af81de0123c8d9920a25a27d28da66f9d00748cc,1,David Reiss,2009-08-27 20:27:09+00:00,['2c8cd944e50d4d69f00fde70ecee9c75ab924e2b'],19,5,24,284729,3,0,0,0,961
ffff2b35763e47667c63df903fe6e59b5ada4d22,1,David Reiss,2009-09-01 18:03:07+00:00,['af81de0123c8d9920a25a27d28da66f9d00748cc'],2,1,3,284732,1,,,,961
db5d5894577c14accc2c81b617fa36dc6924591e,0,David Reiss,2009-09-01 21:36:46+00:00,['ffff2b35763e47667c63df903fe6e59b5ada4d22'],11,10,21,284753,1,0,0,0,961
fd58c55dca197daea0df23a339a1d106dea8189b,0,Bryan Duxbury,2009-09-01 22:32:50+00:00,['db5d5894577c14accc2c81b617fa36dc6924591e'],2,2,4,284757,1,,,,961
ab3666e6caad79315fddf0f8f38c13c7a10cc23a,1,Bryan Duxbury,2009-09-01 23:03:47+00:00,['fd58c55dca197daea0df23a339a1d106dea8189b'],40,796,836,285593,10,0.362886598,0.915463918,1,963
6f6318a652fc3401f92ea44869c6d80a13afa13d,0,Bryan Duxbury,2009-09-01 23:18:34+00:00,['ab3666e6caad79315fddf0f8f38c13c7a10cc23a'],1,1,2,285595,1,,,,963
3647fc62f531f886d92042157b906f455097aa89,0,Bryan Duxbury,2009-09-02 20:05:07+00:00,['6f6318a652fc3401f92ea44869c6d80a13afa13d'],0,3,3,285598,1,1,1,1,963
45603e9c6c6196301655b2328007382f46ef627d,0,David Reiss,2009-09-02 22:15:55+00:00,['3647fc62f531f886d92042157b906f455097aa89'],8,1,9,285607,1,,,,963
b42361c2e91efc63c11b21721643388db820b86d,0,David Reiss,2009-09-09 17:18:57+00:00,['45603e9c6c6196301655b2328007382f46ef627d'],7,14,21,285628,1,,,,963
a0bf2c1e08a1292c35243274c00f7c117a76595a,0,David Reiss,2009-09-16 16:50:00+00:00,['b42361c2e91efc63c11b21721643388db820b86d'],0,2,2,285630,1,0,0,1,963
bb97bef0a11e7ace7d76f2af670c4b2d6fb99efe,0,David Reiss,2009-09-16 16:57:05+00:00,['a0bf2c1e08a1292c35243274c00f7c117a76595a'],6,8,14,285644,1,0,1,1,963
0e8e6099e215f3a6adcb6e5c75e9dc8ad53a7a21,0,Esteve Fernandez,2009-09-17 19:19:11+00:00,['bb97bef0a11e7ace7d76f2af670c4b2d6fb99efe'],1,5,6,285650,1,0,1,0,963
3e7fca421efe0c76bc493a4058d3667c540bcca4,0,David Reiss,2009-09-19 01:59:13+00:00,['0e8e6099e215f3a6adcb6e5c75e9dc8ad53a7a21'],0,3,3,285653,1,0,0,1,963
db40d26f4a61c1c2ae04997a6cc475bfd585d3e4,1,Bryan Duxbury,2009-09-21 16:52:48+00:00,['3e7fca421efe0c76bc493a4058d3667c540bcca4'],1,1,2,285655,1,,,,963
bff2a35adf75e5da3483facab647601a73a1f9ee,0,Esteve Fernandez,2009-09-24 10:22:00+00:00,['db40d26f4a61c1c2ae04997a6cc475bfd585d3e4'],6,6,12,285667,2,,,,963
315a5dbe29213aa70750f4e93542e1d72f3b0bb9,0,Bryan Duxbury,2009-09-25 20:28:35+00:00,['bff2a35adf75e5da3483facab647601a73a1f9ee'],1,6,7,285674,2,0,0,1,963
51f288062dceebbb16886752ddeb0a24a8d04956,1,Bryan Duxbury,2009-10-01 20:53:45+00:00,['315a5dbe29213aa70750f4e93542e1d72f3b0bb9'],0,147,147,285821,4,0.425531915,0.425531915,0.29787234,964
f18202fbd06f2435c47a42ae8d7d75fd42645753,0,Bryan Duxbury,2009-10-01 22:52:25+00:00,['51f288062dceebbb16886752ddeb0a24a8d04956'],0,70,70,285891,1,0,0,1,964
364902eb56493c513eab6eb5ba4dc680af7c1f1b,0,Bryan Duxbury,2009-10-02 00:56:53+00:00,['f18202fbd06f2435c47a42ae8d7d75fd42645753'],11,20,31,285922,1,0,0,0,964
834895d15c8e6761b1dd28401966c39d32954936,0,Bryan Duxbury,2009-10-15 01:20:34+00:00,['364902eb56493c513eab6eb5ba4dc680af7c1f1b'],0,3,3,285925,1,0,1,1,964
72fd472476a68dc55ca8cbfb05452d6c69fb0d19,0,Bryan Duxbury,2009-10-15 01:24:26+00:00,['834895d15c8e6761b1dd28401966c39d32954936'],0,39,39,285964,2,0.56,0.6,0.96,964
9b90344445d0a753e8a4a8a926c67d6a6c051c5e,0,David Reiss,2009-10-21 05:51:28+00:00,['72fd472476a68dc55ca8cbfb05452d6c69fb0d19'],1,13,14,285978,4,,,,964
8266e012c5b473b136421c124d42f82b07892351,1,David Reiss,2009-10-21 06:09:16+00:00,['9b90344445d0a753e8a4a8a926c67d6a6c051c5e'],0,16,16,285994,1,0,1,1,964
72751724b5c1ff0397b8a35875cf3cb19f81ef64,1,Andrew McGeachie,2009-10-27 20:23:02+00:00,['8266e012c5b473b136421c124d42f82b07892351'],7,7,14,286008,1,,,,964
73380097e1afa0e8ea94eb40f6c17c8065f022ba,1,Andrew McGeachie,2009-10-27 20:27:49+00:00,['72751724b5c1ff0397b8a35875cf3cb19f81ef64'],1,2,3,286011,1,0,1,1,964
034c49f0fcf95f13982de528f19760f5ed01617e,0,David Reiss,2009-10-28 17:07:14+00:00,['73380097e1afa0e8ea94eb40f6c17c8065f022ba'],1,1,2,286013,1,,,,964
3533dcbef88d1c4bae8e610f289c3297aea26a67,0,Andrew McGeachie,2009-11-03 18:52:15+00:00,['034c49f0fcf95f13982de528f19760f5ed01617e'],0,148,148,286161,1,0,0,0,964
6731b57b582badaa3fca91e6ac54bf18cd2cf0f7,0,Bryan Duxbury,2009-11-04 00:30:10+00:00,['3533dcbef88d1c4bae8e610f289c3297aea26a67'],3,3,6,286167,1,,,,964
2845b16eb24fc66d34f66c776400354225e70bad,1,Bryan Duxbury,2009-11-09 15:55:22+00:00,['6731b57b582badaa3fca91e6ac54bf18cd2cf0f7'],8,14,22,286189,3,,,,964
7948a66cfc6d164cb27da71360a270838a7468c2,1,Esteve Fernandez,2009-11-11 18:32:25+00:00,['2845b16eb24fc66d34f66c776400354225e70bad'],1,117,118,286307,3,1,1,0.716666667,965
e2e4ea1dcf09bdbf5bc2f270812ae2a3ca69c02b,1,Bryan Duxbury,2009-11-11 21:01:35+00:00,['7948a66cfc6d164cb27da71360a270838a7468c2'],4,48,52,286359,4,0.033333333,0.2,1,965
93f8219567ab09f9dc35095ee3a8692f7a1992ad,0,T Jake Luciani,2009-11-12 02:36:30+00:00,['e2e4ea1dcf09bdbf5bc2f270812ae2a3ca69c02b'],2,2,4,286363,1,,,,965
f2b8f750b3adf3db50fa38af5462e758a38cdc65,0,T Jake Luciani,2009-11-12 02:44:42+00:00,['93f8219567ab09f9dc35095ee3a8692f7a1992ad'],2,2,4,286367,1,,,,965
0c5c234b58802c36013b0d69b237ec3f098ebfd5,1,T Jake Luciani,2009-11-12 03:01:33+00:00,['f2b8f750b3adf3db50fa38af5462e758a38cdc65'],4,576,580,286947,6,,,,967
aa9fb5dc9de5f3cfbe086e6df8e7c6d3640c272c,1,Bryan Duxbury,2009-11-12 20:52:25+00:00,['0c5c234b58802c36013b0d69b237ec3f098ebfd5'],192,289,481,287428,10,0,1,0.98245614,968
559a49f03c072ebb0c5b2ce6e667a4e09555e95d,0,David Reiss,2009-11-13 04:52:10+00:00,['aa9fb5dc9de5f3cfbe086e6df8e7c6d3640c272c'],76,76,152,287580,1,,,,968
e476480691d114ad1f1a9794bd10b34df6554ad2,1,Bryan Duxbury,2009-11-17 21:56:43+00:00,['559a49f03c072ebb0c5b2ce6e667a4e09555e95d'],1,1,2,287582,1,,,,968
9af23d9327277a791c8b22c4323b8e17e2bfc378,1,Bryan Duxbury,2009-11-19 17:26:38+00:00,['e476480691d114ad1f1a9794bd10b34df6554ad2'],102,166,268,287850,10,0.833333333,1,1,970
f5dea4c7f31703cdc0c347eb7ec429fc5864afb4,1,Todd Lipcon,2009-12-03 01:18:44+00:00,['9af23d9327277a791c8b22c4323b8e17e2bfc378'],1,6,7,287857,2,1,1,0.75,970
53ae9f39d5118d9b13774413e7989b9f0fb1a8eb,1,Todd Lipcon,2009-12-07 00:42:38+00:00,['f5dea4c7f31703cdc0c347eb7ec429fc5864afb4'],22,405,427,288284,47,,,,971
ada549f7765b80b4dddc527480cde96a4a080858,0,Todd Lipcon,2009-12-07 05:22:16+00:00,['53ae9f39d5118d9b13774413e7989b9f0fb1a8eb'],0,0,0,288284,0,,,,971
72a1a88c4a2a9cbf5bae49e5784454d95c58a3b0,0,Todd Lipcon,2009-12-08 03:40:31+00:00,['ada549f7765b80b4dddc527480cde96a4a080858'],1,410,411,288695,2,,,,971
7834ccbdacf5b7aac80fa8dc943553b5f72c610a,0,David Reiss,2009-12-09 19:29:48+00:00,['53ae9f39d5118d9b13774413e7989b9f0fb1a8eb'],8,8,16,288711,2,,,,971
eb03222bca7d89654702569cad0c348b5dd44317,0,David Reiss,2009-12-09 19:29:59+00:00,['7834ccbdacf5b7aac80fa8dc943553b5f72c610a'],2,2,4,288715,1,,,,971
2727fab22f11a9d9c30b2c47d9d010adf97c15d6,0,David Reiss,2009-12-09 19:30:01+00:00,['eb03222bca7d89654702569cad0c348b5dd44317'],66,21,87,288802,4,,,,971
e533bace3d462ebad7c65d7de4fd167a0ffbe740,0,Bryan Duxbury,2009-12-18 19:34:25+00:00,['2727fab22f11a9d9c30b2c47d9d010adf97c15d6'],10,0,10,288812,1,1,1,0,971
2d80470bcb1a7e41ef0668194ab97bb65342baac,1,Bryan Duxbury,2009-12-18 19:41:11+00:00,['e533bace3d462ebad7c65d7de4fd167a0ffbe740'],21,216,237,289049,10,0.411764706,0.424836601,0.908496732,971
d250314e66b5a90b4aa5060ee1e326b5818cbb46,1,Bryan Duxbury,2009-12-28 18:49:03+00:00,['2d80470bcb1a7e41ef0668194ab97bb65342baac'],1,1,2,289051,1,,,,971
986d50fc718f06b234cf59effd9d374678801557,1,Bryan Duxbury,2009-12-31 18:18:00+00:00,['d250314e66b5a90b4aa5060ee1e326b5818cbb46'],2,12,14,289065,2,,,,971
c2ec7cae04b1a18a0fbb2dc3802fb3d18f0c080c,0,Bryan Duxbury,2009-12-31 18:59:15+00:00,['986d50fc718f06b234cf59effd9d374678801557'],6,41,47,289112,3,0.590909091,1,1,971
3076fb8d791a07d6f4933bcfb7875ef0d27cb70e,0,Bryan Duxbury,2010-01-06 23:10:24+00:00,['c2ec7cae04b1a18a0fbb2dc3802fb3d18f0c080c'],1,1,2,289114,1,,,,971
35565a4719679523779d946420992bde33a4987c,1,Bryan Duxbury,2010-01-06 23:12:09+00:00,['3076fb8d791a07d6f4933bcfb7875ef0d27cb70e'],3,32,35,289149,4,0.875,1,1,971
752529e9b449f69d2fce19eba1c12471858279b9,1,David Reiss,2010-01-11 19:12:56+00:00,['35565a4719679523779d946420992bde33a4987c'],25,53,78,289227,5,0.8,1,1,971
9d435ab1913de3a597c0e2596d2cf8a71180ee20,1,David Reiss,2010-01-11 19:13:14+00:00,['752529e9b449f69d2fce19eba1c12471858279b9'],0,124,124,289351,1,,,,972
68f8c389bd00ef179b6b0bd03a7aadcbe2cfd05a,1,David Reiss,2010-01-11 19:13:18+00:00,['9d435ab1913de3a597c0e2596d2cf8a71180ee20'],0,206,206,289557,3,,,,975
55b38bc3af3bca57d3def1e7863bb0f327a72dbc,1,Bryan Duxbury,2010-01-15 17:20:04+00:00,['68f8c389bd00ef179b6b0bd03a7aadcbe2cfd05a'],10,5,15,289572,1,1,1,0,975
9bfacd36800f052e33ffa78a06bc9a4f600e5f3d,1,Bryan Duxbury,2010-01-15 17:27:52+00:00,['55b38bc3af3bca57d3def1e7863bb0f327a72dbc'],1,3,4,289576,1,0,1,1,975
62fb2ed1fea45f3193a0b295e5ef7f910a70cd6a,0,Bryan Duxbury,2010-01-15 17:29:26+00:00,['9bfacd36800f052e33ffa78a06bc9a4f600e5f3d'],2,5,7,289583,1,1,1,0,975
8d41b643f9bb670f18404260fbe124c0cabb5360,0,Bryan Duxbury,2010-01-15 17:30:40+00:00,['62fb2ed1fea45f3193a0b295e5ef7f910a70cd6a'],2,1,3,289586,1,0,0,0,975
db57aa0df9f83ff035bedb7e0afc447d0214acc0,0,Bryan Duxbury,2010-01-15 17:40:31+00:00,['8d41b643f9bb670f18404260fbe124c0cabb5360'],171,0,171,289757,1,0.264367816,0,0,975
c4ad9be578f22e240b28af2ca89f83ac18179cd1,1,Bryan Duxbury,2010-01-16 09:13:20+00:00,['db57aa0df9f83ff035bedb7e0afc447d0214acc0'],11,29,40,289797,1,0,0,1,975
b6f4e56bb0c67d6f10391d9a6dff845e72c4100f,0,Todd Lipcon,2010-01-19 05:18:55+00:00,['c4ad9be578f22e240b28af2ca89f83ac18179cd1'],34,46,80,289877,3,0,1,1,975
c771944644247f5ae31c37ffe937fe93c147b327,0,Bryan Duxbury,2010-01-21 03:20:01+00:00,['b6f4e56bb0c67d6f10391d9a6dff845e72c4100f'],2,10,12,289889,1,1,1,1,975
3bb5e0581a076e5c754470f4d44979ad0cff8bc1,1,David Reiss,2010-01-25 19:31:31+00:00,['c771944644247f5ae31c37ffe937fe93c147b327'],8,8,16,289905,6,,,,975
ba4bf4d512439b8eb1fb42584793dec40682a7f9,0,David Reiss,2010-01-26 20:06:36+00:00,['3bb5e0581a076e5c754470f4d44979ad0cff8bc1'],1,1,2,289907,1,,,,975
7acb526434d06f49998e7fe218c7ee384b005621,1,Andrew McGeachie,2010-02-10 00:56:09+00:00,['ba4bf4d512439b8eb1fb42584793dec40682a7f9'],0,87,87,289994,2,1,1,1,977
ddfe0c96982c50901504921291a1b973c1304941,1,Andrew McGeachie,2010-02-10 01:03:01+00:00,['7acb526434d06f49998e7fe218c7ee384b005621'],0,7,7,290001,1,0,1,1,977
526112103cff44ec923d77aed0838b93a41f6b04,0,Bryan Duxbury,2010-02-10 23:23:35+00:00,['ddfe0c96982c50901504921291a1b973c1304941'],1,1,2,290003,1,,,,977
f94f008d80bf858e4ad635fda61f8cd2bd1be0a2,1,Bryan Duxbury,2010-02-12 22:49:40+00:00,['526112103cff44ec923d77aed0838b93a41f6b04'],7,17,24,290027,2,0.666666667,0.666666667,1,977
322caa2f9289e8174069dbac1f8d7949e1130af6,1,T Jake Luciani,2010-02-15 03:24:55+00:00,['f94f008d80bf858e4ad635fda61f8cd2bd1be0a2'],0,2770,2770,292797,10,0.365461847,0.511378849,0.65729585,984
33e190cd150c326ac833c435f975c2e737cff74f,1,Bryan Duxbury,2010-02-16 21:19:01+00:00,['322caa2f9289e8174069dbac1f8d7949e1130af6'],182,713,895,293692,14,0.594155844,0.974025974,0.899350649,987
cd43a06405c806d7ff928262da29703cde7e764f,1,Bryan Duxbury,2010-02-17 20:01:29+00:00,['33e190cd150c326ac833c435f975c2e737cff74f'],1,17,18,293710,2,0,0.923076923,1,987
5af64f03464b927bdc329065b24a063c02fe8412,0,Bryan Duxbury,2010-02-17 22:27:27+00:00,['cd43a06405c806d7ff928262da29703cde7e764f'],0,14,14,293724,2,0,0,1,987
361ef347225707e2066b7b7397a5f9dddb5c8694,0,Bryan Duxbury,2010-02-17 22:29:49+00:00,['5af64f03464b927bdc329065b24a063c02fe8412'],1,1,2,293726,1,,,,987
25b851af36d9260a18ffbf1494e572b54ce6d426,0,Bryan Duxbury,2010-02-17 23:10:48+00:00,['361ef347225707e2066b7b7397a5f9dddb5c8694'],0,3,3,293729,1,,,,987
3d03c527dfec72d10f885b3060ffdc35faa2cfb7,1,Bryan Duxbury,2010-02-18 17:42:06+00:00,['25b851af36d9260a18ffbf1494e572b54ce6d426'],20,74,94,293823,7,0.416666667,0.416666667,1,987
becaf536211a699f1fb936752262fdb7bcd36126,1,Bryan Duxbury,2010-02-18 18:27:51+00:00,['3d03c527dfec72d10f885b3060ffdc35faa2cfb7'],35,165,200,294023,7,0.794871795,1,0.871794872,988
0e4920c6b892ef46ae491fb1c65157ee6aab1367,1,Bryan Duxbury,2010-02-18 20:28:27+00:00,['becaf536211a699f1fb936752262fdb7bcd36126'],54,66,120,294143,7,1,1,1,988
39dadd6656d0cf009e8fdef42db9eea108cb6bb9,0,Bryan Duxbury,2010-02-18 22:00:45+00:00,['0e4920c6b892ef46ae491fb1c65157ee6aab1367'],1,24,25,294168,7,0.4,0.4,0.733333333,988
205e4500f9212ee3689fd973ca4e7b4886d2ed1d,0,Bryan Duxbury,2010-02-18 23:19:42+00:00,['39dadd6656d0cf009e8fdef42db9eea108cb6bb9'],8,94,102,294270,6,0.194805195,0.402597403,1,988
a34a4be080e90888842959794b4c8e7838276996,0,Bryan Duxbury,2010-02-19 20:00:55+00:00,['205e4500f9212ee3689fd973ca4e7b4886d2ed1d'],1,1,2,294272,1,,,,988
65073e5b116d1eb48ccc52c8446ebfdef4b36851,0,Bryan Duxbury,2010-02-23 15:46:46+00:00,['a34a4be080e90888842959794b4c8e7838276996'],1,1,2,294274,1,,,,988
dee6d4260c2cca0917d5a921460d16f062ab27d6,1,Bryan Duxbury,2010-02-23 19:06:25+00:00,['65073e5b116d1eb48ccc52c8446ebfdef4b36851'],4,73,77,294351,3,0,0.074074074,1,989
6acc269d1883c822595ab5f346c6e4c1e1b2724c,0,David Reiss,2010-02-26 00:56:02+00:00,['dee6d4260c2cca0917d5a921460d16f062ab27d6'],0,34,34,294385,2,1,1,0.791666667,990
53cba3cfa23d7c86badb0f85606a26a3e2391aec,1,Bryan Duxbury,2010-02-26 21:38:42+00:00,['6acc269d1883c822595ab5f346c6e4c1e1b2724c'],1,20,21,294406,2,0,0,1,990
30dd725952ddce68eecc645426443a5ebb3bec52,0,Bryan Duxbury,2010-02-27 05:47:15+00:00,['53cba3cfa23d7c86badb0f85606a26a3e2391aec'],0,7,7,294413,1,1,1,1,990
4e7cf25b9574eb439b329070fd57e854948144df,1,Bryan Duxbury,2010-02-28 05:19:38+00:00,['30dd725952ddce68eecc645426443a5ebb3bec52'],6,6,12,294425,2,,,,990
3e60fa6a54ecdd4b30df74e35ff64dbfd81a549c,1,Bryan Duxbury,2010-03-02 18:34:00+00:00,['4e7cf25b9574eb439b329070fd57e854948144df'],3,3,6,294431,2,,,,990
0f52f072013e8fcb85a8382a412a764433cf0673,0,Bryan Duxbury,2010-03-02 18:39:57+00:00,['3e60fa6a54ecdd4b30df74e35ff64dbfd81a549c'],6,186,192,294623,3,0.495238095,1,0.885714286,991
a268019e85ac34b5b7a1c89d59288ecead5e6d97,0,Bryan Duxbury,2010-03-02 18:49:02+00:00,['0f52f072013e8fcb85a8382a412a764433cf0673'],463,517,980,295603,6,1,0,1,993
53c10e09e15b446e7213b341e8fddc79296f1d51,0,David Reiss,2010-03-05 07:51:51+00:00,['a268019e85ac34b5b7a1c89d59288ecead5e6d97'],3,8,11,295614,3,,,,993
4ae8780c5c1e37c4c480a23f277a7942e3aada09,0,David Reiss,2010-03-09 00:49:14+00:00,['53c10e09e15b446e7213b341e8fddc79296f1d51'],0,3,3,295617,1,1,1,1,993
d93c626131455fe5f8757fe3ee29d7f7a5c4fe22,0,Bryan Duxbury,2010-03-09 05:14:34+00:00,['4ae8780c5c1e37c4c480a23f277a7942e3aada09'],1,1,2,295619,1,,,,993
4dd7801e90fe10a6614890f3d176716582b04233,0,David Reiss,2010-03-09 05:19:08+00:00,['d93c626131455fe5f8757fe3ee29d7f7a5c4fe22'],15,2,17,295636,1,,,,993
487fd2e0435db0326a60821bcc96e56fa2eee711,1,David Reiss,2010-03-09 05:19:11+00:00,['4dd7801e90fe10a6614890f3d176716582b04233'],0,3,3,295639,1,1,1,1,993
bec15e5105cae849b8095210e6ed6deac09c443d,1,David Reiss,2010-03-09 05:19:14+00:00,['487fd2e0435db0326a60821bcc96e56fa2eee711'],1,6,7,295646,1,1,1,0,993
ff3d249d413448489095991be7ce3176dbb87722,1,David Reiss,2010-03-09 05:19:16+00:00,['bec15e5105cae849b8095210e6ed6deac09c443d'],0,24,24,295670,1,0.941176471,0.941176471,0.941176471,993
c548b3dd6312e02df04ca822157c1e41193731c9,0,David Reiss,2010-03-09 05:19:18+00:00,['ff3d249d413448489095991be7ce3176dbb87722'],0,10,10,295680,1,1,1,1,993
006260f07a49f74b1fe8fa7be39b0d34d14b8067,1,David Reiss,2010-03-09 05:19:20+00:00,['c548b3dd6312e02df04ca822157c1e41193731c9'],0,12,12,295692,1,0.333333333,0.333333333,1,993
e574a065a9ed100bda718582dc3378abc2933e78,0,David Reiss,2010-03-09 05:19:22+00:00,['006260f07a49f74b1fe8fa7be39b0d34d14b8067'],0,17,17,295709,1,0,0,1,993
01fe15322f55a9aec5de6807fe0d4c54db7d79f6,1,David Reiss,2010-03-09 05:19:25+00:00,['e574a065a9ed100bda718582dc3378abc2933e78'],118,552,670,296379,4,0.588957055,0.858895706,0.950920245,993
28e88ecac1cab801112587068ee4fbc6de457e49,1,David Reiss,2010-03-09 05:19:27+00:00,['01fe15322f55a9aec5de6807fe0d4c54db7d79f6'],0,3,3,296382,1,0,0,1,993
b9db49c6776bde3b06ce8a5ceb32c873f8de4592,0,David Reiss,2010-03-09 05:19:30+00:00,['28e88ecac1cab801112587068ee4fbc6de457e49'],40,77,117,296499,4,0.666666667,1,1,993
a0dbfefbf3d09eebdc784f3fe6049c8bbc62a498,1,David Reiss,2010-03-09 05:19:32+00:00,['b9db49c6776bde3b06ce8a5ceb32c873f8de4592'],5,10,15,296514,1,1,1,1,993
83b8fdac0ff52f1f1d9f96772b956c807f668593,0,David Reiss,2010-03-09 05:19:34+00:00,['a0dbfefbf3d09eebdc784f3fe6049c8bbc62a498'],7,18,25,296539,2,1,1,1,993
e96fa5502f38d91e7c417343e4c504384fc84f31,0,David Reiss,2010-03-09 05:19:37+00:00,['83b8fdac0ff52f1f1d9f96772b956c807f668593'],1,20,21,296560,1,1,1,1,993
9e8073c5cd71ad72f7603b36514af06cee09c830,0,David Reiss,2010-03-09 05:19:39+00:00,['e96fa5502f38d91e7c417343e4c504384fc84f31'],2,2,4,296564,1,,,,993
450e35d2a333a6883c4a7444d9687e9ebd1160dd,0,David Reiss,2010-03-09 05:19:41+00:00,['9e8073c5cd71ad72f7603b36514af06cee09c830'],2,2,4,296568,1,,,,993
58e4d2c6e3b237825b573116d4e06781733ab5f5,0,David Reiss,2010-03-09 05:19:43+00:00,['450e35d2a333a6883c4a7444d9687e9ebd1160dd'],0,3,3,296571,1,0,0,1,993
068f4169b9c2cd9f93ad32e99c5b0d5b786e0bc1,1,David Reiss,2010-03-09 05:19:45+00:00,['58e4d2c6e3b237825b573116d4e06781733ab5f5'],12,139,151,296722,4,0.542372881,0.593220339,0.593220339,993
9c22ba41033a3f632df9db1c871cbf844e79824c,0,David Reiss,2010-03-09 05:19:47+00:00,['068f4169b9c2cd9f93ad32e99c5b0d5b786e0bc1'],1,2,3,296725,1,1,1,1,993
8106ba617af50f2a325fd6ce01a1a995cbd320a9,0,David Reiss,2010-03-09 05:19:50+00:00,['9c22ba41033a3f632df9db1c871cbf844e79824c'],0,11,11,296736,2,1,1,1,993
eed92991cf064f7c89a911be734d51619150d6bf,1,David Reiss,2010-03-09 05:19:52+00:00,['8106ba617af50f2a325fd6ce01a1a995cbd320a9'],5,11,16,296752,1,0,0,1,993
a1a15112fed5f7ec934a352920b4c535941fd1ab,1,David Reiss,2010-03-09 05:19:54+00:00,['eed92991cf064f7c89a911be734d51619150d6bf'],4,5,9,296761,1,,,,993
6c1ee214c447bef02c3aa091ff5706503d1b1004,1,David Reiss,2010-03-09 05:19:56+00:00,['a1a15112fed5f7ec934a352920b4c535941fd1ab'],3,28,31,296792,1,1,1,1,993
4e19f1914e49db4b7913ff0f5af8eec51caee875,1,David Reiss,2010-03-09 05:19:59+00:00,['6c1ee214c447bef02c3aa091ff5706503d1b1004'],6,35,41,296833,3,0.875,0.875,0.875,993
4cc0755b3382abc3e17ebba0ab4c2c78b9a8bbd7,0,David Reiss,2010-03-09 05:20:01+00:00,['4e19f1914e49db4b7913ff0f5af8eec51caee875'],1,1,2,296835,1,,,,993
7a2065d3dbdf361bbbe8b66a5b03080c0e532403,1,David Reiss,2010-03-09 05:20:04+00:00,['4cc0755b3382abc3e17ebba0ab4c2c78b9a8bbd7'],23,212,235,297070,4,1,1,0.71641791,993
ac110e4f1cd87ce38fce06e61ef88bc84ac2edb0,1,David Reiss,2010-03-09 05:20:07+00:00,['7a2065d3dbdf361bbbe8b66a5b03080c0e532403'],135,190,325,297395,6,0,1,1,995
eee98bede4e9934a0cdd32fcffcd0cc659b4d09a,1,David Reiss,2010-03-09 05:20:10+00:00,['ac110e4f1cd87ce38fce06e61ef88bc84ac2edb0'],7,11,18,297413,2,0,0,1,995
71a1530c74340e95a95a1b0b6c5699fbc082a9d9,0,David Reiss,2010-03-09 05:20:12+00:00,['eee98bede4e9934a0cdd32fcffcd0cc659b4d09a'],1,2,3,297416,1,0,1,1,995
1c20c871d218f479e101f6e9fb25231189d1bf72,0,David Reiss,2010-03-09 05:20:14+00:00,['71a1530c74340e95a95a1b0b6c5699fbc082a9d9'],1,40,41,297457,3,0.461538462,0,1,995
8af018bf13789a48af8a49827a0d18d26925d73f,1,David Reiss,2010-03-09 05:20:17+00:00,['1c20c871d218f479e101f6e9fb25231189d1bf72'],29,70,99,297556,2,0,0.029411765,1,995
336c29dbbeca40543a028c731be6d5c26aeeb363,0,David Reiss,2010-03-09 05:20:19+00:00,['8af018bf13789a48af8a49827a0d18d26925d73f'],1,10,11,297567,2,0,0,1,995
ccd4bdb2aebee869c537c8a38fd1c00e9ac706b3,0,David Reiss,2010-03-09 05:20:21+00:00,['336c29dbbeca40543a028c731be6d5c26aeeb363'],0,17,17,297584,2,1,1,1,995
472fffb37530256702006ef00b6fcf949ecbc26c,0,David Reiss,2010-03-09 05:20:24+00:00,['ccd4bdb2aebee869c537c8a38fd1c00e9ac706b3'],4,8,12,297596,2,0.25,0.25,1,995
450c240592b35c9706832fc853e0345cf5800c0d,0,David Reiss,2010-03-09 05:20:26+00:00,['472fffb37530256702006ef00b6fcf949ecbc26c'],1,1,2,297598,1,,,,995
767c1a90fed87d36aaf077322bb9225eff98ee52,0,David Reiss,2010-03-09 05:20:28+00:00,['450c240592b35c9706832fc853e0345cf5800c0d'],16,21,37,297635,1,0,0,1,995
5f013bb45d0c380b034c2099614ab1ba5eaea021,0,David Reiss,2010-03-10 22:11:26+00:00,['767c1a90fed87d36aaf077322bb9225eff98ee52'],0,2,2,297637,1,,,,995
3f4ca0e8fd63ed0fde1a5a00097144384436f9b2,1,Bryan Duxbury,2010-03-16 03:13:26+00:00,['5f013bb45d0c380b034c2099614ab1ba5eaea021'],1,6,7,297644,2,,,,995
f35a9b9152b66fc47c36ff25240e7704172d18ae,0,Bryan Duxbury,2010-03-17 16:47:41+00:00,['3f4ca0e8fd63ed0fde1a5a00097144384436f9b2'],4,4,8,297652,1,,,,995
318a328aec8062d6edf5efcd41dc8702a8595253,1,David Reiss,2010-03-22 02:34:57+00:00,['f35a9b9152b66fc47c36ff25240e7704172d18ae'],0,6,6,297658,1,1,1,1,995
27c97857582b79f9ca684e03641d1cf81e8916e3,0,Bryan Duxbury,2010-03-23 03:50:16+00:00,['318a328aec8062d6edf5efcd41dc8702a8595253'],62,95,157,297815,5,0.777777778,0.777777778,0.518518519,995
15b7b287947dd348e2801ead6b1a33b2a2d6b31b,1,Bryan Duxbury,2010-03-23 05:39:18+00:00,['27c97857582b79f9ca684e03641d1cf81e8916e3'],8,8,16,297831,1,1,0,0,995
951e7e24800c0f0c4cfcdef5d634b1e16536eed0,1,Bryan Duxbury,2010-03-26 05:05:59+00:00,['15b7b287947dd348e2801ead6b1a33b2a2d6b31b'],803,562,1365,299196,8,1,1,0,998
5af1b97173bd8cd2dda9529d441ca68960f5ff61,1,Bryan Duxbury,2010-03-26 05:12:27+00:00,['951e7e24800c0f0c4cfcdef5d634b1e16536eed0'],32,21,53,299249,2,0.222222222,0.111111111,0.777777778,998
98c45872f938eb746186ccb437b9e3a51127e82f,0,Bryan Duxbury,2010-03-26 05:58:34+00:00,['5af1b97173bd8cd2dda9529d441ca68960f5ff61'],442,354,796,300045,6,0.428571429,0,0,1000
61a1ad4d9d72d57387f1626edbeed0cbdaac2fb9,0,Bryan Duxbury,2010-03-26 05:59:59+00:00,['98c45872f938eb746186ccb437b9e3a51127e82f'],4,0,4,300049,1,,,,1000
bf0595fcb871dc496c35aa453713ae04bd1f9017,0,Bryan Duxbury,2010-03-26 16:59:46+00:00,['61a1ad4d9d72d57387f1626edbeed0cbdaac2fb9'],125,86,211,300260,7,1,1,0,1001
dd6dc838d902c3bc840d1c079e4de87760db0d38,1,Bryan Duxbury,2010-03-26 23:30:35+00:00,['bf0595fcb871dc496c35aa453713ae04bd1f9017'],166,161,327,300587,5,0,0,0,1004
dffa072afc5f5424dcec4744ef27021d7094fa3b,0,Bryan Duxbury,2010-03-26 23:38:23+00:00,['dd6dc838d902c3bc840d1c079e4de87760db0d38'],19,116,135,300722,8,,,,1004
d10f2bb4803663aa3921e1dd50b11fd521df807f,0,Bryan Duxbury,2010-03-26 23:45:41+00:00,['dffa072afc5f5424dcec4744ef27021d7094fa3b'],51,7,58,300780,9,0,0,0,1004
c23e09e7b012f9fbdba71e2dd8baabbfb1c4d70a,0,Bryan Duxbury,2010-03-27 05:56:26+00:00,['d10f2bb4803663aa3921e1dd50b11fd521df807f'],59,18,77,300857,2,1,1,0,1004
981869c6ac4a6d9d470407bc598f18e05310447c,0,Bryan Duxbury,2010-03-27 06:13:09+00:00,['c23e09e7b012f9fbdba71e2dd8baabbfb1c4d70a'],65,25,90,300947,3,1,0,0,1004
e5e5c7b9d2b4537d3477b7916e00a14a18b2f169,0,Bryan Duxbury,2010-03-27 06:24:12+00:00,['981869c6ac4a6d9d470407bc598f18e05310447c'],67,30,97,301044,3,1,1,0,1004
547edc7ae0fe871d452ecb34129c2bb4a1778014,1,Bryan Duxbury,2010-03-28 21:02:38+00:00,['e5e5c7b9d2b4537d3477b7916e00a14a18b2f169'],7,57,64,301108,2,,,,1004
b35240f4d585a4f0415bf64fca5a39e0008380eb,0,Bryan Duxbury,2010-03-29 21:12:10+00:00,['547edc7ae0fe871d452ecb34129c2bb4a1778014'],2,3,5,301113,1,,,,1004
5557beffaecbd7b97a90ed38afc49c2a091aadba,0,Bryan Duxbury,2010-03-29 23:57:09+00:00,['b35240f4d585a4f0415bf64fca5a39e0008380eb'],69,292,361,301474,4,0.605839416,0.708029197,1,1005
ea7910faf3abc85e90ba88bc9615b2fa3e8efd2d,0,Bryan Duxbury,2010-04-03 05:04:48+00:00,['5557beffaecbd7b97a90ed38afc49c2a091aadba'],5,17,22,301496,1,0,0.222222222,0.777777778,1005
c5de56cdfdaf7491fea99b52758231bb7ddea36e,1,Bryan Duxbury,2010-04-03 15:18:47+00:00,['ea7910faf3abc85e90ba88bc9615b2fa3e8efd2d'],55,61,116,301612,1,1,1,1,1005
c81a10a432c9d272c3d4bc461d5070b9c4062084,0,Bryan Duxbury,2010-04-03 19:45:20+00:00,['c5de56cdfdaf7491fea99b52758231bb7ddea36e'],0,45,45,301657,1,0.387096774,1,1,1006
75526c999ee741b8d30de4bffcb790ff52700bbe,0,Bryan Duxbury,2010-04-03 20:25:04+00:00,['c81a10a432c9d272c3d4bc461d5070b9c4062084'],4,43,47,301704,4,0.333333333,1,0.703703704,1006
88569a25d1e8380574de16be541f9e6e18bbca12,0,Bryan Duxbury,2010-04-03 22:52:03+00:00,['75526c999ee741b8d30de4bffcb790ff52700bbe'],2,233,235,301939,5,0.228187919,1,1,1008
b1f7f7973bed233ec6f21807dfd774f7b600c5ec,1,Bryan Duxbury,2010-04-03 23:19:52+00:00,['88569a25d1e8380574de16be541f9e6e18bbca12'],1,101,102,302041,3,0,0,1,1010
49b38015a672613c83d7c7a2954a9eb331b59a5a,0,Bryan Duxbury,2010-04-04 04:01:07+00:00,['b1f7f7973bed233ec6f21807dfd774f7b600c5ec'],3,16,19,302060,1,0,1,1,1010
33da6432202075cad3f91881e859778f89a9765c,0,Bryan Duxbury,2010-04-05 16:28:21+00:00,['49b38015a672613c83d7c7a2954a9eb331b59a5a'],8,42,50,302110,1,0,0,1,1010
eb598b8c899dcf267f6da6c4c137115af9cb2070,0,David Reiss,2010-04-14 17:33:01+00:00,['33da6432202075cad3f91881e859778f89a9765c'],1,2,3,302113,1,,,,1010
3292b3fed9665b04d6bfa2c8824af20332fbef39,0,Bryan Duxbury,2010-04-15 07:01:51+00:00,['eb598b8c899dcf267f6da6c4c137115af9cb2070'],217,143,360,302473,2,0.934782609,1,0,1011
0fab12e9681581d4919cb7afe21d853c9e300614,1,Bryan Duxbury,2010-04-22 00:22:34+00:00,['3292b3fed9665b04d6bfa2c8824af20332fbef39'],11,7,18,302491,3,1,0.5,0.5,1011
505b4c1e98bdb07d4f047cbe6d75a604750c2881,0,Bryan Duxbury,2010-04-22 00:26:41+00:00,['0fab12e9681581d4919cb7afe21d853c9e300614'],2,0,2,302493,1,,,,1011
60229785cb858c919f832e8ce8155c7c4ce06012,1,Bryan Duxbury,2010-04-22 00:27:41+00:00,['505b4c1e98bdb07d4f047cbe6d75a604750c2881'],1,1,2,302495,1,,,,1011
15e2930ccf8fd4932bd700f7dd9ba433819368d5,0,Bryan Duxbury,2010-04-22 01:05:02+00:00,['60229785cb858c919f832e8ce8155c7c4ce06012'],86,80,166,302661,5,1,1,1,1011
321eb7a2bdedde79102dfcf0fcefd99f45ec2075,1,Bryan Duxbury,2010-04-22 21:17:39+00:00,['15e2930ccf8fd4932bd700f7dd9ba433819368d5'],0,4731,4731,307392,34,0.106334842,0.36821267,0.609162896,1043
0137af6bf1e37762db319a08d2d6921d6897e21f,0,Bryan Duxbury,2010-04-22 21:21:46+00:00,['321eb7a2bdedde79102dfcf0fcefd99f45ec2075'],0,9,9,307401,1,0,0,1,1043
719ab84318ae1c7c59da5657ef0ad41dc4c3f921,0,Bryan Duxbury,2010-04-25 15:20:02+00:00,['0137af6bf1e37762db319a08d2d6921d6897e21f'],41,163,204,307605,4,0.534246575,0.575342466,0.301369863,1045
97d21c853d543dbba497650badcf10334910edaf,1,Bryan Duxbury,2010-04-26 18:16:46+00:00,['719ab84318ae1c7c59da5657ef0ad41dc4c3f921'],3,4,7,307612,1,0,0,1,1045
a005777ae5dabb49ade7d6d6306bd3391210e3aa,1,David Reiss,2010-04-26 19:37:44+00:00,['97d21c853d543dbba497650badcf10334910edaf'],1,22,23,307635,1,0,1,1,1045
7e36df1c07dda74187ad53ea1ff2d037fb3a67e5,1,David Reiss,2010-04-26 19:37:53+00:00,['a005777ae5dabb49ade7d6d6306bd3391210e3aa'],1,11,12,307647,1,1,1,0.375,1045
b80024d686a3e2b7f62c68d45bd606e01f0a9ef4,0,Andrew McGeachie,2010-04-28 17:43:45+00:00,['7e36df1c07dda74187ad53ea1ff2d037fb3a67e5'],1,6,7,307654,1,,,,1045
abfc54fa0689f8257a1612df39f1f25d3fe0c560,0,Bryan Duxbury,2010-04-29 00:33:34+00:00,['b80024d686a3e2b7f62c68d45bd606e01f0a9ef4'],0,8,8,307662,1,1,1,1,1045
332a625118c87d1ea3540aefff3f5ad8ddf8428b,0,Bryan Duxbury,2010-04-29 17:08:17+00:00,['abfc54fa0689f8257a1612df39f1f25d3fe0c560'],1,1,2,307664,1,,,,1045
cb6d9708e2673b92aec3ee6bbff7e67b5b0a171f,0,Bryan Duxbury,2010-04-29 18:14:54+00:00,['332a625118c87d1ea3540aefff3f5ad8ddf8428b'],1,39,40,307704,1,1,1,0.37037037,1045
12abe949779c5eb318ae616695ce02385b728bce,0,Bryan Duxbury,2010-04-30 21:35:38+00:00,['cb6d9708e2673b92aec3ee6bbff7e67b5b0a171f'],54,169,223,307927,5,0.525641026,0.269230769,0.858974359,1046
adf5f19c541deeeb5fc9f695c61378e4490745a7,0,Bryan Duxbury,2010-04-30 21:39:54+00:00,['12abe949779c5eb318ae616695ce02385b728bce'],1,1,2,307929,1,,,,1046
06491d7bb591f8b55d4be6b116b246c56af66511,0,Bryan Duxbury,2010-05-01 13:45:38+00:00,['adf5f19c541deeeb5fc9f695c61378e4490745a7'],286,41,327,308256,5,0.461038961,0.571428571,0.402597403,1046
6a681873383b931c82f5a4ddafb0c58547516eca,1,Bryan Duxbury,2010-05-02 22:39:31+00:00,['06491d7bb591f8b55d4be6b116b246c56af66511'],1,51,52,308308,4,0,0,1,1047
7173bd96bd7002d3b4ef86f02877b83d80b6c83b,1,Bryan Duxbury,2010-05-02 22:54:22+00:00,['6a681873383b931c82f5a4ddafb0c58547516eca'],1,22,23,308331,2,,,,1047
f7d9f8e4899ac9b126a4ed3cd11a949fd476a066,0,Bryan Duxbury,2010-05-02 23:04:03+00:00,['7173bd96bd7002d3b4ef86f02877b83d80b6c83b'],18,25,43,308374,4,0,0.571428571,1,1047
a1e268c54b6702dc9223623fd51a8c96df8335d2,0,Bryan Duxbury,2010-05-03 21:33:00+00:00,['f7d9f8e4899ac9b126a4ed3cd11a949fd476a066'],77,9,86,308460,7,,,,1048
c8ee35805dc23143a8e0e774cee497deea4fa97d,0,Bryan Duxbury,2010-05-04 14:01:14+00:00,['a1e268c54b6702dc9223623fd51a8c96df8335d2'],5,1,6,308466,1,1,1,0,1048
1873fed34248698975f94d3f7c23afd7491a04c5,0,David Reiss,2010-05-04 16:32:33+00:00,['c8ee35805dc23143a8e0e774cee497deea4fa97d'],15,34,49,308515,1,,,,1048
b405edb6ff46b894cb9abce1f1b2e0121770db3d,0,Bryan Duxbury,2010-05-07 18:44:48+00:00,['1873fed34248698975f94d3f7c23afd7491a04c5'],0,0,0,308515,0,,,,1048
b9b7048bc37c3fc30e0631a5fa0be9e12ab20d71,0,Bryan Duxbury,2010-05-07 18:55:53+00:00,['b405edb6ff46b894cb9abce1f1b2e0121770db3d'],2,2,4,308519,2,,,,1048
8f293f94c8fc05e2c29ff66891836b8ded4f0f8e,0,David Reiss,2010-05-07 20:08:03+00:00,['1873fed34248698975f94d3f7c23afd7491a04c5'],3,3,6,308525,1,,,,1048
f5d650a5a07e579f045617238995efc834b4f648,1,David Reiss,2010-05-07 20:08:06+00:00,['8f293f94c8fc05e2c29ff66891836b8ded4f0f8e'],0,2,2,308527,1,,,,1048
fb90e77e4509a639390ecb3e435cf8620340676b,0,Bryan Duxbury,2010-05-12 20:54:07+00:00,['f5d650a5a07e579f045617238995efc834b4f648'],50,276,326,308853,2,0.294573643,0.612403101,0.23255814,1048
fe55e75bbd0e5ff886d4b64b202f7a3e1e1df8a7,0,Bryan Duxbury,2010-05-12 21:16:44+00:00,['b9b7048bc37c3fc30e0631a5fa0be9e12ab20d71'],0,2,2,308855,1,,,,1048
3f0b526d2d1893807e2bcfef60af24cbca6a7bbf,0,Bryan Duxbury,2010-05-12 21:31:58+00:00,['fb90e77e4509a639390ecb3e435cf8620340676b'],1,6,7,308862,2,,,,1048
b6657f142e86135fea5d3352f7155165744a7282,0,David Reiss,2010-05-17 19:13:23+00:00,['3f0b526d2d1893807e2bcfef60af24cbca6a7bbf'],1,1,2,308864,1,,,,1048
9e2fd7987db241b5f35967e157223b398349b07e,1,David Reiss,2010-05-18 16:52:48+00:00,['b6657f142e86135fea5d3352f7155165744a7282'],25,14,39,308903,2,,,,1048
d09f09c89d626f145bf429d2e5f0431ea42ea2b3,1,David Reiss,2010-05-18 21:32:16+00:00,['9e2fd7987db241b5f35967e157223b398349b07e'],7,7,14,308917,1,,,,1048
7ceba947212b6709adac7395a29d39376c50c9a4,0,Andrew McGeachie,2010-05-19 15:00:26+00:00,['d09f09c89d626f145bf429d2e5f0431ea42ea2b3'],1,1,2,308919,1,,,,1048
910cd831ed43ebf58e7fd27024d8950a36ec1f2b,0,Bryan Duxbury,2010-05-19 16:28:08+00:00,['fe55e75bbd0e5ff886d4b64b202f7a3e1e1df8a7'],25,14,39,308958,2,,,,1048
d58ccec66090afbbef68471cb635ad731ef03319,1,Bryan Duxbury,2010-05-26 16:34:48+00:00,['7ceba947212b6709adac7395a29d39376c50c9a4'],40,927,967,309925,13,0.360416667,0.622916667,0.864583333,1054
b7887b860bb37148761a81b34f1302939f0329cd,0,Bryan Duxbury,2010-06-09 21:30:54+00:00,['d58ccec66090afbbef68471cb635ad731ef03319'],0,127,127,310052,7,,,,1054
c07057e49ff8a2a1d2b772cf8655f55b01893350,0,David Reiss,2010-06-11 17:57:32+00:00,['b7887b860bb37148761a81b34f1302939f0329cd'],1,7,8,310060,2,,,,1054
0851779daa867653e9603d6eb479f8f73ea40732,0,Bryan Duxbury,2010-06-22 18:53:53+00:00,['910cd831ed43ebf58e7fd27024d8950a36ec1f2b'],0,127,127,310187,7,,,,1054
2e1aab5db73ff3a32af112ee955b891d4705afc5,0,Bryan Duxbury,2010-06-23 16:54:17+00:00,['c07057e49ff8a2a1d2b772cf8655f55b01893350'],0,1,1,310188,1,0,0,1,1054
656683c776f594da98b8df6d00fcb2a316d56171,0,Bryan Duxbury,2010-06-23 16:57:51+00:00,['2e1aab5db73ff3a32af112ee955b891d4705afc5'],0,3,3,310191,1,0,0,1,1054
162b3ac6465d598e834609c8fae5b341f8e941d8,1,Bryan Duxbury,2010-06-23 21:17:48+00:00,['656683c776f594da98b8df6d00fcb2a316d56171'],7,45,52,310243,4,0.043478261,0.347826087,1,1054
d08e3021af3e673cda5f5abd89a3aab1db98657c,0,David Reiss,2010-06-24 17:04:46+00:00,['0851779daa867653e9603d6eb479f8f73ea40732'],0,0,0,310243,0,,,,1054
623594749c76f65bf964a5dc517128f207d25b42,1,Bryan Duxbury,2010-06-24 20:34:34+00:00,['162b3ac6465d598e834609c8fae5b341f8e941d8'],5,197,202,310445,4,0.29,0.92,0.76,1055
95c005a7c69d106591202cfa6eded6354608b307,1,David Reiss,2010-07-01 05:36:25+00:00,['623594749c76f65bf964a5dc517128f207d25b42'],2,18,20,310465,1,0,0.2,0,1055
127909c1c948e9248f7ed98f0b5e3a7088d89ca3,0,T Jake Luciani,2010-07-10 14:58:51+00:00,['95c005a7c69d106591202cfa6eded6354608b307'],2,2,4,310469,2,,,,1055
99f2ab7790003138124a5791d624ed5651e4908c,1,Bryan Duxbury,2010-07-13 23:11:04+00:00,['127909c1c948e9248f7ed98f0b5e3a7088d89ca3'],6,8,14,310483,3,1,1,1,1055
da50d552321c8bcf1108ebaf2ef21c08bf77956d,0,Andrew McGeachie,2010-07-21 19:14:44+00:00,['99f2ab7790003138124a5791d624ed5651e4908c'],3,3,6,310489,2,,,,1055
c892ac555e74db0b3be99093fb6ffec5468ad316,1,Andrew McGeachie,2010-07-21 19:51:04+00:00,['da50d552321c8bcf1108ebaf2ef21c08bf77956d'],0,13,13,310502,2,1,1,1,1055
b8ca398d5f4bb2c0f775e415004785afb4026ba2,0,Bryan Duxbury,2010-07-23 21:22:40+00:00,['d08e3021af3e673cda5f5abd89a3aab1db98657c'],0,18,18,310520,1,,,,1055
15c9877f7b29748099a983728687acecdf8f0206,0,Bryan Duxbury,2010-07-23 21:24:04+00:00,['b8ca398d5f4bb2c0f775e415004785afb4026ba2'],1,19,20,310540,1,,,,1055
fb3e1475de6279c3c061a6faccff410d7fde1834,0,Bryan Duxbury,2010-07-26 17:12:42+00:00,['15c9877f7b29748099a983728687acecdf8f0206'],2,76,78,310618,4,,,,1055
dc4a871e120e60f353fc698ab1bc52be884e2f88,1,Bryan Duxbury,2010-07-26 17:18:30+00:00,['c892ac555e74db0b3be99093fb6ffec5468ad316'],3,113,116,310734,6,,,,1055
dcfb0025df86fcc0e372ba33e851981cb54c49fe,0,Bryan Duxbury,2010-07-26 17:20:24+00:00,['dc4a871e120e60f353fc698ab1bc52be884e2f88'],0,0,0,310734,0,,,,1055
dcdd550419fccbf9e95cc3da371129278b5ecd24,0,Bryan Duxbury,2010-07-28 18:22:02+00:00,['fb3e1475de6279c3c061a6faccff410d7fde1834'],0,60,60,310794,4,,,,1055
23f2348fae272f68622bb12f3c271edf721ca1eb,0,Bryan Duxbury,2010-07-28 18:23:22+00:00,['dcfb0025df86fcc0e372ba33e851981cb54c49fe'],320,88,408,311202,7,0.316326531,0,0.12244898,1055
51d1a50e62d1f60b272c777f03791a3554f35573,0,Bryan Duxbury,2010-07-28 19:04:25+00:00,['dcdd550419fccbf9e95cc3da371129278b5ecd24'],1,19,20,311222,1,,,,1055
e95d2772b5250b7d9bb0103d361e2e1b009d90ff,0,Bryan Duxbury,2010-07-28 19:06:33+00:00,['23f2348fae272f68622bb12f3c271edf721ca1eb'],1,19,20,311242,1,,,,1055
04345ad4f0cca9dd7c15954a1a54239f030bc7ba,0,Bryan Duxbury,2010-07-28 19:07:57+00:00,['51d1a50e62d1f60b272c777f03791a3554f35573'],0,34,34,311276,1,,,,1056
a7bd2f20ff8301040e80debdf2d9c91ccbe55c14,1,Bryan Duxbury,2010-07-28 19:08:58+00:00,['e95d2772b5250b7d9bb0103d361e2e1b009d90ff'],0,34,34,311310,1,,,,1057
4d8815037c091866e7275aa3f55844dbcae3db41,0,Bryan Duxbury,2010-07-28 19:13:12+00:00,['04345ad4f0cca9dd7c15954a1a54239f030bc7ba'],1,1,2,311312,1,,,,1057
7ba364f7d80624d378be67624a92cda43665b091,0,Bryan Duxbury,2010-07-28 20:45:37+00:00,['a7bd2f20ff8301040e80debdf2d9c91ccbe55c14'],28,320,348,311660,3,0.683673469,1,0.87755102,1057
d2cc5bb39e2eac4d93cf421707e388c50b62e058,1,Bryan Duxbury,2010-07-28 21:00:06+00:00,['7ba364f7d80624d378be67624a92cda43665b091'],244,50,294,311954,4,0.976377953,0,0,1057
76c2dcc4d3d4497a2ec11fefb4a76087fc5fbf79,0,Bryan Duxbury,2010-07-28 21:30:24+00:00,['d2cc5bb39e2eac4d93cf421707e388c50b62e058'],12,9,21,311975,1,1,0,1,1057
efabb89c75169611801330b71b5fd230d46f8128,1,T Jake Luciani,2010-07-28 22:31:12+00:00,['76c2dcc4d3d4497a2ec11fefb4a76087fc5fbf79'],102,170,272,312247,3,0.666666667,0,1,1057
e0ac3abd534151e845fe229881a5ef27baf1b521,1,Bryan Duxbury,2010-07-29 16:24:41+00:00,['efabb89c75169611801330b71b5fd230d46f8128'],79,113,192,312439,3,1,1,1,1058
c687712d18ae6db3f5ca06f49acdebf86635e1de,0,Bryan Duxbury,2010-07-29 18:39:06+00:00,['e0ac3abd534151e845fe229881a5ef27baf1b521'],1,3,4,312443,1,1,1,1,1058
d8c7757b9db7ec9839c795eba59119c4fd85b693,0,Bryan Duxbury,2010-07-29 19:30:47+00:00,['c687712d18ae6db3f5ca06f49acdebf86635e1de'],1,2,3,312446,1,,,,1058
c412a2fad4e25f73a72f9821fd297937d9b2abda,0,Bryan Duxbury,2010-08-04 18:51:57+00:00,['d8c7757b9db7ec9839c795eba59119c4fd85b693'],0,1,1,312447,1,,,,1058
5226eeaaaa1789fccce5c7cf0a5cef0a38190df8,1,Bryan Duxbury,2010-08-05 20:44:53+00:00,['c412a2fad4e25f73a72f9821fd297937d9b2abda'],1,57,58,312505,3,0.1,0.1,0.975,1058
067a7beb7350818c97edf24086f48cef2a9be1fa,1,Bryan Duxbury,2010-08-05 21:13:06+00:00,['5226eeaaaa1789fccce5c7cf0a5cef0a38190df8'],20,126,146,312651,3,0.1625,0,1,1058
d74ca156b3aaff49abca1b52461235031ef522b9,0,Bryan Duxbury,2010-08-05 22:05:35+00:00,['067a7beb7350818c97edf24086f48cef2a9be1fa'],0,119,119,312770,1,0.571428571,1,0.857142857,1059
ad776c14256b3dd0b8d3ff6d466416c3f7f1f642,1,Bryan Duxbury,2010-08-05 22:12:01+00:00,['d74ca156b3aaff49abca1b52461235031ef522b9'],6,27,33,312803,2,1,1,1,1059
20dbec7cfe9f9b642f5c04d550063e600c35a9db,0,Bryan Duxbury,2010-08-05 22:28:13+00:00,['ad776c14256b3dd0b8d3ff6d466416c3f7f1f642'],6,6,12,312815,1,,,,1059
5a9fc65f55bf428a663b559281fce956bd6884c0,0,Bryan Duxbury,2010-08-05 23:22:02+00:00,['20dbec7cfe9f9b642f5c04d550063e600c35a9db'],0,1,1,312816,1,,,,1059
8fc413fbfd721080d5e8e0300d1094387cdeda15,0,Bryan Duxbury,2010-08-05 23:23:04+00:00,['5a9fc65f55bf428a663b559281fce956bd6884c0'],1,6,7,312823,1,1,1,1,1059
7f3285eddb0c4e1f58e2facacd47cf992e50c34c,1,Bryan Duxbury,2010-08-05 23:28:14+00:00,['8fc413fbfd721080d5e8e0300d1094387cdeda15'],0,40,40,312863,1,,,,1059
f5abd26858f6839c9b8853c8fe810b94b310d1ad,1,Bryan Duxbury,2010-08-06 00:18:25+00:00,['7f3285eddb0c4e1f58e2facacd47cf992e50c34c'],217,207,424,313287,17,1,1,0,1059
b22b51eea25698e2eb1319850835567dbfb28278,0,T Jake Luciani,2010-08-06 02:37:45+00:00,['f5abd26858f6839c9b8853c8fe810b94b310d1ad'],1,1,2,313289,1,,,,1059
ea67a78377e7434cb750b6e7a1072e3729c8109f,0,Bryan Duxbury,2010-08-06 17:50:51+00:00,['b22b51eea25698e2eb1319850835567dbfb28278'],2,8,10,313299,1,1,1,1,1059
7e9ac7bf593a71b05b0879ddc34aaf82509052bb,0,Bryan Duxbury,2010-08-09 15:25:34+00:00,['ea67a78377e7434cb750b6e7a1072e3729c8109f'],2,2,4,313303,1,,,,1059
f66525f56ceca6d650bb877ec1528233c352848b,0,Bryan Duxbury,2010-08-10 20:59:00+00:00,['7e9ac7bf593a71b05b0879ddc34aaf82509052bb'],1,1,2,313305,1,,,,1059
09d13c2edff351f00ff1f33eccb43ad54e68df7e,0,Bryan Duxbury,2010-08-11 18:37:25+00:00,['f66525f56ceca6d650bb877ec1528233c352848b'],6,11,17,313322,2,,,,1059
38bab12298973b8d423a3362720a51c222933d3e,0,Bryan Duxbury,2010-08-12 00:27:14+00:00,['09d13c2edff351f00ff1f33eccb43ad54e68df7e'],1,1,2,313324,1,,,,1059
34b530f099b4ecbc5537ba904f4a91dfef945147,1,Bryan Duxbury,2010-08-12 01:48:51+00:00,['38bab12298973b8d423a3362720a51c222933d3e'],0,6,6,313330,1,1,1,1,1059
b149bc7050c5136f3b071e1c1251f0f2716ae208,0,Bryan Duxbury,2010-08-12 14:54:33+00:00,['34b530f099b4ecbc5537ba904f4a91dfef945147'],23,0,23,313353,11,,,,1059
7c74d9bfb131ee4486a04c5405173234cfa06f28,1,Bryan Duxbury,2010-08-12 15:00:41+00:00,['b149bc7050c5136f3b071e1c1251f0f2716ae208'],20,21,41,313394,1,0,0,1,1059
17115d7a528b6351fc230fe73b6d765b8e186264,1,Bryan Duxbury,2010-08-12 16:59:19+00:00,['7c74d9bfb131ee4486a04c5405173234cfa06f28'],8,334,342,313736,7,0.671052632,0.565789474,0.828947368,1064
07b2ed1df5a7438c974480c2888ec64437c1466e,0,Bryan Duxbury,2010-08-12 17:21:06+00:00,['17115d7a528b6351fc230fe73b6d765b8e186264'],4,6,10,313746,1,0,0,1,1064
e2350512c9e2bcff8f5d3c2a3108e2573e85a1a5,1,David Reiss,2010-08-12 21:15:04+00:00,['07b2ed1df5a7438c974480c2888ec64437c1466e'],42,55,97,313843,1,0,0,0,1064
112e30985bdd71433a736bdc16019d22adccb59c,1,David Reiss,2010-08-12 23:03:29+00:00,['e2350512c9e2bcff8f5d3c2a3108e2573e85a1a5'],320,28,348,314191,3,0.316326531,0,0.12244898,1064
cf8fc15fa083d4111886b304e287e9811fe1b9c0,1,David Reiss,2010-08-12 23:27:54+00:00,['112e30985bdd71433a736bdc16019d22adccb59c'],4,4,8,314199,1,,,,1064
66c334792b1148f7eec8af923b5d90b29a89201e,1,Bryan Duxbury,2010-08-12 23:37:47+00:00,['cf8fc15fa083d4111886b304e287e9811fe1b9c0'],14,141,155,314354,1,0.085365854,0,0.756097561,1064
f6b0e7cb38a751de5658808bfb8c6316e6f4babf,0,Bryan Duxbury,2010-08-12 23:42:45+00:00,['66c334792b1148f7eec8af923b5d90b29a89201e'],1,1,2,314356,1,,,,1064
0bb034008cbbb9681863f009e8473d527f154a18,1,Bryan Duxbury,2010-08-13 00:13:16+00:00,['f6b0e7cb38a751de5658808bfb8c6316e6f4babf'],5,598,603,314959,10,0.814159292,1,0.849557522,1072
7b1128c94fa330fdf18300ba24868ef49b510520,0,Bryan Duxbury,2010-08-13 00:17:16+00:00,['0bb034008cbbb9681863f009e8473d527f154a18'],2,15,17,314976,1,,,,1072
088e42e8501bb91e55937bcf7a80c57f98f66f87,0,Bryan Duxbury,2010-08-13 00:21:06+00:00,['7b1128c94fa330fdf18300ba24868ef49b510520'],0,0,0,314976,0,,,,1072
cdde1854e7d2eb27577bec89336f1ec007195478,1,David Reiss,2010-08-13 02:06:08+00:00,['7b1128c94fa330fdf18300ba24868ef49b510520'],0,543,543,315519,4,0.562264151,1,1,1076
d26ef49c90ee94a140ebdf692b54158b8b249389,0,Bryan Duxbury,2010-08-13 02:50:02+00:00,['088e42e8501bb91e55937bcf7a80c57f98f66f87'],0,543,543,316062,4,0.562264151,1,1,1080
2acb33cf4149306204286ac222243c86634f3392,0,Bryan Duxbury,2010-08-13 02:50:56+00:00,['d26ef49c90ee94a140ebdf692b54158b8b249389'],1,1,2,316064,1,,,,1080
4c9f25c9a5d87f72b268e3cddda3d4b3b7865855,0,Bryan Duxbury,2010-08-13 02:52:12+00:00,['cdde1854e7d2eb27577bec89336f1ec007195478'],1,1,2,316066,1,,,,1080
38e1ba3f8dca5cb7a9c4c6bedcbe6bb31dc4ccae,0,Bryan Duxbury,2010-08-13 04:28:04+00:00,['2acb33cf4149306204286ac222243c86634f3392'],0,49,49,316115,1,,,,1080
d7042709946ffc16310ec2b3d487923eeca7600f,1,Bryan Duxbury,2010-08-13 04:28:13+00:00,['4c9f25c9a5d87f72b268e3cddda3d4b3b7865855'],0,49,49,316164,1,,,,1080
48fa172d34b2e389b4316301bf67198b2ac715e9,0,Bryan Duxbury,2010-08-15 21:10:22+00:00,['38e1ba3f8dca5cb7a9c4c6bedcbe6bb31dc4ccae'],3,2,5,316169,1,,,,1080
56b44d72b9bc6cd0443b860feb930b270cd93ea1,0,Bryan Duxbury,2010-08-15 21:10:47+00:00,['d7042709946ffc16310ec2b3d487923eeca7600f'],3,2,5,316174,1,,,,1080
4d0e2b48bf30af8378436529b439662e752a5468,0,Bryan Duxbury,2010-08-15 22:57:07+00:00,['56b44d72b9bc6cd0443b860feb930b270cd93ea1'],1,1,2,316176,1,,,,1080
346a2689319123a99f7a4efa2c5316ba73b7be47,0,Bryan Duxbury,2010-08-15 23:04:12+00:00,['4d0e2b48bf30af8378436529b439662e752a5468'],1,1,2,316178,1,,,,1080
3ff373e26e633fe728c7d93485db637bbb534a85,1,Bryan Duxbury,2010-08-15 23:19:06+00:00,['346a2689319123a99f7a4efa2c5316ba73b7be47'],26,614,640,316818,2,0.163043478,0.429347826,0.89673913,1081
0c4f88a9533ac99d8101fb97f9b22f0d5c22cb9a,0,Bryan Duxbury,2010-08-16 17:08:03+00:00,['48fa172d34b2e389b4316301bf67198b2ac715e9'],15,2,17,316835,1,,,,1081
184d26237a3d0a5449a29350a74c2240bf1097e8,0,Bryan Duxbury,2010-08-17 17:43:58+00:00,['3ff373e26e633fe728c7d93485db637bbb534a85'],9,8,17,316852,3,,,,1081
d50f347e33abcfc5c4d70bb8d276f3e1951f4e00,0,Bryan Duxbury,2010-08-19 04:58:34+00:00,['184d26237a3d0a5449a29350a74c2240bf1097e8'],1,1,2,316854,1,,,,1081
d3879f80c6bfb8c60b569ceb9a6235fcdff066a2,1,Bryan Duxbury,2010-08-19 05:06:02+00:00,['d50f347e33abcfc5c4d70bb8d276f3e1951f4e00'],1532,1203,2735,319589,31,,,,1084
1237369cfc1b63c7b4c7e1a9455b2196c3fda006,1,Bryan Duxbury,2010-08-19 05:23:59+00:00,['d3879f80c6bfb8c60b569ceb9a6235fcdff066a2'],1,5,6,319595,1,,,,1084
cd7a51fd93be6e756445b363acffaed7a4151c2c,0,Bryan Duxbury,2010-08-19 15:21:04+00:00,['1237369cfc1b63c7b4c7e1a9455b2196c3fda006'],0,7,7,319602,1,,,,1084
1ee2001d03b83384f073ff744fb23be653a67c5b,1,David Reiss,2010-08-19 16:29:52+00:00,['cd7a51fd93be6e756445b363acffaed7a4151c2c'],0,3,3,319605,1,,,,1084
5d742622e6b4bd46dd7d31d66011a546c99c79c1,1,Bryan Duxbury,2010-08-19 21:02:19+00:00,['1ee2001d03b83384f073ff744fb23be653a67c5b'],8,1,9,319614,2,,,,1084
3adf8aad36eb46bf94c7c8ab7fc3a743775b46b2,1,Bryan Duxbury,2010-08-19 21:41:58+00:00,['5d742622e6b4bd46dd7d31d66011a546c99c79c1'],73,187,260,319874,4,0.654320988,1,0.950617284,1084
681f5eae6dee4e317248145be07be0b6ded5c1e8,1,Bryan Duxbury,2010-08-20 16:42:04+00:00,['3adf8aad36eb46bf94c7c8ab7fc3a743775b46b2'],4,34,38,319912,4,0,1,1,1084
c39817c9a7800d7185f908f726137bcb11c0df2c,0,Bryan Duxbury,2010-08-20 16:45:13+00:00,['681f5eae6dee4e317248145be07be0b6ded5c1e8'],6,17,23,319935,1,1,1,1,1084
0d28efac2d1caf844c7c8e44eb5feee07cdc8cd5,0,Bryan Duxbury,2010-08-20 17:59:17+00:00,['c39817c9a7800d7185f908f726137bcb11c0df2c'],0,2,2,319937,1,,,,1085
66467a7779b980bf8e338ab3e9407fea64a6743f,1,Bryan Duxbury,2010-08-21 17:48:18+00:00,['0d28efac2d1caf844c7c8e44eb5feee07cdc8cd5'],44,22,66,320003,3,1,1,1,1085
31e1b6e98806ffe793421ec9543717c4e6c9188d,0,David Reiss,2010-08-24 20:45:24+00:00,['66467a7779b980bf8e338ab3e9407fea64a6743f'],4,6,10,320013,1,,,,1085
82c73194df27be0874092b92271575ae23820bc3,0,David Reiss,2010-08-24 20:52:56+00:00,['31e1b6e98806ffe793421ec9543717c4e6c9188d'],11,11,22,320035,3,,,,1085
89200e1c9df54bd90a240a61849842e7584304e4,1,Bryan Duxbury,2010-08-25 17:09:02+00:00,['82c73194df27be0874092b92271575ae23820bc3'],6,28,34,320069,4,,,,1086
e3ba3490deabc8beb5a0f694b3134b16c5e3b68f,0,David Reiss,2010-08-26 21:49:45+00:00,['89200e1c9df54bd90a240a61849842e7584304e4'],3,3,6,320075,3,,,,1086
90ec5bfcd0acd9314b0c02df25802fe9e26de4e3,0,Todd Lipcon,2010-08-27 06:16:37+00:00,['e3ba3490deabc8beb5a0f694b3134b16c5e3b68f'],7,13,20,320095,3,0,0,1,1086
4d8a9cd5693e9d6d14d4196d325be2e6917043a5,0,Bryan Duxbury,2010-08-30 17:09:58+00:00,['90ec5bfcd0acd9314b0c02df25802fe9e26de4e3'],1,8,9,320104,3,0,1,1,1086
bcfb72a60badf802f4d8275453b26e89437bdaa5,0,Bryan Duxbury,2010-08-30 20:27:32+00:00,['4d8a9cd5693e9d6d14d4196d325be2e6917043a5'],1,0,1,320105,1,,,,1086
73af3b7c4c3b3d71c12544ed800ec9b1c537c783,1,David Reiss,2010-08-30 21:57:07+00:00,['bcfb72a60badf802f4d8275453b26e89437bdaa5'],1,15,16,320121,1,1,0,1,1086
f32d0fb90085009cd53efd402f21d6fe6dcde492,1,David Reiss,2010-08-30 22:05:00+00:00,['73af3b7c4c3b3d71c12544ed800ec9b1c537c783'],1204,1533,2737,322858,31,,,,1087
8f9431484674d06a22819ac19c95c09d24304fda,0,David Reiss,2010-08-30 22:05:01+00:00,['f32d0fb90085009cd53efd402f21d6fe6dcde492'],3,3,6,322864,1,,,,1087
fb2c1ae5949bd31d079c8617f64c107611184a90,0,David Reiss,2010-08-30 22:05:02+00:00,['8f9431484674d06a22819ac19c95c09d24304fda'],1,0,1,322865,1,,,,1087
bf2b97871b30ce7648ec0faf2467217662db0fac,0,David Reiss,2010-08-30 22:05:04+00:00,['fb2c1ae5949bd31d079c8617f64c107611184a90'],2,2,4,322869,1,,,,1087
58d312d516d46e97b38dbd139c93c6d11dd80a14,0,David Reiss,2010-08-30 22:05:05+00:00,['bf2b97871b30ce7648ec0faf2467217662db0fac'],55,0,55,322924,2,,,,1087
14da1daf6780ad8f9829085399215ac71108fdf5,0,David Reiss,2010-08-30 22:05:06+00:00,['58d312d516d46e97b38dbd139c93c6d11dd80a14'],5,5,10,322934,1,,,,1087
ba5a9842712a2a151aba8c304bcbd4766967107d,0,David Reiss,2010-08-30 22:05:07+00:00,['14da1daf6780ad8f9829085399215ac71108fdf5'],1,1,2,322936,1,,,,1087
d172a887ff5668b83bb7ab482d731fe384cbd35f,0,David Reiss,2010-08-30 22:05:08+00:00,['ba5a9842712a2a151aba8c304bcbd4766967107d'],1,1,2,322938,1,,,,1087
6d0be7235cf491431242319a5edc7243ece76d22,0,David Reiss,2010-08-30 22:05:09+00:00,['d172a887ff5668b83bb7ab482d731fe384cbd35f'],1,1,2,322940,1,,,,1087
3e81fff832395e24fa3e12ac09bfb6cb8dd570bd,0,David Reiss,2010-08-30 22:05:11+00:00,['6d0be7235cf491431242319a5edc7243ece76d22'],1,1,2,322942,1,,,,1087
c0e4b5b246a90f0d098955532a8d913bdb6c0083,0,David Reiss,2010-08-30 22:05:12+00:00,['3e81fff832395e24fa3e12ac09bfb6cb8dd570bd'],1,1,2,322944,1,,,,1087
5db982cdf2492914a4d8d09e066c1103d3bc447c,0,David Reiss,2010-08-30 22:05:13+00:00,['c0e4b5b246a90f0d098955532a8d913bdb6c0083'],1,0,1,322945,1,,,,1087
7772d931a1908fa924972f4725de9e8ed3851d97,0,David Reiss,2010-08-30 22:05:15+00:00,['5db982cdf2492914a4d8d09e066c1103d3bc447c'],1,0,1,322946,1,,,,1087
a94514f48ebabd82b6814c709efa67d8cffbcb2b,0,David Reiss,2010-08-30 22:05:16+00:00,['7772d931a1908fa924972f4725de9e8ed3851d97'],1,1,2,322948,1,,,,1087
6204bb12be87abc805968f151e1b56118ec94e9f,1,David Reiss,2010-08-30 22:05:17+00:00,['a94514f48ebabd82b6814c709efa67d8cffbcb2b'],1,3,4,322952,1,,,,1087
5e6637b0ffdf9130e7cac012a5c42235d2f74f7d,0,David Reiss,2010-08-30 22:05:18+00:00,['6204bb12be87abc805968f151e1b56118ec94e9f'],0,45,45,322997,4,,,,1088
9b7fbe37437a21a9d18644d9b20b6e8e86a92ce4,1,David Reiss,2010-08-30 22:05:20+00:00,['5e6637b0ffdf9130e7cac012a5c42235d2f74f7d'],1,52,53,323050,10,,,,1089
ee93398ccc61843239c24aabeafc8d4d7a6ec27e,0,David Reiss,2010-08-30 22:05:22+00:00,['9b7fbe37437a21a9d18644d9b20b6e8e86a92ce4'],1,38,39,323089,2,,,,1089
48b8124e3289484193833049fde3fb4c584cd457,0,David Reiss,2010-08-30 22:05:23+00:00,['ee93398ccc61843239c24aabeafc8d4d7a6ec27e'],11,11,22,323111,2,,,,1089
1cb979b3d0a9163adf60dc08b311964af53dfa15,0,David Reiss,2010-08-30 22:05:25+00:00,['48b8124e3289484193833049fde3fb4c584cd457'],1,13,14,323125,3,,,,1089
480d5ab62b6fa320a0f098575020b3cae08a3f14,0,David Reiss,2010-08-30 22:05:26+00:00,['1cb979b3d0a9163adf60dc08b311964af53dfa15'],3,11,14,323139,2,,,,1089
eb207273ea3e1e7210092cfee2848b855d67feb1,0,David Reiss,2010-08-30 22:05:27+00:00,['480d5ab62b6fa320a0f098575020b3cae08a3f14'],2,2,4,323143,1,,,,1089
3f660a4266b675a0c9d1f7024dda827bd38c24b9,1,David Reiss,2010-08-30 22:05:29+00:00,['eb207273ea3e1e7210092cfee2848b855d67feb1'],547,166,713,323856,6,,,,1090
c465799c1b2e06c2fec8b756876b0c8bcc15b6ef,1,David Reiss,2010-08-30 22:05:31+00:00,['3f660a4266b675a0c9d1f7024dda827bd38c24b9'],76,81,157,324013,2,,,,1090
82862950f628943f768dac8e694e7f36a8bd5f24,1,David Reiss,2010-08-30 22:05:32+00:00,['c465799c1b2e06c2fec8b756876b0c8bcc15b6ef'],16,20,36,324049,1,,,,1090
6c1875340a027cafb77dcabfc45686bbf3de11cd,1,David Reiss,2010-08-30 22:05:33+00:00,['82862950f628943f768dac8e694e7f36a8bd5f24'],99,114,213,324262,1,,,,1090
63f6126e978e2a5e23c6abc91a9805ff8611f45a,0,David Reiss,2010-08-30 22:05:34+00:00,['6c1875340a027cafb77dcabfc45686bbf3de11cd'],149,164,313,324575,2,,,,1090
b9561c83f530915c1597cfa9b1c341e88c0971fc,0,David Reiss,2010-08-30 22:05:36+00:00,['63f6126e978e2a5e23c6abc91a9805ff8611f45a'],1,1,2,324577,1,,,,1090
4b0534a6626cb989edd8c57a228763fe4328cf19,0,David Reiss,2010-08-30 22:05:37+00:00,['b9561c83f530915c1597cfa9b1c341e88c0971fc'],7,1,8,324585,1,,,,1090
035979ff80e1e47c03eaa019a674239fef4f343f,1,David Reiss,2010-08-30 22:05:38+00:00,['4b0534a6626cb989edd8c57a228763fe4328cf19'],54,52,106,324691,3,,,,1090
2c8d228fa709120f17ce6bfd7b7c022561736a01,1,David Reiss,2010-08-30 22:05:39+00:00,['035979ff80e1e47c03eaa019a674239fef4f343f'],1,110,111,324802,2,,,,1091
a508b336db925fb1ee1523e9171a8a612b8aee84,1,David Reiss,2010-08-30 22:05:41+00:00,['2c8d228fa709120f17ce6bfd7b7c022561736a01'],7,58,65,324867,2,,,,1091
639e1cfe2b9eb6e9e852899adeeec8a41daeda81,1,David Reiss,2010-08-30 22:05:43+00:00,['a508b336db925fb1ee1523e9171a8a612b8aee84'],99,113,212,325079,11,,,,1091
9b170ebf104c45532c553f8447346cd43b37449c,0,David Reiss,2010-08-30 22:05:44+00:00,['639e1cfe2b9eb6e9e852899adeeec8a41daeda81'],2,133,135,325214,2,,,,1092
0127af242fecdd715bcf89d681bb876d0fa68094,0,David Reiss,2010-08-30 22:05:46+00:00,['9b170ebf104c45532c553f8447346cd43b37449c'],131,23,154,325368,1,,,,1092
bc1b3fdb77eac0e2d705a9d363d6f3062bb146ee,1,David Reiss,2010-08-30 22:05:47+00:00,['0127af242fecdd715bcf89d681bb876d0fa68094'],137,28,165,325533,1,,,,1092
f28f23d5b7fb08743c7a88b0f79cad69f604c013,0,David Reiss,2010-08-30 22:05:48+00:00,['bc1b3fdb77eac0e2d705a9d363d6f3062bb146ee'],9,9,18,325551,1,,,,1092
01c6d61ebdc4f8206c79695ea93ae9fc90d9bbc3,0,David Reiss,2010-08-30 22:05:49+00:00,['f28f23d5b7fb08743c7a88b0f79cad69f604c013'],9,11,20,325571,1,,,,1092
48539bc9602a6e3f11aa0652238ccf2584893407,0,David Reiss,2010-08-30 22:05:50+00:00,['01c6d61ebdc4f8206c79695ea93ae9fc90d9bbc3'],116,12,128,325699,1,,,,1092
3a292b444177a63fa127cfb32fae7188d6c8f17d,0,David Reiss,2010-08-30 22:05:51+00:00,['48539bc9602a6e3f11aa0652238ccf2584893407'],106,24,130,325829,1,,,,1092
a9c5283329d458a3c75f7285549e738167054d37,0,David Reiss,2010-08-30 22:05:53+00:00,['3a292b444177a63fa127cfb32fae7188d6c8f17d'],2,2,4,325833,2,,,,1092
cf7f3973bb025cdec3914e007e4d0cfe9a362614,0,David Reiss,2010-08-30 22:05:55+00:00,['a9c5283329d458a3c75f7285549e738167054d37'],16,16,32,325865,13,,,,1092
5ed313d998c3a5dc43c4bc9a22d2db57162bd28e,0,David Reiss,2010-08-30 22:05:57+00:00,['cf7f3973bb025cdec3914e007e4d0cfe9a362614'],8,6,14,325879,6,,,,1092
b4ab00847635ef74a8c03f6336e8378b5979c3e7,1,David Reiss,2010-08-30 22:05:58+00:00,['5ed313d998c3a5dc43c4bc9a22d2db57162bd28e'],2,21,23,325902,2,,,,1092
df2047e4b1682f5d8016523727308ce3e8a6f91c,0,David Reiss,2010-08-30 22:06:00+00:00,['b4ab00847635ef74a8c03f6336e8378b5979c3e7'],2,2,4,325906,1,,,,1092
c549f7b08622dd96060f9596bae3547d00b7db7c,1,David Reiss,2010-08-30 22:06:01+00:00,['df2047e4b1682f5d8016523727308ce3e8a6f91c'],2,5,7,325913,1,,,,1092
f4494ee3a9a4751e6537527bb7a46d2daba20bed,1,David Reiss,2010-08-30 22:06:03+00:00,['c549f7b08622dd96060f9596bae3547d00b7db7c'],11,11,22,325935,3,,,,1092
5f11084c060e1cfcb48285d4098fe416f9334fd6,0,David Reiss,2010-08-30 22:11:58+00:00,['f4494ee3a9a4751e6537527bb7a46d2daba20bed'],13,24,37,325972,1,,,,1092
618777d975d1e19d63b097db2d3817a701464044,0,David Reiss,2010-08-31 16:51:10+00:00,['5f11084c060e1cfcb48285d4098fe416f9334fd6'],6,12,18,325990,1,,,,1092
2b45589aa3ac0c9584b9c136a2f3aa09c82170fd,0,David Reiss,2010-08-31 16:51:11+00:00,['618777d975d1e19d63b097db2d3817a701464044'],2,0,2,325992,1,,,,1092
f9962c278dce08d24aaf4543e74bde195ed24b67,1,David Reiss,2010-08-31 16:51:12+00:00,['2b45589aa3ac0c9584b9c136a2f3aa09c82170fd'],0,14,14,326006,2,,,,1092
228596ce74cbf7cd6bfb0dc0690d45726849b3b8,0,David Reiss,2010-08-31 16:51:13+00:00,['f9962c278dce08d24aaf4543e74bde195ed24b67'],6,0,6,326012,1,,,,1092
f261dd795c4004c72c7efd66c4b09f66299bfc83,0,David Reiss,2010-08-31 16:51:14+00:00,['228596ce74cbf7cd6bfb0dc0690d45726849b3b8'],2,2,4,326016,2,,,,1092
351e22b52afcbe9b40e0933f80b06b479dff50f4,1,David Reiss,2010-08-31 16:51:19+00:00,['f261dd795c4004c72c7efd66c4b09f66299bfc83'],142,167,309,326325,21,,,,1093
5cc3ba83fd9c5563709f3c80a48f4820c82473f4,1,David Reiss,2010-08-31 16:51:20+00:00,['351e22b52afcbe9b40e0933f80b06b479dff50f4'],11,90,101,326426,2,,,,1093
ea4c9816fc5c4a67e0804d7f1f5afbb1fc5d7c9a,0,David Reiss,2010-08-31 16:51:21+00:00,['5cc3ba83fd9c5563709f3c80a48f4820c82473f4'],11,22,33,326459,2,,,,1093
dcc7e9b33343ab2ed07ec2fe46e670d7d5c193be,0,David Reiss,2010-08-31 16:51:22+00:00,['ea4c9816fc5c4a67e0804d7f1f5afbb1fc5d7c9a'],4,81,85,326544,2,,,,1094
bfab32a3b3937d413a38082b817c2829486ab52f,0,David Reiss,2010-08-31 16:51:24+00:00,['dcc7e9b33343ab2ed07ec2fe46e670d7d5c193be'],1,0,1,326545,1,,,,1094
38f89597798a911221839188864f5f90949e3416,0,David Reiss,2010-08-31 16:51:25+00:00,['bfab32a3b3937d413a38082b817c2829486ab52f'],5,13,18,326563,1,0,1,1,1094
aca320d3955c39ce7c05de16d748e103daf074a4,0,David Reiss,2010-08-31 16:51:26+00:00,['38f89597798a911221839188864f5f90949e3416'],4,8,12,326575,2,0.5,0.5,1,1094
ef5e81b1acdc6e0091c8bc9170bff1e83c7e990e,1,David Reiss,2010-08-31 16:51:28+00:00,['aca320d3955c39ce7c05de16d748e103daf074a4'],8,9,17,326592,3,,,,1094
4563acdd236da80f2cadc2ba548d05c10f5b2998,0,David Reiss,2010-08-31 16:51:29+00:00,['ef5e81b1acdc6e0091c8bc9170bff1e83c7e990e'],0,5,5,326597,1,,,,1094
5ad126044d56e0277c9ad31998777e04ae82eb42,0,David Reiss,2010-08-31 16:51:30+00:00,['4563acdd236da80f2cadc2ba548d05c10f5b2998'],0,2,2,326599,2,,,,1094
79db3e16ec7ce0a5323f2cc14b80142b1447f8ac,0,David Reiss,2010-08-31 16:51:31+00:00,['5ad126044d56e0277c9ad31998777e04ae82eb42'],1,3,4,326603,1,,,,1094
37b3df2c40b1ea37ef75cc58b7a635e9c6202870,1,David Reiss,2010-08-31 16:51:32+00:00,['79db3e16ec7ce0a5323f2cc14b80142b1447f8ac'],0,26,26,326629,1,,,,1095
9f3296bca00927ec5bac7ccdecdf2fbd68be9744,1,David Reiss,2010-08-31 16:58:41+00:00,['37b3df2c40b1ea37ef75cc58b7a635e9c6202870'],0,725,725,327354,15,0.720930233,1,0.850498339,1110
38104c8234d28249912eeda5d8b45534ba4faa74,0,David Reiss,2010-09-01 16:54:05+00:00,['9f3296bca00927ec5bac7ccdecdf2fbd68be9744'],1,1,2,327356,1,,,,1110
0f4078dbf5ed39beeacd509f1fab8fcb17d4c44a,1,Bryan Duxbury,2010-09-02 00:07:20+00:00,['38104c8234d28249912eeda5d8b45534ba4faa74'],0,94,94,327450,1,0.341772152,0.101265823,0.797468354,1110
cd9f200b9de57f08f3d4f0b7acb995227ab157cd,1,Bryan Duxbury,2010-09-02 00:12:22+00:00,['0f4078dbf5ed39beeacd509f1fab8fcb17d4c44a'],3,9,12,327462,1,0,0,1,1110
a55f51d8709582e1d054844c17c554e8d124b394,0,Bryan Duxbury,2010-09-02 00:24:50+00:00,['cd9f200b9de57f08f3d4f0b7acb995227ab157cd'],4,2,6,327468,1,,,,1110
e02d6118bfe00f74fec801efcb677ef17dfe928e,0,Bryan Duxbury,2010-09-02 00:29:08+00:00,['a55f51d8709582e1d054844c17c554e8d124b394'],19,0,19,327487,1,0.7,0.7,0.7,1110
686d92ce66c100e8fc9671ea8a021aca21adc5cf,0,Bryan Duxbury,2010-09-02 00:36:18+00:00,['e02d6118bfe00f74fec801efcb677ef17dfe928e'],5,5,10,327497,1,,,,1110
773b8dbf301442372d4f7b3a84ee150e034047e6,1,Bryan Duxbury,2010-09-02 00:43:16+00:00,['686d92ce66c100e8fc9671ea8a021aca21adc5cf'],1,8,9,327506,1,0.571428571,0.571428571,1,1110
ee8255d0867da74510574afe634c692603c7d7aa,0,Bryan Duxbury,2010-09-02 00:52:46+00:00,['773b8dbf301442372d4f7b3a84ee150e034047e6'],4,4,8,327514,1,,,,1110
010f1e09d09d7a5169b3468399928b6e807aab29,0,Bryan Duxbury,2010-09-02 00:56:53+00:00,['ee8255d0867da74510574afe634c692603c7d7aa'],13,10,23,327537,3,1,1,0,1110
727d67dcfad44784b1ef552d4744f739a8fe7d3c,1,Bryan Duxbury,2010-09-02 01:00:19+00:00,['010f1e09d09d7a5169b3468399928b6e807aab29'],0,8,8,327545,2,0,0,0.75,1110
7112c0712e0156fe227cf3dabf2cec6f80763d33,0,Anthony F. Molinaro,2010-09-02 05:09:05+00:00,['727d67dcfad44784b1ef552d4744f739a8fe7d3c'],1,1,2,327547,1,,,,1110
1316ed9d1644234106035d76f48d6362c41bf914,0,Bryan Duxbury,2010-09-02 14:20:01+00:00,['7112c0712e0156fe227cf3dabf2cec6f80763d33'],9,10,19,327566,2,,0,0,1110
c43ec6247af8c67f4e14e8e2bab40b46baf03fce,1,Bryan Duxbury,2010-09-02 14:58:51+00:00,['1316ed9d1644234106035d76f48d6362c41bf914'],23,28,51,327617,1,1,1,0,1110
472eb3c94ce44b32ed2a6d73bd0d3b2786e928f7,0,Bryan Duxbury,2010-09-02 15:02:06+00:00,['c43ec6247af8c67f4e14e8e2bab40b46baf03fce'],1,0,1,327618,1,,,,1110
f2ef59ffbf7819d7e89e73ba78c5900778cbe293,0,Bryan Duxbury,2010-09-02 15:12:06+00:00,['472eb3c94ce44b32ed2a6d73bd0d3b2786e928f7'],2,6,8,327626,1,1,1,0,1110
d6a02ff99bcee734d5335c91f5ada41d7322ecb4,1,Bryan Duxbury,2010-09-02 15:14:27+00:00,['f2ef59ffbf7819d7e89e73ba78c5900778cbe293'],2,5,7,327633,1,1,1,0.666666667,1110
383e9495667afbd686beb89bb510433fdd4cfe82,1,Bryan Duxbury,2010-09-02 15:16:56+00:00,['d6a02ff99bcee734d5335c91f5ada41d7322ecb4'],0,1,1,327634,1,1,1,1,1110
8ede81860c5b6c93645c62e871c213b4188e7162,1,David Reiss,2010-09-02 15:26:28+00:00,['383e9495667afbd686beb89bb510433fdd4cfe82'],1,24,25,327659,2,1,1,1,1110
c564fa569289240fb210c245b2b1125d759b93e1,0,David Reiss,2010-09-02 15:36:00+00:00,['8ede81860c5b6c93645c62e871c213b4188e7162'],5,10,15,327674,1,1,1,0,1110
a9ca25a81ec3d5a82c03ca31e2cfad3c4b87c674,1,David Reiss,2010-09-02 15:36:03+00:00,['c564fa569289240fb210c245b2b1125d759b93e1'],7,23,30,327704,1,0,1,1,1110
c377c32168de2c9fdc73e9c29d8ed2425e1d8395,1,Bryan Duxbury,2010-09-02 15:37:19+00:00,['a9ca25a81ec3d5a82c03ca31e2cfad3c4b87c674'],1,28,29,327733,1,0,1,1,1110
f723e8d5b59bc5322663431e82c75ccace59287a,0,Bryan Duxbury,2010-09-02 16:33:42+00:00,['c377c32168de2c9fdc73e9c29d8ed2425e1d8395'],0,0,0,327733,0,,,,1110
fb790d726297cfa85900db00214fc0f3a9d029e6,1,David Reiss,2010-09-02 16:41:45+00:00,['f723e8d5b59bc5322663431e82c75ccace59287a'],4,18,22,327755,4,1,1,1,1110
7a0825c34da505371aaaded74565108fa01f526c,0,Bryan Duxbury,2010-09-02 16:42:18+00:00,['fb790d726297cfa85900db00214fc0f3a9d029e6'],0,1,1,327756,1,,,,1110
bbff4a8e7e2a4280462d649f1ac794e2283f074a,0,Bryan Duxbury,2010-09-03 20:36:02+00:00,['7a0825c34da505371aaaded74565108fa01f526c'],18,20,38,327794,1,0,0,1,1110
6a37b4d55ecb9414ddd905ee3c7227274f208442,1,Anthony F. Molinaro,2010-09-07 03:25:02+00:00,['bbff4a8e7e2a4280462d649f1ac794e2283f074a'],1,27,28,327822,1,,,,1110
ef16420d54485fbc5310a3a1f4902e25032c652d,0,Anthony F. Molinaro,2010-09-07 03:35:30+00:00,['6a37b4d55ecb9414ddd905ee3c7227274f208442'],544,30,574,328396,14,,,,1110
d4837129729c85d49476cae08fb0c5ec84a2a811,1,Bryan Duxbury,2010-09-08 00:06:35+00:00,['ef16420d54485fbc5310a3a1f4902e25032c652d'],11,1232,1243,329639,8,0.536817102,0.90023753,0.828978622,1116
855294b21340b01d145bcbee438a6817c127a32e,1,Bryan Duxbury,2010-09-08 21:47:45+00:00,['d4837129729c85d49476cae08fb0c5ec84a2a811'],169,239,408,330047,6,1,0.862068966,0.862068966,1116
34628f3e7ae6f69bad0ce31af0e7008873839bd6,1,Bryan Duxbury,2010-09-10 16:16:01+00:00,['855294b21340b01d145bcbee438a6817c127a32e'],17,32,49,330096,1,1,1,0,1116
04650afb872fbf62dc31426d7278261bf178fc4f,1,Bryan Duxbury,2010-09-10 18:49:53+00:00,['34628f3e7ae6f69bad0ce31af0e7008873839bd6'],1,1,2,330098,1,,,,1116
13ad873d1815da49cf17f7a52c98895bfde011e1,0,Bryan Duxbury,2010-09-10 19:08:00+00:00,['04650afb872fbf62dc31426d7278261bf178fc4f'],16,21,37,330135,2,0.333333333,0.333333333,0,1116
b6c50e56583d503ab7dcc843d4e09d99f8010ef3,0,David Reiss,2010-09-10 23:00:40+00:00,['13ad873d1815da49cf17f7a52c98895bfde011e1'],5,30,35,330170,1,0.133333333,0,0.666666667,1116
9f0a786dad1d6d0d737b89f96ba7ec90bf9096e2,1,Bryan Duxbury,2010-09-12 14:38:36+00:00,['b6c50e56583d503ab7dcc843d4e09d99f8010ef3'],7,25,32,330202,3,0,0,0,1116
cb0218f5c8fcc5e14016ea97f9cfc51009472246,0,Bryan Duxbury,2010-09-12 15:22:21+00:00,['9f0a786dad1d6d0d737b89f96ba7ec90bf9096e2'],1,1,2,330204,1,,,,1116
6e05e25c8977953a46251f5abfaf111a3ae9607b,0,Bryan Duxbury,2010-09-12 15:22:49+00:00,['cb0218f5c8fcc5e14016ea97f9cfc51009472246'],3,3,6,330210,1,,,,1116
76ecb91c3d7034c939d6df9316f571cbf9f7ce09,1,Bryan Duxbury,2010-09-12 15:29:38+00:00,['6e05e25c8977953a46251f5abfaf111a3ae9607b'],1,1,2,330212,1,,,,1116
a97414674c2afb52331662d8603bd9133aae7f9a,0,Bryan Duxbury,2010-09-12 15:30:06+00:00,['76ecb91c3d7034c939d6df9316f571cbf9f7ce09'],1,1,2,330214,1,,,,1116
a4c6d64e80e3d7f598ad97d213e83d66b7063a83,0,Bryan Duxbury,2010-09-12 15:31:50+00:00,['a97414674c2afb52331662d8603bd9133aae7f9a'],1,1,2,330216,1,,,,1116
a7420b6593998776871d55cbf415a0531c76a012,1,Bryan Duxbury,2010-09-13 15:42:36+00:00,['a4c6d64e80e3d7f598ad97d213e83d66b7063a83'],11,80,91,330307,4,0.606557377,0.606557377,0.852459016,1116
d4235e0a47bde7a2fdbc9fc73dc6ca7231992278,0,Bryan Duxbury,2010-09-13 16:28:53+00:00,['a7420b6593998776871d55cbf415a0531c76a012'],0,2,2,330309,2,0,1,1,1116
8d7667c27f1b116386d7970a130439f02ac4491d,0,David Reiss,2010-09-13 17:32:13+00:00,['d4235e0a47bde7a2fdbc9fc73dc6ca7231992278'],0,5,5,330314,1,0,1,1,1116
bdd6261b3336cbb7f3df2829e0c001f6591bb224,0,David Reiss,2010-09-13 17:32:14+00:00,['8d7667c27f1b116386d7970a130439f02ac4491d'],2,7,9,330323,1,0,1,1,1116
d920765c66472d0011a7c6b3c8ce612317fa3801,1,Bryan Duxbury,2010-09-17 19:27:36+00:00,['bdd6261b3336cbb7f3df2829e0c001f6591bb224'],9,57,66,330389,3,0.487804878,1,1,1116
83c47958707956a8812b2c5c91a4550f874cb055,0,Bryan Duxbury,2010-09-17 20:17:21+00:00,['d920765c66472d0011a7c6b3c8ce612317fa3801'],6,7,13,330402,2,0,0,1,1116
416eea9802d16645d4f4da8909abee5b4b51d95e,0,T Jake Luciani,2010-09-17 23:38:25+00:00,['83c47958707956a8812b2c5c91a4550f874cb055'],6,39,45,330447,1,0.416666667,0.416666667,0.25,1116
fd32d79afa6a728b6dc320c5e0eda108b0622f98,1,Bryan Duxbury,2010-09-18 20:51:25+00:00,['416eea9802d16645d4f4da8909abee5b4b51d95e'],2,1182,1184,331631,7,0.50625,0.68625,0.94,1118
e59a80fbf9d3be9eab5353355718fbd495fad0f1,0,Bryan Duxbury,2010-09-20 15:21:37+00:00,['fd32d79afa6a728b6dc320c5e0eda108b0622f98'],21,56,77,331708,8,0.4,0.7,1,1118
f38b2f10fb83284c9a449e9aec82fc2a10cba81e,0,Bryan Duxbury,2010-09-20 17:41:40+00:00,['e59a80fbf9d3be9eab5353355718fbd495fad0f1'],1,1,2,331710,1,,,,1118
1237dcb099a068f83f31cc51df428f5c828d0511,1,Bryan Duxbury,2010-09-20 17:49:09+00:00,['f38b2f10fb83284c9a449e9aec82fc2a10cba81e'],0,6491,6491,338201,41,0.303285839,0.523407967,0.708927014,1157
6a1fb17a25ce7b52b7c5e396adf86ceb96606d64,0,Bryan Duxbury,2010-09-21 16:30:58+00:00,['1237dcb099a068f83f31cc51df428f5c828d0511'],8,19,27,338228,2,0.875,1,1,1157
61934780c6fd534015fdd568e85e8ee8d5b07dbe,0,Todd Lipcon,2010-09-21 18:01:43+00:00,['6a1fb17a25ce7b52b7c5e396adf86ceb96606d64'],4,8,12,338240,2,,,,1157
f9e3c3b140f046bf726c79db77a2a02cdc452e9b,0,David Reiss,2010-09-21 18:35:43+00:00,['61934780c6fd534015fdd568e85e8ee8d5b07dbe'],0,27,27,338267,1,,,,1157
75a33e858fdeb2171a4ee973ee2e53d39e891d27,1,Bryan Duxbury,2010-09-22 00:48:56+00:00,['f9e3c3b140f046bf726c79db77a2a02cdc452e9b'],52,71,123,338390,4,0,0,1,1157
6461d56d025893581fd9b06487b7c4788af3c0ed,1,T Jake Luciani,2010-09-22 02:33:06+00:00,['75a33e858fdeb2171a4ee973ee2e53d39e891d27'],5,7,12,338402,1,0,0,1,1157
7466bcd5d7244c464a337816f760fd50c362e5be,1,Anthony F. Molinaro,2010-09-23 22:28:09+00:00,['6461d56d025893581fd9b06487b7c4788af3c0ed'],24,23,47,338449,2,,,,1157
96b2ccc0d4c9b19530d5dbd81643cff1ad6fb6c0,1,Bryan Duxbury,2010-09-24 16:47:59+00:00,['7466bcd5d7244c464a337816f760fd50c362e5be'],122,447,569,339018,7,,,,1162
d7a6e5dfc9616eb622bde53229f707a6f23589a3,0,Anthony F. Molinaro,2010-09-26 04:20:23+00:00,['96b2ccc0d4c9b19530d5dbd81643cff1ad6fb6c0'],0,0,0,339018,0,,,,1162
0ee555b43d785cbe9eb44421655c3783483391b7,0,Anthony F. Molinaro,2010-09-26 04:21:08+00:00,['d7a6e5dfc9616eb622bde53229f707a6f23589a3'],0,0,0,339018,0,,,,1162
7404f2a72ffa3ec4495625f6eebc9a3735efd56b,0,Anthony F. Molinaro,2010-09-26 04:22:24+00:00,['0ee555b43d785cbe9eb44421655c3783483391b7'],0,0,0,339018,0,,,,1162
daef1c8ed02102936655b9101a30cc8737a9eb15,0,Anthony F. Molinaro,2010-09-26 04:25:36+00:00,['7404f2a72ffa3ec4495625f6eebc9a3735efd56b'],26,26,52,339070,3,,,,1162
0b4936dea5684d3b071d586492458e80c4e60a9f,0,Anthony F. Molinaro,2010-09-27 04:43:39+00:00,['daef1c8ed02102936655b9101a30cc8737a9eb15'],0,1,1,339071,1,,,,1162
3a3686fd51aaed9153a2d3f7299785753ba8e315,0,Bryan Duxbury,2010-09-27 17:12:36+00:00,['0b4936dea5684d3b071d586492458e80c4e60a9f'],9,24,33,339104,2,1,1,1,1162
a5df7c7b0ef66819f56039f95f6d8b40a3197d8d,1,Anthony F. Molinaro,2010-09-27 17:22:17+00:00,['3a3686fd51aaed9153a2d3f7299785753ba8e315'],1,68,69,339173,3,,,,1163
833ae492902c08ab13ebc4efa73adef0a4936dff,1,Bryan Duxbury,2010-09-27 17:26:02+00:00,['a5df7c7b0ef66819f56039f95f6d8b40a3197d8d'],36,36,72,339245,5,,,,1163
abafd79aeede6c1f20632e41ff6e80d99e6fe479,1,David Reiss,2010-09-27 17:28:15+00:00,['833ae492902c08ab13ebc4efa73adef0a4936dff'],8,389,397,339642,3,0.914285714,1,0.820408163,1164
fa6eaca7623c90a23adf088ee20f125cf7b2c388,0,Anthony F. Molinaro,2010-09-27 17:33:47+00:00,['abafd79aeede6c1f20632e41ff6e80d99e6fe479'],16,23,39,339681,1,,,,1164
515c2381b71cf997c17a70c144bfc622a388c6a0,1,Todd Lipcon,2010-09-27 18:26:07+00:00,['fa6eaca7623c90a23adf088ee20f125cf7b2c388'],12,27,39,339720,5,,,,1164
71a58a87648c03309d00d959af74ca45c7700cfd,1,Anthony F. Molinaro,2010-09-27 19:27:40+00:00,['515c2381b71cf997c17a70c144bfc622a388c6a0'],134,581,715,340435,12,1,1,1,1170
a406b90fa27221119baf09625345487de26db0a7,1,Bryan Duxbury,2010-09-27 23:37:44+00:00,['71a58a87648c03309d00d959af74ca45c7700cfd'],191,45,236,340671,15,1,1,0,1170
fcaa8f5364931155ba5675db7a02d898abf07998,0,Todd Lipcon,2010-09-27 23:51:22+00:00,['a406b90fa27221119baf09625345487de26db0a7'],6,14,20,340691,2,,,,1170
4abfb288ab76b2291b49e4f9439107c3bcb26d7a,0,Todd Lipcon,2010-09-28 00:01:31+00:00,['fcaa8f5364931155ba5675db7a02d898abf07998'],0,29,29,340720,1,,,,1171
84a7c2a901ee11433ca755edad1c278172ba7644,1,Todd Lipcon,2010-09-28 00:02:53+00:00,['4abfb288ab76b2291b49e4f9439107c3bcb26d7a'],0,6,6,340726,1,,,,1172
b1a283f11e50650acc1b0730200b17bf8c5fac07,1,Todd Lipcon,2010-09-28 00:11:01+00:00,['84a7c2a901ee11433ca755edad1c278172ba7644'],143,397,540,341266,5,0.819277108,0.753012048,0.813253012,1172
ca67b899594004966f002a82ff126e0916f133d4,0,David Reiss,2010-09-28 03:30:17+00:00,['b1a283f11e50650acc1b0730200b17bf8c5fac07'],1,1,2,341268,1,,,,1172
a18364ac88b035e9433a0238b8fbe75285aa04f3,1,Bryan Duxbury,2010-09-28 14:36:07+00:00,['ca67b899594004966f002a82ff126e0916f133d4'],18,146,164,341432,4,0.489361702,0.489361702,1,1172
f0755e95c7f69d48cc994b80c02b940d9878a386,1,Bryan Duxbury,2010-09-28 15:06:38+00:00,['a18364ac88b035e9433a0238b8fbe75285aa04f3'],0,90,90,341522,1,,,,1172
51099cca62c3fbe6c75a22cb49b78ace48f599d7,0,Bryan Duxbury,2010-09-28 16:06:42+00:00,['f0755e95c7f69d48cc994b80c02b940d9878a386'],0,0,0,341522,0,,,,1172
0b483e11ef179c1480b3e61039f62cb72d82e9b3,0,Bryan Duxbury,2010-09-28 17:38:19+00:00,['51099cca62c3fbe6c75a22cb49b78ace48f599d7'],2,2,4,341526,2,,,,1172
e1ae6b45d556dc6e92aeaaa855206be807fbe8a3,1,Bryan Duxbury,2010-09-28 17:44:45+00:00,['f0755e95c7f69d48cc994b80c02b940d9878a386'],2,2,4,341530,2,,,,1172
5bb525ccf938e3b183814f92097a96bb85941e07,0,Bryan Duxbury,2010-09-30 19:36:05+00:00,['e1ae6b45d556dc6e92aeaaa855206be807fbe8a3'],0,11,11,341541,2,0.875,1,1,1172
7f7795d0d2a025d4f75d4ae348bbc59600d9345f,0,Bryan Duxbury,2010-09-30 19:37:01+00:00,['0b483e11ef179c1480b3e61039f62cb72d82e9b3'],0,11,11,341552,2,0.875,1,1,1172
8a441a46ad56b6f1f9d15ecadcc604a8b4c27c59,1,Roger Meier,2010-10-04 21:13:36+00:00,['5bb525ccf938e3b183814f92097a96bb85941e07'],1,1,2,341554,1,,,,1172
653eadab2fd65051d36b117237ba0a91596cb8bf,0,David Reiss,2010-10-05 02:38:58+00:00,['8a441a46ad56b6f1f9d15ecadcc604a8b4c27c59'],2,4,6,341560,3,,,,1172
3e07a8f23371ae9a96c55b4d81c31c9c57ace92b,0,David Reiss,2010-10-05 02:38:59+00:00,['653eadab2fd65051d36b117237ba0a91596cb8bf'],7,1,8,341568,1,,,,1172
9e7ba8cbacd5d09eb2af4c76eb82f7df5e0b8739,1,David Reiss,2010-10-05 16:39:27+00:00,['3e07a8f23371ae9a96c55b4d81c31c9c57ace92b'],10,13,23,341591,3,,,,1173
41d3058dbf45d3e771192052f1f15ba1b6daf5d3,0,David Reiss,2010-10-05 16:39:29+00:00,['9e7ba8cbacd5d09eb2af4c76eb82f7df5e0b8739'],8,18,26,341617,4,0.8,0.8,1,1173
ddcf32ab9cb342de899f6c572b5ecb64be2a8fb1,1,Anthony F. Molinaro,2010-10-05 16:45:50+00:00,['41d3058dbf45d3e771192052f1f15ba1b6daf5d3'],2,9,11,341628,1,,,,1173
687c412c10cba2013fce0984dab18bb9aa49e8d9,0,Anthony F. Molinaro,2010-10-05 16:47:52+00:00,['ddcf32ab9cb342de899f6c572b5ecb64be2a8fb1'],1,1,2,341630,1,,,,1173
371372e83284a767354cf7f30a545cd0ec26d6b4,1,Anthony F. Molinaro,2010-10-05 17:08:08+00:00,['687c412c10cba2013fce0984dab18bb9aa49e8d9'],5,212,217,341847,2,,,,1174
ffca7e17202bc045f6a5ac3489c9f6a5e3b61d4c,0,Bryan Duxbury,2010-10-06 00:01:43+00:00,['371372e83284a767354cf7f30a545cd0ec26d6b4'],1,1,2,341849,1,,,,1174
c657447e0edd882ffc6144ca81c1f1d3cccae048,1,Bryan Duxbury,2010-10-06 00:12:33+00:00,['ffca7e17202bc045f6a5ac3489c9f6a5e3b61d4c'],564,602,1166,343015,16,,,,1179
ded25bbe0d82ce151c633addd3b96d5c3e0c4dc1,1,Bryan Duxbury,2010-10-06 00:23:30+00:00,['c657447e0edd882ffc6144ca81c1f1d3cccae048'],12,27,39,343054,1,0,1,0,1179
1df96ce22fcfa3cbc2700eb4be29e5d457167d15,1,Bryan Duxbury,2010-10-06 00:28:10+00:00,['ded25bbe0d82ce151c633addd3b96d5c3e0c4dc1'],3,30,33,343087,3,0.933333333,0.933333333,1,1180
8c535ab87c3eaa35f1c94ca9dd1aeb5930425c3b,0,David Reiss,2010-10-06 17:09:31+00:00,['1df96ce22fcfa3cbc2700eb4be29e5d457167d15'],67,85,152,343239,1,1,1,1,1180
d7192063e141c8374c2256e9fea9b7571e5fc71e,0,David Reiss,2010-10-06 17:09:33+00:00,['8c535ab87c3eaa35f1c94ca9dd1aeb5930425c3b'],12,155,167,343406,3,0.5375,0.5375,0.9625,1180
5ddabb8e3f63a15874e436c9a650dc17f7dd7028,1,David Reiss,2010-10-06 17:09:37+00:00,['d7192063e141c8374c2256e9fea9b7571e5fc71e'],353,1830,2183,345589,20,0.285714286,0.284194529,0.398176292,1195
18cd0f03340c3eeead9b691e0d9b8a055035eec2,0,David Reiss,2010-10-06 17:09:39+00:00,['5ddabb8e3f63a15874e436c9a650dc17f7dd7028'],31,99,130,345719,3,0.340425532,0.340425532,0.29787234,1195
ef7200f6e825db54edfa4736192446c96b2ae1d4,1,David Reiss,2010-10-06 17:09:42+00:00,['18cd0f03340c3eeead9b691e0d9b8a055035eec2'],24,53,77,345796,10,1,1,0.5,1195
f62126dbb30f1d9ec9a8744206c598016d366e7a,0,David Reiss,2010-10-06 17:09:43+00:00,['ef7200f6e825db54edfa4736192446c96b2ae1d4'],22,23,45,345841,1,0,0,0,1195
c6b4cab89c6da0272914a07b1f01491031df524f,1,David Reiss,2010-10-06 17:09:45+00:00,['f62126dbb30f1d9ec9a8744206c598016d366e7a'],11,82,93,345934,1,0,0.03030303,0.96969697,1195
ea051ca793bfe68b554d4dd39b48cc237cae53d9,0,David Reiss,2010-10-06 17:09:46+00:00,['c6b4cab89c6da0272914a07b1f01491031df524f'],1,13,14,345948,2,0,0,1,1195
72fd0b415f7fe4f84988b52346b380f17b528c90,0,David Reiss,2010-10-06 17:09:47+00:00,['ea051ca793bfe68b554d4dd39b48cc237cae53d9'],13,35,48,345996,2,1,1,0,1195
e879c2f4db4bc0b7e5a0edfdf669c4fa477123a0,1,David Reiss,2010-10-06 17:09:50+00:00,['72fd0b415f7fe4f84988b52346b380f17b528c90'],20,279,299,346295,12,1,1,1,1196
6806fb836a6a846ae450f06a22deef1e59c2a983,1,David Reiss,2010-10-06 17:09:52+00:00,['e879c2f4db4bc0b7e5a0edfdf669c4fa477123a0'],541,960,1501,347796,11,1,1,0.795031056,1197
e71115be6caa2f3afd6fa092a09fd41c2c355691,1,David Reiss,2010-10-06 17:09:56+00:00,['6806fb836a6a846ae450f06a22deef1e59c2a983'],623,889,1512,349308,14,0.235849057,0.141509434,0.433962264,1199
8dfc732af635d5243194b74d4f411a551ff9a5ee,0,David Reiss,2010-10-06 17:09:58+00:00,['e71115be6caa2f3afd6fa092a09fd41c2c355691'],5,47,52,349360,7,1,1,1,1199
b7762a032aa4190c6b99a5394e69b29aceb57281,1,David Reiss,2010-10-06 17:10:00+00:00,['8dfc732af635d5243194b74d4f411a551ff9a5ee'],254,712,966,350326,5,0,0,0.62295082,1199
23248713345e36d8ed66704a9a58a5f39a48d942,1,David Reiss,2010-10-06 17:10:08+00:00,['b7762a032aa4190c6b99a5394e69b29aceb57281'],67,699,766,351092,17,0.438931298,0.893129771,0.583969466,1201
c3b3622158009ea9db85607a4901d05c63108875,1,David Reiss,2010-10-06 17:10:10+00:00,['23248713345e36d8ed66704a9a58a5f39a48d942'],18,815,833,351925,5,0.559405941,0.685643564,0.618811881,1203
a8af11dde6194e7449388148ed573347895b9229,0,David Reiss,2010-10-06 17:10:11+00:00,['c3b3622158009ea9db85607a4901d05c63108875'],1,1,2,351927,1,,,,1203
64637511d2c987dc0df9d8466e7ce3626d005425,0,David Reiss,2010-10-06 17:10:13+00:00,['a8af11dde6194e7449388148ed573347895b9229'],1,1,2,351929,1,,,,1203
44ff76f5147010694187e6ae95a3978fd7a71fb2,1,David Reiss,2010-10-06 17:10:15+00:00,['64637511d2c987dc0df9d8466e7ce3626d005425'],21,91,112,352041,2,0.384615385,1,0.230769231,1203
67f56ec6ab7a89c72d607efe620f85a885fc088e,0,David Reiss,2010-10-06 17:10:16+00:00,['44ff76f5147010694187e6ae95a3978fd7a71fb2'],8,0,8,352049,1,,,,1203
105961de04cf064981b70e8ec8458c196e0ee17e,1,David Reiss,2010-10-06 17:10:17+00:00,['67f56ec6ab7a89c72d607efe620f85a885fc088e'],91,184,275,352324,4,0.692307692,0.846153846,0.538461538,1203
35dc7695a95e4e0c3e311faca5341a2e365b9ea0,1,David Reiss,2010-10-06 17:10:19+00:00,['105961de04cf064981b70e8ec8458c196e0ee17e'],0,593,593,352917,2,0.416356877,0.609665428,0.695167286,1204
56cb796bcecb1e2fef8ab23d8f3f60418502ba10,0,David Reiss,2010-10-06 17:10:20+00:00,['35dc7695a95e4e0c3e311faca5341a2e365b9ea0'],8,21,29,352946,1,0,0,1,1204
3cc9dab229951aecf59cd229a45007013cb57fba,1,David Reiss,2010-10-06 17:10:21+00:00,['56cb796bcecb1e2fef8ab23d8f3f60418502ba10'],19,90,109,353055,1,0.375,1,1,1204
9a961e7750bd9d0393802df4d7a3bb6996a3339b,1,David Reiss,2010-10-06 17:10:23+00:00,['3cc9dab229951aecf59cd229a45007013cb57fba'],162,240,402,353457,2,0.872340426,1,0,1204
f2abcf9a563849dc5861be8aa38f764525c072b1,0,David Reiss,2010-10-06 17:10:24+00:00,['9a961e7750bd9d0393802df4d7a3bb6996a3339b'],143,77,220,353677,1,0,1,0.625,1204
e94fa3391db1a423b6964b0aa6499324d05b055b,1,David Reiss,2010-10-06 17:10:26+00:00,['f2abcf9a563849dc5861be8aa38f764525c072b1'],21,184,205,353882,5,0.235955056,0.831460674,0.820224719,1204
a0e11597163def6727896a77490899681c1eb6d6,0,David Reiss,2010-10-06 17:10:27+00:00,['e94fa3391db1a423b6964b0aa6499324d05b055b'],63,117,180,354062,4,0,1,1,1204
0e0eb354527cecdc22d1c0e6ecba06d7f747e728,0,David Reiss,2010-10-06 17:10:29+00:00,['a0e11597163def6727896a77490899681c1eb6d6'],13,17,30,354092,1,0,1,1,1204
709b69f14c7c69b83e1752212bf51b4da67db834,1,David Reiss,2010-10-06 17:10:30+00:00,['0e0eb354527cecdc22d1c0e6ecba06d7f747e728'],11,366,377,354469,3,0.449704142,0.656804734,0.769230769,1205
4199377a7c5dbb72679abe9c05c9663e3736a780,1,David Reiss,2010-10-06 17:10:31+00:00,['709b69f14c7c69b83e1752212bf51b4da67db834'],3,23,26,354495,1,0,1,0.8,1205
4f9efdb460a7c54cc55b25f2c6b8955a5fcff229,1,David Reiss,2010-10-06 17:10:33+00:00,['4199377a7c5dbb72679abe9c05c9663e3736a780'],32,109,141,354636,4,0.447368421,0.447368421,1,1205
65e62d3741e226abf0caf7b7393845ad41779a61,1,David Reiss,2010-10-06 17:10:35+00:00,['4f9efdb460a7c54cc55b25f2c6b8955a5fcff229'],49,83,132,354768,1,0,0,0.95,1205
0c025e8f52096f6c9f39b80909b5b1aebf335b03,1,David Reiss,2010-10-06 17:10:36+00:00,['65e62d3741e226abf0caf7b7393845ad41779a61'],12,84,96,354864,1,0.32,1,1,1205
d4788dfd4ae1bd04a78dc611855f70eb97355af3,0,David Reiss,2010-10-06 17:10:37+00:00,['0c025e8f52096f6c9f39b80909b5b1aebf335b03'],108,88,196,355060,1,0,0,0,1205
e5c435cccf4fdc5650c6127563b3b61de65e1762,1,David Reiss,2010-10-06 17:10:38+00:00,['d4788dfd4ae1bd04a78dc611855f70eb97355af3'],29,300,329,355389,1,0.594936709,1,0.829113924,1205
0a2d81e81614a73590056b4fea7688463df7c80b,1,David Reiss,2010-10-06 17:10:40+00:00,['e5c435cccf4fdc5650c6127563b3b61de65e1762'],61,139,200,355589,6,0,0,0.973684211,1205
109693c82a63b321b540cb3c993d918fc946dfbe,0,David Reiss,2010-10-06 17:10:42+00:00,['0a2d81e81614a73590056b4fea7688463df7c80b'],20,17,37,355626,3,0,0,0,1205
7197efb8490afebc97625de2b8a4dfcf61fe6d19,0,David Reiss,2010-10-06 17:10:43+00:00,['109693c82a63b321b540cb3c993d918fc946dfbe'],59,2,61,355687,3,1,0.657894737,0.052631579,1205
54bec5dbd8f91305d2cd1d1f1125cf8b54fdd6bc,0,David Reiss,2010-10-06 17:10:45+00:00,['7197efb8490afebc97625de2b8a4dfcf61fe6d19'],26,149,175,355862,2,0.575,0.4,0.85,1205
ece1a089eccad21f093de72b5fe6d730d132812c,1,David Reiss,2010-10-06 17:10:46+00:00,['54bec5dbd8f91305d2cd1d1f1125cf8b54fdd6bc'],5,6,11,355873,1,0,0,1,1205
2991a0f376ab7640b7259ac8db0af820054998cd,0,David Reiss,2010-10-06 17:10:47+00:00,['ece1a089eccad21f093de72b5fe6d730d132812c'],3,5,8,355881,1,1,1,1,1205
f673509f1be499bc899e204ab0d7837ebf4f418a,1,David Reiss,2010-10-06 17:10:49+00:00,['2991a0f376ab7640b7259ac8db0af820054998cd'],7,21,28,355909,7,0,0.8,0.6,1205
7e729d207492f8b4be9509e927b687a282039bc9,1,David Reiss,2010-10-06 17:10:51+00:00,['f673509f1be499bc899e204ab0d7837ebf4f418a'],0,9,9,355918,1,1,1,1,1205
89a12942d2fd53a3caf269f601134bd392fbf333,1,David Reiss,2010-10-06 17:10:52+00:00,['7e729d207492f8b4be9509e927b687a282039bc9'],56,114,170,356088,2,0,0.666666667,1,1205
46e4f252dcc09b40f71635aaeb80476635aa8076,0,David Reiss,2010-10-06 17:10:53+00:00,['89a12942d2fd53a3caf269f601134bd392fbf333'],6,6,12,356100,1,,,,1205
25df8e7e4ae6bd889a76d1ffacc5ec64da241223,1,David Reiss,2010-10-06 17:10:54+00:00,['46e4f252dcc09b40f71635aaeb80476635aa8076'],31,57,88,356188,1,0,0,1,1205
ef6a1766ceeddac8345aa3102e4d33af4ecd8432,0,David Reiss,2010-10-06 17:10:55+00:00,['25df8e7e4ae6bd889a76d1ffacc5ec64da241223'],4,28,32,356220,1,0.9375,1,1,1205
b3d0aa0c82ea5769b2a5dc7268e05c398d361726,1,Bryan Duxbury,2010-10-06 20:00:03+00:00,['ef6a1766ceeddac8345aa3102e4d33af4ecd8432'],3,22,25,356245,4,0.533333333,0.866666667,1,1205
f969bcb7d89f3f50dba4528a673464f668fb2905,1,Bryan Duxbury,2010-10-06 20:04:40+00:00,['b3d0aa0c82ea5769b2a5dc7268e05c398d361726'],245,290,535,356780,6,1,1,1,1205
50e4349463c983aac50d37a071191391f704258a,1,Roger Meier,2010-10-08 17:46:06+00:00,['f969bcb7d89f3f50dba4528a673464f668fb2905'],0,220,220,357000,5,1,1,1,1207
085a3e7b6045c435bc21442c867c9d3ed8d3bb60,1,Roger Meier,2010-10-08 21:23:35+00:00,['50e4349463c983aac50d37a071191391f704258a'],6,6,12,357012,1,,,,1207
052bbef327eda51ddde5845a2794c344eab8e3a0,0,Mark Slee,2010-10-11 21:45:13+00:00,['085a3e7b6045c435bc21442c867c9d3ed8d3bb60'],0,70,70,357082,2,1,1,1,1208
9a3ec701d814334f6c20ed0f69b3bbcbcca6a6e5,0,Bryan Duxbury,2010-10-11 21:56:50+00:00,['052bbef327eda51ddde5845a2794c344eab8e3a0'],0,0,0,357082,0,,,,1208
8684df9a7986e785ceffb8316c8592558bd7707c,0,Bryan Duxbury,2010-10-11 22:01:27+00:00,['9a3ec701d814334f6c20ed0f69b3bbcbcca6a6e5'],51,20,71,357153,12,0,0,0,1208
21cd3180ef915ec8f1a2fa33520bcb529e5a1c41,0,Bryan Duxbury,2010-10-11 22:13:23+00:00,['8684df9a7986e785ceffb8316c8592558bd7707c'],12,12,24,357177,1,,,,1208
4c5689269f767670741bc49648d419d4c6a188f1,1,Bryan Duxbury,2010-10-12 22:32:23+00:00,['21cd3180ef915ec8f1a2fa33520bcb529e5a1c41'],10,30,40,357217,5,0.714285714,0.714285714,1,1208
0069cc4a298a15c84df5e09e4abebe8ba8a0b8a5,1,Roger Meier,2010-10-13 18:10:18+00:00,['4c5689269f767670741bc49648d419d4c6a188f1'],30,50,80,357297,25,0,0.5,1,1208
63c938bfa139fa088d2a1776614d7f882d71edc1,0,Roger Meier,2010-10-13 20:02:54+00:00,['0069cc4a298a15c84df5e09e4abebe8ba8a0b8a5'],0,0,0,357297,0,,,,1208
3b76fa3638ff91a76c518bfbc480a18e17d01e09,0,Roger Meier,2010-10-14 17:56:03+00:00,['63c938bfa139fa088d2a1776614d7f882d71edc1'],1,0,1,357298,1,1,1,0,1208
c991270de6361bcd86319bf02201d2074c9a93d9,0,Roger Meier,2010-10-15 13:16:05+00:00,['3b76fa3638ff91a76c518bfbc480a18e17d01e09'],5,21,26,357324,2,,,,1208
e8ddffe7bafbdcccd86db79b6a0dd7c60df4af05,0,Bryan Duxbury,2010-10-15 16:40:34+00:00,['c991270de6361bcd86319bf02201d2074c9a93d9'],1,1,2,357326,1,,,,1208
421dfbea6348ea5fdc1c8bb870f8940715f080fa,0,Roger Meier,2010-10-15 19:12:44+00:00,['e8ddffe7bafbdcccd86db79b6a0dd7c60df4af05'],10,4,14,357340,1,1,1,1,1208
f04cfca79716258c97415527ddc47ac87c83a802,0,Roger Meier,2010-10-15 19:24:32+00:00,['421dfbea6348ea5fdc1c8bb870f8940715f080fa'],0,109,109,357449,1,,,,1209
5e64d51efcbaac0839ac78565a5e010843587f95,0,Roger Meier,2010-10-16 15:54:36+00:00,['f04cfca79716258c97415527ddc47ac87c83a802'],25,33,58,357507,1,0,0,1,1209
d11ca5a95e035aca2e9107aba66f9fad1549ffb7,1,Roger Meier,2010-10-18 08:22:57+00:00,['5e64d51efcbaac0839ac78565a5e010843587f95'],2,2,4,357511,2,,,,1209
f770befe173280bf25942294814eb8f9f3e95906,0,David Reiss,2010-10-18 17:25:13+00:00,['d11ca5a95e035aca2e9107aba66f9fad1549ffb7'],3,3,6,357517,1,,,,1209
63228e53c239eac664b3933b4ed3a86d32af809a,0,David Reiss,2010-10-18 17:25:40+00:00,['f770befe173280bf25942294814eb8f9f3e95906'],0,1,1,357518,1,1,1,0,1209
1b13083defbde2dae2baf535eeae272c7c9e1ab0,1,Bryan Duxbury,2010-10-19 17:20:57+00:00,['63228e53c239eac664b3933b4ed3a86d32af809a'],71,579,650,358168,11,0.597156398,0.848341232,0.6492891,1213
2376684d86215e0ef1415f8820d9a2a797dcd3a0,0,Bryan Duxbury,2010-10-19 18:06:45+00:00,['1b13083defbde2dae2baf535eeae272c7c9e1ab0'],2,7,9,358177,1,1,1,1,1213
206c0dc1af226521eb7fccf3890182741fb56cc1,0,Bryan Duxbury,2010-10-19 23:00:27+00:00,['2376684d86215e0ef1415f8820d9a2a797dcd3a0'],0,174,174,358351,3,0.684210526,0.684210526,1,1214
8166073e7fc4b4a13bbbcc464328f03d0a89b577,0,Bryan Duxbury,2010-10-20 19:04:07+00:00,['206c0dc1af226521eb7fccf3890182741fb56cc1'],9,7,16,358367,1,,,,1214
2287278140256323491d8879dbc9592f71cbd1a9,1,Roger Meier,2010-10-22 11:20:25+00:00,['8166073e7fc4b4a13bbbcc464328f03d0a89b577'],21,27,48,358415,7,,,,1214
e703ed2ce689fce7b57af1f7299ccbfdc99adaee,1,Bryan Duxbury,2010-10-22 20:23:57+00:00,['2287278140256323491d8879dbc9592f71cbd1a9'],488,174,662,359077,10,0.088495575,0,1,1214
bc8109faffb4358249efa9a6e8c4e8dc769070d8,0,Roger Meier,2010-10-23 22:01:54+00:00,['e703ed2ce689fce7b57af1f7299ccbfdc99adaee'],3,3,6,359083,1,,,,1214
56b6e32173997d66d6e86093e1f4856c9354d8f3,1,Roger Meier,2010-10-23 22:16:51+00:00,['bc8109faffb4358249efa9a6e8c4e8dc769070d8'],0,57,57,359140,2,,,,1215
62b7cfb7b9ff2ee506336128de00529d4b80fc10,1,Roger Meier,2010-10-23 22:25:04+00:00,['56b6e32173997d66d6e86093e1f4856c9354d8f3'],3,588,591,359731,4,0,0.068862275,1,1218
5ad70a1a55468c65f0e04a36155b2dbf7cd110eb,0,Roger Meier,2010-10-23 23:35:46+00:00,['62b7cfb7b9ff2ee506336128de00529d4b80fc10'],4,7,11,359742,2,,,,1218
2067c1f01bd8c4eb7735167d4dae709f8fa37a56,0,Roger Meier,2010-10-23 23:50:48+00:00,['5ad70a1a55468c65f0e04a36155b2dbf7cd110eb'],2,2,4,359746,1,,,,1218
37b5bf8e00a0c7c6462a2397a12869d86bef65c9,1,Roger Meier,2010-10-24 21:41:24+00:00,['2067c1f01bd8c4eb7735167d4dae709f8fa37a56'],201,182,383,360129,6,0,0,0.105263158,1220
178f8f2c52907d5a9ad8e7419fdb868ff32c2449,0,Roger Meier,2010-10-25 12:36:04+00:00,['37b5bf8e00a0c7c6462a2397a12869d86bef65c9'],4,4,8,360137,3,1,1,,1220
5013de297a1892fb336f69a01e6f57fdad147568,0,Roger Meier,2010-10-25 19:57:26+00:00,['178f8f2c52907d5a9ad8e7419fdb868ff32c2449'],1,6,7,360144,1,,,,1220
213a66479872e0ccf828f8f2675d1546cdff0a18,1,Roger Meier,2010-10-27 12:30:11+00:00,['5013de297a1892fb336f69a01e6f57fdad147568'],0,11499,11499,371643,61,0.235896675,0.686163895,0.610599762,1273
a6ce16470dda427380b41e930ed59e028bdb7615,0,Bryan Duxbury,2010-10-27 17:54:10+00:00,['213a66479872e0ccf828f8f2675d1546cdff0a18'],0,98,98,371741,2,1,1,1,1275
2fde9eee6f155ff23d938256d3c9db9c93a21b77,0,Roger Meier,2010-10-27 19:19:04+00:00,['a6ce16470dda427380b41e930ed59e028bdb7615'],1,12,13,371754,1,,,,1275
b942d57a79cb173df26d07892a6cb60b83cb38d7,0,Roger Meier,2010-10-27 19:39:56+00:00,['2fde9eee6f155ff23d938256d3c9db9c93a21b77'],69,100,169,371923,2,,,,1276
8c9c8bf8f0dcaa89a3ca73695442c4f3ccd6e342,0,Bryan Duxbury,2010-10-27 23:15:35+00:00,['b942d57a79cb173df26d07892a6cb60b83cb38d7'],1,6,7,371930,1,0,1,0,1276
b6722bf8c4dfc35bc818251f8004d1fa5e04d437,1,Bryan Duxbury,2010-10-27 23:26:52+00:00,['8c9c8bf8f0dcaa89a3ca73695442c4f3ccd6e342'],0,851,851,372781,4,0.511568123,0.652956298,0.771208226,1280
452dc69a6b2334884d94a93a098e276f9683f84f,0,Bryan Duxbury,2010-10-27 23:39:58+00:00,['b6722bf8c4dfc35bc818251f8004d1fa5e04d437'],35,24,59,372840,1,1,1,1,1280
fa038f31aca3f751308a41c1f01573bc9835a827,0,Gavin McDonald,2010-10-28 02:12:01+00:00,['452dc69a6b2334884d94a93a098e276f9683f84f'],0,0,0,372840,0,,,,1280
e76f2264b50a576fc2c339548fc2522c15f14f45,0,Gavin McDonald,2010-10-28 02:12:01+00:00,['72a1a88c4a2a9cbf5bae49e5784454d95c58a3b0'],0,0,0,372840,0,,,,1280
2f5e7760c7973a4675f1372be43540f9179a3521,0,Gavin McDonald,2010-10-28 02:12:01+00:00,['4d8815037c091866e7275aa3f55844dbcae3db41'],0,0,0,372840,0,,,,1280
1b7729f71e76af446d8d0119f67a51c4718e1f3b,0,Gavin McDonald,2010-10-28 02:12:01+00:00,['0c4f88a9533ac99d8101fb97f9b22f0d5c22cb9a'],0,0,0,372840,0,,,,1280
e25771d4c29a398ba5d23b447a37d15ab77e7f42,0,Gavin McDonald,2010-10-28 02:12:01+00:00,['7f7795d0d2a025d4f75d4ae348bbc59600d9345f'],0,0,0,372840,0,,,,1280
229c4c28c1f018c5d11044638ee3748f47d85c43,0,Roger Meier,2010-10-29 05:14:54+00:00,['fa038f31aca3f751308a41c1f01573bc9835a827'],0,34,34,372874,1,,,,1281
a8b52c7a8b240042a0c6368fb116520f2b580528,1,Roger Meier,2010-11-02 07:33:30+00:00,['229c4c28c1f018c5d11044638ee3748f47d85c43'],10,12,22,372896,5,,,,1281
e5e50dec48d0d1fafd146009f268c3cf2bd5774b,1,Roger Meier,2010-11-02 12:36:52+00:00,['a8b52c7a8b240042a0c6368fb116520f2b580528'],5,381,386,373282,3,0.209459459,0.452702703,0.587837838,1283
ae7f7fa57f9fa984711362ea88f42d21a965a642,0,Christian Lavoie,2010-11-02 21:42:53+00:00,['e5e50dec48d0d1fafd146009f268c3cf2bd5774b'],32,30,62,373344,6,,,,1283
4a2bc1b161805833483b14154d07a55be3e63e26,0,Bryan Duxbury,2010-11-03 17:57:38+00:00,['ae7f7fa57f9fa984711362ea88f42d21a965a642'],2,2,4,373348,1,,,,1283
5aaa02166e335d6399c7345bbd8f3d83d4e481fa,1,Roger Meier,2010-11-04 12:20:05+00:00,['4a2bc1b161805833483b14154d07a55be3e63e26'],6,6,12,373360,3,,,,1283
4f42ef7aa593b20fa17ad542f53c296032955fb7,1,Christian Lavoie,2010-11-04 18:51:42+00:00,['5aaa02166e335d6399c7345bbd8f3d83d4e481fa'],10,30,40,373400,4,0,0,1,1283
01c5cebfdd0f638f09378e0a735419efc69f3c08,1,Christian Lavoie,2010-11-04 20:35:15+00:00,['4f42ef7aa593b20fa17ad542f53c296032955fb7'],42,41,83,373483,9,1,1,0,1283
bbe36c5d35bca5177c2a5472b58d784d93769da1,1,Bryan Duxbury,2010-11-05 17:14:52+00:00,['01c5cebfdd0f638f09378e0a735419efc69f3c08'],3,184,187,373670,2,0.382978723,0.382978723,1,1283
600a88c6e2e56305227bdb7d5ec4d267e0242365,1,Christian Lavoie,2010-11-07 18:37:11+00:00,['bbe36c5d35bca5177c2a5472b58d784d93769da1'],457,467,924,374594,1,0.93902439,0.792682927,0.109756098,1283
77215d8a35e08559ab51d8440c57b6525ce76e41,0,Christian Lavoie,2010-11-07 19:42:48+00:00,['600a88c6e2e56305227bdb7d5ec4d267e0242365'],4,7,11,374605,3,,,,1283
be87ab28b06323f46835983ce2501b952978bda2,1,Roger Meier,2010-11-10 21:19:36+00:00,['77215d8a35e08559ab51d8440c57b6525ce76e41'],1,1,2,374607,1,,,,1283
3b771a10f1b815d5168d244374cddd1014ba3c02,1,Roger Meier,2010-11-17 22:11:26+00:00,['be87ab28b06323f46835983ce2501b952978bda2'],49,277,326,374933,46,0.728070175,0.877192982,0.543859649,1283
c3affb3940d1f479e5a68d6a6a5e32cb5d19a87e,0,Bryan Duxbury,2010-11-17 22:47:06+00:00,['3b771a10f1b815d5168d244374cddd1014ba3c02'],4,8,12,374945,1,,,,1283
cecbe0fc5202e5047606b881c0e047d1f9d5ca74,1,Bryan Duxbury,2010-11-19 00:06:51+00:00,['c3affb3940d1f479e5a68d6a6a5e32cb5d19a87e'],5,5,10,374955,1,,,,1283
d3bfe700308fa00eeed4bfa9cd76283c194c2d4a,1,Roger Meier,2010-11-20 06:48:47+00:00,['cecbe0fc5202e5047606b881c0e047d1f9d5ca74'],8,8,16,374971,2,,,,1283
5f9614cf9a8003a772e48d9d2ae5b2877d08a721,0,Roger Meier,2010-11-21 16:59:05+00:00,['d3bfe700308fa00eeed4bfa9cd76283c194c2d4a'],24,24,48,375019,6,,,,1283
1606f25616bbf0dc862ab6d0b9aef620027d1fcb,1,Bryan Duxbury,2010-11-24 00:25:57+00:00,['5f9614cf9a8003a772e48d9d2ae5b2877d08a721'],20,82,102,375121,3,0.471698113,0.037735849,1,1283
fea49cb8409167636a94e25f5657aeee58587f6e,0,Bryan Duxbury,2010-11-24 21:30:00+00:00,['1606f25616bbf0dc862ab6d0b9aef620027d1fcb'],0,7,7,375128,2,1,1,1,1283
af65f1b4781a6f7761617e67f5604413f65ceb8d,0,Christian Lavoie,2010-11-24 21:58:05+00:00,['fea49cb8409167636a94e25f5657aeee58587f6e'],7,22,29,375157,4,,,,1283
a5eb8489309492bb0e94b32cd1364469a86fc921,1,Bryan Duxbury,2010-11-24 22:30:38+00:00,['af65f1b4781a6f7761617e67f5604413f65ceb8d'],3,12,15,375172,2,0.875,0.875,1,1283
c101092ea742e1252207b6e8f680bf392292c916,1,Roger Meier,2010-11-26 10:17:48+00:00,['a5eb8489309492bb0e94b32cd1364469a86fc921'],2147,2122,4269,379441,51,1,0,0,1283
cbf87cb89cf0b1e7cd3656262c642209fef235ef,1,Christian Lavoie,2010-11-28 14:34:26+00:00,['c101092ea742e1252207b6e8f680bf392292c916'],10,10,20,379461,6,,,,1283
29208ff190ef0ee25116dd7e199457a5bea8f8e9,0,Roger Meier,2010-11-28 16:22:10+00:00,['cbf87cb89cf0b1e7cd3656262c642209fef235ef'],0,0,0,379461,0,,,,1283
708971351fd0136dce390ad3d76bb9f3e76ef9f6,1,Bryan Duxbury,2010-11-30 00:33:48+00:00,['29208ff190ef0ee25116dd7e199457a5bea8f8e9'],5,12,17,379478,2,1,1,1,1283
6eeb21e917947001e69dd44db60cb5876fec7e62,1,Roger Meier,2010-11-30 05:54:53+00:00,['708971351fd0136dce390ad3d76bb9f3e76ef9f6'],975,823,1798,381276,1,1,0.772727273,0.509090909,1283
26f817a0c947ffed39e2961eddbdc36933f23ee0,0,Roger Meier,2010-11-30 19:46:56+00:00,['6eeb21e917947001e69dd44db60cb5876fec7e62'],5,5,10,381286,3,,,,1283
c2cc61a0fad68b7c72379fa4ad0588fdf5a18644,0,Roger Meier,2010-11-30 19:53:29+00:00,['26f817a0c947ffed39e2961eddbdc36933f23ee0'],4,23,27,381313,2,,,,1283
c0b5d9065c105ae73f11615717d6f071eba3e511,1,Roger Meier,2010-11-30 20:23:44+00:00,['c2cc61a0fad68b7c72379fa4ad0588fdf5a18644'],2,3,5,381318,1,0,0,1,1283
22903cb542d16cb12bb848dfa6eabee26f0d1eb1,0,Bryan Duxbury,2010-12-02 21:29:20+00:00,['c0b5d9065c105ae73f11615717d6f071eba3e511'],25,20,45,381363,2,0,0,0,1283
932ce2b80ab604fff2a5ea489fe507a821074425,1,Bryan Duxbury,2010-12-07 18:28:48+00:00,['22903cb542d16cb12bb848dfa6eabee26f0d1eb1'],153,134,287,381650,1,0.166666667,0,0,1283
ed2dc5359efc77d6410ecdbd9fc121bb9fddd95b,0,Bryan Duxbury,2010-12-13 19:17:22+00:00,['932ce2b80ab604fff2a5ea489fe507a821074425'],5,5,10,381660,1,1,1,0,1283
08dc7e85b9aa84933febecab29b2cbe5958d5471,1,Roger Meier,2010-12-14 21:38:00+00:00,['ed2dc5359efc77d6410ecdbd9fc121bb9fddd95b'],0,559,559,382219,15,,,,1298
e0cac988b6caa0a3a624951418ecae32c6ba9a5c,1,Roger Meier,2010-12-16 13:15:49+00:00,['08dc7e85b9aa84933febecab29b2cbe5958d5471'],23,21,44,382263,5,1,1,1,1298
cd9bc46ebd1ad5336cf27f517db8eb43e1947410,1,Roger Meier,2011-01-03 20:19:07+00:00,['e0cac988b6caa0a3a624951418ecae32c6ba9a5c'],0,216,216,382479,3,0.203389831,0.576271186,0.525423729,1301
981240d11e82b63529b7680b175bed35a95b93b4,0,Bryan Duxbury,2011-01-07 18:24:38+00:00,['cd9bc46ebd1ad5336cf27f517db8eb43e1947410'],0,0,0,382479,0,,,,1301
f54f4cb0e2c688f1fcad9212f81c74e52e663f42,1,Bryan Duxbury,2011-01-07 18:39:54+00:00,['cd9bc46ebd1ad5336cf27f517db8eb43e1947410'],0,62,62,382541,1,,,,1301
68a59b2acb300451bea53da0245e4251a124c502,0,Bryan Duxbury,2011-01-07 18:41:20+00:00,['981240d11e82b63529b7680b175bed35a95b93b4'],0,62,62,382603,1,,,,1301
c216556bd6d63f699a0632f569a13c7ad8920ca2,0,Bryan Duxbury,2011-01-07 18:45:29+00:00,['f54f4cb0e2c688f1fcad9212f81c74e52e663f42'],6,6,12,382615,6,,,,1301
e22ff6dbea0d2e667052a778ade4bd9341333f77,0,Bryan Duxbury,2011-01-07 18:46:50+00:00,['68a59b2acb300451bea53da0245e4251a124c502'],5,5,10,382625,5,,,,1301
0c124bb94f86eead61ef1c65dc6b38f5f60076f9,1,T Jake Luciani,2011-01-08 03:49:16+00:00,['c216556bd6d63f699a0632f569a13c7ad8920ca2'],71,1643,1714,384339,15,0.517313746,0.650577125,0.827911857,1315
960173564264caf33ffae71ba27cd366126ce660,0,Bryan Duxbury,2011-01-11 19:21:51+00:00,"['e22ff6dbea0d2e667052a778ade4bd9341333f77', '0c124bb94f86eead61ef1c65dc6b38f5f60076f9']",72,1644,1716,386055,16,,,,1315
5baba45df99d625ca682e8ecafb81400a6cb56c5,0,Bryan Duxbury,2011-01-11 19:23:24+00:00,['960173564264caf33ffae71ba27cd366126ce660'],3,5,8,386063,1,,,,1315
fad8d6b1096769abc6eb4c0f2f926de4d3f5ab56,0,Bryan Duxbury,2011-01-12 18:41:52+00:00,['0c124bb94f86eead61ef1c65dc6b38f5f60076f9'],61,63,124,386187,4,0,0,1,1315
39fbb9a95bb217218414b24450b38dee0d628203,0,Bryan Duxbury,2011-01-13 18:09:51+00:00,['fad8d6b1096769abc6eb4c0f2f926de4d3f5ab56'],2,2,4,386191,1,,,,1315
eb1e6f7107bb2f861ad008ed77e276a1fda270cb,0,Bryan Duxbury,2011-01-13 18:10:18+00:00,['5baba45df99d625ca682e8ecafb81400a6cb56c5'],2,2,4,386195,1,,,,1315
3d60f81ce1a7cde3a801888117e2cbbf5ee774e8,0,Bryan Duxbury,2011-01-13 18:11:49+00:00,['eb1e6f7107bb2f861ad008ed77e276a1fda270cb'],0,1,1,386196,1,,,,1315
c7cd68eb86bfc4c07a12ee929fa2f7acdad909fc,1,Bryan Duxbury,2011-01-20 17:47:28+00:00,['39fbb9a95bb217218414b24450b38dee0d628203'],0,1,1,386197,1,,,,1315
4b3f1c31817b26385ec1a802dd4beffcf88c4caa,1,Roger Meier,2011-01-22 21:32:50+00:00,['c7cd68eb86bfc4c07a12ee929fa2f7acdad909fc'],1,14,15,386212,3,1,1,1,1315
90443f4e11d883fba6abb23562a159e8a8b0b78e,1,Roger Meier,2011-01-22 21:35:48+00:00,['4b3f1c31817b26385ec1a802dd4beffcf88c4caa'],23,24,47,386259,3,1,1,1,1315
afb0c7f374d5038062c75ea31cf1ee0f8bc80481,1,Roger Meier,2011-01-22 21:43:59+00:00,['90443f4e11d883fba6abb23562a159e8a8b0b78e'],11,48,59,386318,1,0.655172414,1,1,1315
a99c7505e082b867c87b3e32db1a8a054742bdea,0,Roger Meier,2011-01-23 09:35:45+00:00,['afb0c7f374d5038062c75ea31cf1ee0f8bc80481'],1,1,2,386320,1,,,,1315
7f979e4f78d82e7c0ec1e288000cdf731f7b59aa,0,Roger Meier,2011-01-23 10:57:03+00:00,['a99c7505e082b867c87b3e32db1a8a054742bdea'],2,2,4,386324,1,,,,1315
6a084da48f1177eec38a6ddef982247cc343ff94,0,Christian Lavoie,2011-01-24 23:01:37+00:00,['7f979e4f78d82e7c0ec1e288000cdf731f7b59aa'],0,1,1,386325,1,,,,1315
923e453be43ed31d2c32ed3af28581a3785a79b4,0,Christian Lavoie,2011-01-24 23:01:37+00:00,['3d60f81ce1a7cde3a801888117e2cbbf5ee774e8'],0,1,1,386326,1,,,,1315
e0498c984eae35b847f978cf24cf5dd88a16d3e9,1,Bryan Duxbury,2011-01-26 17:54:02+00:00,['6a084da48f1177eec38a6ddef982247cc343ff94'],2,2,4,386330,1,,,,1315
c0e2ef50b7c27cd1023a264f208cd81a58e63668,0,Bryan Duxbury,2011-01-26 18:25:17+00:00,['e0498c984eae35b847f978cf24cf5dd88a16d3e9'],0,114,114,386444,1,0.56,0.56,1,1316
d94cb081a1b304409d59c75115d68ad794e3d408,0,Bryan Duxbury,2011-01-26 18:29:33+00:00,['c0e2ef50b7c27cd1023a264f208cd81a58e63668'],1,1,2,386446,1,,,,1316
34c2dbd545c32dde632f95e376830f49457ac2aa,0,Bryan Duxbury,2011-01-26 18:40:30+00:00,['d94cb081a1b304409d59c75115d68ad794e3d408'],0,8,8,386454,2,0.857142857,0.857142857,0.571428571,1316
c8d533b65e8b87f41cdfa04a4a021021a0636f30,1,Bryan Duxbury,2011-01-26 22:42:02+00:00,['34c2dbd545c32dde632f95e376830f49457ac2aa'],0,85,85,386539,3,0.88,0.96,0.96,1316
65ad14cbd7c28fb2edc228cb219797f67a91421a,1,Bryan Duxbury,2011-01-26 22:43:43+00:00,['c8d533b65e8b87f41cdfa04a4a021021a0636f30'],0,1,1,386540,1,,,,1316
38b6574865f2646b0b455ca0ceb2ff3ba83315ee,0,Bryan Duxbury,2011-01-26 22:46:04+00:00,['923e453be43ed31d2c32ed3af28581a3785a79b4'],0,86,86,386626,4,0.88,0.96,0.96,1316
9dedce2196b511e50d39ca544dcf735d506d6d96,0,Bryan Duxbury,2011-01-26 23:31:19+00:00,['65ad14cbd7c28fb2edc228cb219797f67a91421a'],1,94,95,386721,2,,,,1317
e61fef37d846e89108ef59ddcf9d4e67bcbefd1f,0,Bryan Duxbury,2011-01-26 23:38:54+00:00,['9dedce2196b511e50d39ca544dcf735d506d6d96'],1,5,6,386727,1,,,,1317
7070aaa23bce996f9c40f75903d72fe427072713,0,T Jake Luciani,2011-01-27 02:51:51+00:00,['e61fef37d846e89108ef59ddcf9d4e67bcbefd1f'],29,81,110,386837,4,0.277777778,0,1,1317
03ec1e4696d5a9bea0dd7df4bcc7f727f4f0aab5,0,T Jake Luciani,2011-01-27 02:53:57+00:00,['7070aaa23bce996f9c40f75903d72fe427072713'],1,1,2,386839,1,,,,1317
b547141797f17159fdb61abfb22e817b121fde8f,1,Christian Lavoie,2011-01-27 21:05:45+00:00,['03ec1e4696d5a9bea0dd7df4bcc7f727f4f0aab5'],12,11,23,386862,1,1,1,1,1317
a026b5d9eb6d3f3105440807a5f030cfc5186667,0,Mark Slee,2011-01-28 22:26:13+00:00,['b547141797f17159fdb61abfb22e817b121fde8f'],1,0,1,386863,1,,,,1317
68634a0bac61d41b8ce057d0c9086aea82f4d853,0,T Jake Luciani,2011-01-31 01:57:14+00:00,['38b6574865f2646b0b455ca0ceb2ff3ba83315ee'],66,173,239,387102,8,0.609756098,0.37804878,1,1317
56c2d5682e1122917465e704a43e5c3ae2f6eb99,0,Todd Lipcon,2011-02-06 18:13:10+00:00,['a026b5d9eb6d3f3105440807a5f030cfc5186667'],0,8,8,387110,1,1,1,1,1317
2d9dfdb88e58ab5b961726a5506a4f3e0653b807,1,Bryan Duxbury,2011-02-08 16:38:15+00:00,['56c2d5682e1122917465e704a43e5c3ae2f6eb99'],0,2,2,387112,2,0,1,0.5,1317
0fd37f08716758b283010abfa5162eb2c1aee2ad,1,Bryan Duxbury,2011-02-08 17:26:37+00:00,['2d9dfdb88e58ab5b961726a5506a4f3e0653b807'],197,184,381,387493,4,1,1,0,1319
4ebaa761cbb06964831cc69f923ba849025e9ff1,1,Roger Meier,2011-02-08 20:44:22+00:00,['0fd37f08716758b283010abfa5162eb2c1aee2ad'],1,2,3,387496,1,,,,1319
2bbc328212ee779b96aa3cdf96f2a054a1226214,0,Christian Lavoie,2011-02-08 23:05:47+00:00,['4ebaa761cbb06964831cc69f923ba849025e9ff1'],18,25,43,387539,1,,,,1319
410253a1e02e5c0d5651c98fa97e4754dfcc04ea,1,Christian Lavoie,2011-02-09 05:27:32+00:00,['2bbc328212ee779b96aa3cdf96f2a054a1226214'],2,241,243,387782,2,,,,1320
d4c67c343ebfc0fb8bb404400b4b4ba8ff11f046,0,Christian Lavoie,2011-02-09 14:37:53+00:00,['410253a1e02e5c0d5651c98fa97e4754dfcc04ea'],119,0,119,387901,1,,,,1320
b005c1f45615a3c8ee4cd895c2492fe6ff9caab3,0,Bryan Duxbury,2011-02-09 17:05:11+00:00,['d4c67c343ebfc0fb8bb404400b4b4ba8ff11f046'],0,1,1,387902,1,,,,1320
10a8743f6a7bc2faefb39ba476f508ddcf62a068,1,Anthony F. Molinaro,2011-02-16 05:54:17+00:00,['b005c1f45615a3c8ee4cd895c2492fe6ff9caab3'],17,17,34,387936,3,,,,1320
f8bf0d69c5b8afccebc2b4cb5412411ae2e72527,0,Anthony F. Molinaro,2011-02-16 06:00:10+00:00,['10a8743f6a7bc2faefb39ba476f508ddcf62a068'],0,8,8,387944,1,,,,1321
dd0c328a45d6ccedfd63b4dcf8ac5e525907d11b,1,Roger Meier,2011-02-16 19:25:05+00:00,['f8bf0d69c5b8afccebc2b4cb5412411ae2e72527'],14,11,25,387969,1,0.666666667,0,0,1321
55ea68f8e78dcda0770b67239792b677502c0d60,0,Roger Meier,2011-02-16 19:29:50+00:00,['dd0c328a45d6ccedfd63b4dcf8ac5e525907d11b'],18,15,33,388002,1,0,0,0,1321
c59c30ebd37df06f42898356d19687b2983e6091,0,Christian Lavoie,2011-02-19 21:02:22+00:00,['55ea68f8e78dcda0770b67239792b677502c0d60'],1,1,2,388004,1,,,,1321
282e717add0460bc6fd4da9be93033b1d5a2be9e,0,Christian Lavoie,2011-02-20 01:57:55+00:00,['c59c30ebd37df06f42898356d19687b2983e6091'],0,0,0,388004,2,,,,1321
afc6d8f650cd7e500b07134d11b936dc90a62a02,1,Christian Lavoie,2011-02-20 02:39:19+00:00,['282e717add0460bc6fd4da9be93033b1d5a2be9e'],2,16778,16780,404784,71,0.322147651,0.400510445,0.828528216,1388
cd2ee9ae6ea85335b4c9c3db3a421f27f583f417,0,Christian Lavoie,2011-02-20 18:59:33+00:00,['afc6d8f650cd7e500b07134d11b936dc90a62a02'],2,3,5,404789,1,,,,1388
cd9aea1136d9a51b2ce53a3de5da09359c9756e2,1,Bryan Duxbury,2011-02-22 18:12:06+00:00,['cd2ee9ae6ea85335b4c9c3db3a421f27f583f417'],7,1216,1223,406012,11,0.465195246,0.623089983,0.85229202,1393
7d1517aa4cee0aa7bc78e07766e541865e8115c5,1,Bryan Duxbury,2011-02-22 18:17:23+00:00,['cd9aea1136d9a51b2ce53a3de5da09359c9756e2'],15,45,60,406072,2,1,0,0,1393
f1ed92696906c8796936754a3cdea5740d79639c,0,Bryan Duxbury,2011-02-22 18:20:13+00:00,['7d1517aa4cee0aa7bc78e07766e541865e8115c5'],0,8,8,406080,1,,,,1394
2b969add48431feab8c1769e05e15a572fba1e3d,1,Bryan Duxbury,2011-02-22 18:20:53+00:00,['f1ed92696906c8796936754a3cdea5740d79639c'],0,38,38,406118,1,0.222222222,0.222222222,1,1395
a8738b5560db8216c06d0a8cea116b7f29255e8e,1,Roger Meier,2011-02-22 20:15:03+00:00,['2b969add48431feab8c1769e05e15a572fba1e3d'],1,7,8,406126,1,1,1,1,1395
b3b07d6de4fd673fd8acd1484daa8bf9002d91cc,1,Roger Meier,2011-02-22 20:55:21+00:00,['a8738b5560db8216c06d0a8cea116b7f29255e8e'],25,13,38,406164,1,,,,1395
76d55f635784aa9dfae8ce52ce3eb49ba7f90a40,1,Roger Meier,2011-02-22 20:56:45+00:00,['b3b07d6de4fd673fd8acd1484daa8bf9002d91cc'],16,5,21,406185,1,1,1,0,1395
598bf48f77ad512d2235aaef73c6257a26672b5e,0,Roger Meier,2011-02-22 21:56:33+00:00,['76d55f635784aa9dfae8ce52ce3eb49ba7f90a40'],1,1,2,406187,1,,,,1395
9d9c4b9039918d06cb64e5fbabf4718445120ab3,0,Roger Meier,2011-02-23 20:27:54+00:00,['598bf48f77ad512d2235aaef73c6257a26672b5e'],0,4,4,406191,1,,,,1395
60cb3baf8fb426c2e2d9cfa9dee8b79c2e7d5bd6,0,Roger Meier,2011-02-24 14:45:03+00:00,['9d9c4b9039918d06cb64e5fbabf4718445120ab3'],1,1,2,406193,1,,,,1395
d9924984dbdf92fe85d2e03c2523651e45c37140,1,Roger Meier,2011-02-24 16:04:03+00:00,['60cb3baf8fb426c2e2d9cfa9dee8b79c2e7d5bd6'],15,39,54,406247,3,0.5,0.75,1,1395
9db5e50b428a1dddf86b3b79aa8d747f9631a92c,1,Roger Meier,2011-02-27 19:24:45+00:00,['d9924984dbdf92fe85d2e03c2523651e45c37140'],9,9,18,406265,2,,,,1395
46d32b4f082c595a6f7de54d0e683f50b4991efe,1,Roger Meier,2011-02-28 16:04:51+00:00,['9db5e50b428a1dddf86b3b79aa8d747f9631a92c'],3,4,7,406272,1,,,,1395
ef6cbfd1abed98806a93fc67f78c73477a907f91,1,Bryan Duxbury,2011-03-01 16:57:34+00:00,['46d32b4f082c595a6f7de54d0e683f50b4991efe'],22,123,145,406417,4,0,0.159090909,1,1395
bdca9f667fb2d76b4085a4426636f4be129d1cfa,0,Bryan Duxbury,2011-03-01 19:53:07+00:00,['ef6cbfd1abed98806a93fc67f78c73477a907f91'],7,25,32,406449,3,0.636363636,0.818181818,1,1395
1d373bc0e719718836395b90e84dbe0b0f241c9b,0,Bryan Duxbury,2011-03-02 18:13:30+00:00,['bdca9f667fb2d76b4085a4426636f4be129d1cfa'],10,11,21,406470,2,,,,1395
a2cceb4396e89f02b9724e3f6dada3c534eacea1,0,Bryan Duxbury,2011-03-02 18:25:24+00:00,['1d373bc0e719718836395b90e84dbe0b0f241c9b'],22,27,49,406519,1,,,,1395
a971fb094877b4245142c45abe67fc4e5568af30,1,Bryan Duxbury,2011-03-04 00:49:40+00:00,['a2cceb4396e89f02b9724e3f6dada3c534eacea1'],5,9,14,406533,1,,,,1395
c46f32ce181164ecd28de7c328e5cd704282a699,0,Bryan Duxbury,2011-03-04 01:25:17+00:00,['a971fb094877b4245142c45abe67fc4e5568af30'],87,69,156,406689,1,1,1,0,1395
e7b1864d46da8939935ed17530e2510e37a1f2ad,0,Bryan Duxbury,2011-03-04 01:35:17+00:00,['c46f32ce181164ecd28de7c328e5cd704282a699'],1,1,2,406691,1,,,,1395
062de1b0d327e72993489118f5949d2e1e4d3848,0,Roger Meier,2011-03-04 13:10:58+00:00,['e7b1864d46da8939935ed17530e2510e37a1f2ad'],3,1,4,406695,1,,,,1395
3f067a86ebea6e4919fb4cc67192b2b5f386fbdf,1,Roger Meier,2011-03-04 13:35:05+00:00,['062de1b0d327e72993489118f5949d2e1e4d3848'],36,36,72,406767,17,,,,1395
b4bcbe3cb2be14939e938df264b0472fbbb58edb,1,Roger Meier,2011-03-07 19:37:46+00:00,['3f067a86ebea6e4919fb4cc67192b2b5f386fbdf'],469,476,945,407712,1,1,1,0.2,1395
6d8219c10556c88ceb11a8a074987afbfa884175,0,Roger Meier,2011-03-07 21:16:46+00:00,['b4bcbe3cb2be14939e938df264b0472fbbb58edb'],4,4,8,407720,3,,,,1395
0244e9353f01a780ae3d7edd122288c23ce8652c,0,Roger Meier,2011-03-09 15:25:01+00:00,['6d8219c10556c88ceb11a8a074987afbfa884175'],0,8,8,407728,1,,,,1395
a48b7d6e52eb3fcc9a986cde654277ea48a29951,1,Bryan Duxbury,2011-03-09 18:05:58+00:00,['0244e9353f01a780ae3d7edd122288c23ce8652c'],0,125,125,407853,1,0.671875,0.671875,1,1396
a6d31c57f0f9e253f8e669495ca8f28e85c11f16,1,Bryan Duxbury,2011-03-10 18:14:14+00:00,['a48b7d6e52eb3fcc9a986cde654277ea48a29951'],0,31,31,407884,1,0.173913043,0.173913043,0.173913043,1396
8430d50c8f44f756c33bf6fb507ec34210ac88ab,1,Roger Meier,2011-03-11 12:38:54+00:00,['a6d31c57f0f9e253f8e669495ca8f28e85c11f16'],163,152,315,408199,1,1,1,1,1396
da6e6ae91894bc52fc04234fbd2610f8969399f4,1,Roger Meier,2011-03-15 09:55:33+00:00,['8430d50c8f44f756c33bf6fb507ec34210ac88ab'],123,190,313,408512,4,0,0.642857143,0.964285714,1396
c9929306ba8eafaee9bced7fd6521ec0bf6b876a,0,Bryan Duxbury,2011-03-15 17:10:15+00:00,['da6e6ae91894bc52fc04234fbd2610f8969399f4'],1,2,3,408515,1,0,1,1,1396
df4cffd34a54988a3faa50c3ddb33d263fa08693,0,Bryan Duxbury,2011-03-15 17:16:09+00:00,['c9929306ba8eafaee9bced7fd6521ec0bf6b876a'],7,128,135,408650,3,0.103448276,1,1,1396
ee7c7bb48586ac35b3561d6253b6d7792b6ce152,0,Bryan Duxbury,2011-03-15 17:25:23+00:00,['df4cffd34a54988a3faa50c3ddb33d263fa08693'],27,27,54,408704,2,,,,1396
f2495760feb8d30087bd27945c46993d092960fa,1,Roger Meier,2011-03-17 19:13:36+00:00,['ee7c7bb48586ac35b3561d6253b6d7792b6ce152'],2,38,40,408744,4,,,,1397
81a13cbd5d2a5fbd9a81cd2b19c9916cb88c942e,0,Roger Meier,2011-03-17 19:20:56+00:00,['f2495760feb8d30087bd27945c46993d092960fa'],0,0,0,408744,0,,,,1397
59d4efda817f73eb195f47ff9f04cb0f4ec47525,1,Bryan Duxbury,2011-03-21 17:38:22+00:00,['81a13cbd5d2a5fbd9a81cd2b19c9916cb88c942e'],53,233,286,409030,4,0.847619048,0.695238095,0.647619048,1397
5040911bfab39b5c9f2a0d715cea0ee9012f7450,1,Bryan Duxbury,2011-03-21 17:59:49+00:00,['59d4efda817f73eb195f47ff9f04cb0f4ec47525'],31,159,190,409220,2,0.411764706,0.411764706,0.68627451,1397
d3fceb02d450f415088c254ca5fb65d2f32085c0,0,Bryan Duxbury,2011-03-21 18:04:08+00:00,['5040911bfab39b5c9f2a0d715cea0ee9012f7450'],1,1,2,409222,1,,,,1397
177b52ab58d87450042e62a9ae6e563b528ec3c5,0,Bryan Duxbury,2011-03-21 18:18:33+00:00,['d3fceb02d450f415088c254ca5fb65d2f32085c0'],2,13,15,409237,3,0,1,1,1397
42a6fa4b29d74028ee943b3da17d5eccf7fd897a,0,Roger Meier,2011-03-21 21:26:35+00:00,['177b52ab58d87450042e62a9ae6e563b528ec3c5'],3,2,5,409242,2,,,,1397
1606659171d9ee8885d5806d6030ec39399b3b08,1,Bryan Duxbury,2011-03-22 18:06:04+00:00,['42a6fa4b29d74028ee943b3da17d5eccf7fd897a'],102,489,591,409833,8,0.75862069,0.913793103,0.724137931,1400
f51a4ce89e947204bd401c1afd0885f2f38126cc,0,Bryan Duxbury,2011-03-23 17:57:21+00:00,['1606659171d9ee8885d5806d6030ec39399b3b08'],1,6,7,409840,1,1,1,1,1400
d081dd668b4c8d11de68d4e2047b3e54cfc21ec3,0,Bryan Duxbury,2011-03-23 18:05:27+00:00,['f51a4ce89e947204bd401c1afd0885f2f38126cc'],0,3,3,409843,2,1,1,1,1400
1709d40b4f33d034e63dcf7803202891834bba05,0,Bryan Duxbury,2011-03-23 18:15:19+00:00,['d081dd668b4c8d11de68d4e2047b3e54cfc21ec3'],4,4,8,409851,1,,,,1400
f2100be15b4c4e17db08c36c54ca71a9e80e33d8,1,Roger Meier,2011-03-23 20:36:20+00:00,['1709d40b4f33d034e63dcf7803202891834bba05'],2,4,6,409857,2,,,,1400
5a9ca8811838f416f4fc0dbe7240a28e95c344f1,1,Anthony F. Molinaro,2011-03-24 16:46:22+00:00,['f2100be15b4c4e17db08c36c54ca71a9e80e33d8'],8,8,16,409873,3,,,,1400
55f7ffea5d792ce33044d885cda8f8ba92d36c3c,0,Bryan Duxbury,2011-03-24 17:24:27+00:00,['5a9ca8811838f416f4fc0dbe7240a28e95c344f1'],201,237,438,410311,3,,,,1400
c76009881b2149ef5840692fdf50d0025acd069c,0,Bryan Duxbury,2011-03-24 22:20:12+00:00,['68634a0bac61d41b8ce057d0c9086aea82f4d853'],231,267,498,410809,3,,,,1400
1735a73cc189ef874b44160fbd06e0b7b778cfa9,0,Bryan Duxbury,2011-03-24 22:22:24+00:00,['c76009881b2149ef5840692fdf50d0025acd069c'],2,4,6,410815,2,,,,1400
2511cdcef91f3aad716ec0aaca54e37746300cbd,0,Bryan Duxbury,2011-03-24 22:26:32+00:00,['1735a73cc189ef874b44160fbd06e0b7b778cfa9'],25,25,50,410865,8,,,,1400
2fdf05c69ea7b1a9236960f1dce9fef4087f2431,1,Roger Meier,2011-03-25 11:37:16+00:00,['55f7ffea5d792ce33044d885cda8f8ba92d36c3c'],9,13,22,410887,1,,,,1400
346039367546dc7fc67cc96cc4c0920407157dbd,0,Roger Meier,2011-03-25 12:22:17+00:00,['2fdf05c69ea7b1a9236960f1dce9fef4087f2431'],0,2,2,410889,1,,,,1400
3cf5daf9cf234989f24b3a53131b762479983e8c,0,Bryan Duxbury,2011-03-25 17:28:19+00:00,['346039367546dc7fc67cc96cc4c0920407157dbd'],1,1,2,410891,1,,,,1400
137fea686ee77a6f61e60f8201459df9c6038ab9,0,Bryan Duxbury,2011-03-28 14:52:25+00:00,['3cf5daf9cf234989f24b3a53131b762479983e8c'],1,2,3,410894,1,,,,1400
f02d43772f496fa5cc79bfcf264c474513a8425f,0,Bryan Duxbury,2011-03-28 14:56:53+00:00,['137fea686ee77a6f61e60f8201459df9c6038ab9'],1,1,2,410896,1,,,,1400
ba47e8e7d9187b9aec3d10cfa33aabb3d04b9b1d,0,Roger Meier,2011-03-29 19:59:44+00:00,['f02d43772f496fa5cc79bfcf264c474513a8425f'],0,1,1,410897,1,,,,1400
ff20fa11e094536c942ee80129b0dbf294146b67,1,Anthony F. Molinaro,2011-03-29 21:19:03+00:00,['ba47e8e7d9187b9aec3d10cfa33aabb3d04b9b1d'],77,134,211,411108,1,0.666666667,0.104166667,1,1400
b7bc72648645b00f7b0cf0aa6adfbc295000f2f2,1,Roger Meier,2011-03-30 04:52:50+00:00,['ff20fa11e094536c942ee80129b0dbf294146b67'],1,1,2,411110,1,,,,1400
39e9c3036b6162691e73ca23f9077d1fdf09866e,1,Roger Meier,2011-03-30 06:14:06+00:00,['b7bc72648645b00f7b0cf0aa6adfbc295000f2f2'],0,4,4,411114,1,0,0,1,1400
54af25e3d3e5e93ae3120e81301558a5eeb764c1,1,Anthony F. Molinaro,2011-04-01 05:34:27+00:00,['39e9c3036b6162691e73ca23f9077d1fdf09866e'],101,107,208,411322,1,1,0.5,0,1400
08b309997f3d45238c1c755bbb0c3cf42a3b0105,1,Roger Meier,2011-04-06 21:30:53+00:00,['54af25e3d3e5e93ae3120e81301558a5eeb764c1'],126,269,395,411717,4,0,0.763636364,0.436363636,1400
c32e8309f439b6ca8fd878a059516c3d1618d2cc,0,Bryan Duxbury,2011-04-08 18:31:52+00:00,['08b309997f3d45238c1c755bbb0c3cf42a3b0105'],0,1,1,411718,1,0,0,1,1400
c65e3978ecdeb9be141eae4adb504de0edf75850,0,Roger Meier,2011-04-08 21:24:55+00:00,['c32e8309f439b6ca8fd878a059516c3d1618d2cc'],0,0,0,411718,0,,,,1400
5fc6973bdf5afed28c6889b91b84a11ecc39fbb0,0,Roger Meier,2011-04-08 21:28:50+00:00,['c65e3978ecdeb9be141eae4adb504de0edf75850'],12,12,24,411742,4,,,,1400
cbf4d5d7d26d30440e7c0612dbefd5133fd35b16,0,Roger Meier,2011-04-08 23:23:13+00:00,['5fc6973bdf5afed28c6889b91b84a11ecc39fbb0'],0,0,0,411742,0,,,,1400
5c819c084c09faace575f3889869a8a0b0dd7c95,1,Roger Meier,2011-04-09 11:10:04+00:00,['cbf4d5d7d26d30440e7c0612dbefd5133fd35b16'],133,342,475,412217,5,0.734177215,0.892405063,0.943037975,1402
d26cb9b325c6a0757d773d2aaf1d8ce3561ee2d5,0,Bryan Duxbury,2011-04-11 17:59:27+00:00,['5c819c084c09faace575f3889869a8a0b0dd7c95'],0,2,2,412219,1,,,,1402
08d46814386c5b63ad194441fa6f31bb685eb37a,0,Roger Meier,2011-04-12 19:08:21+00:00,['d26cb9b325c6a0757d773d2aaf1d8ce3561ee2d5'],10,28,38,412257,10,1,1,1,1402
0ae0542152c1a37b8beb0ae9615ce824cd4241a4,0,Roger Meier,2011-04-12 19:23:10+00:00,['08d46814386c5b63ad194441fa6f31bb685eb37a'],26,72,98,412355,5,,,,1402
f3a51e6b03679fa3b1b14a7616f57fc62be05b90,1,Roger Meier,2011-04-12 20:36:12+00:00,['0ae0542152c1a37b8beb0ae9615ce824cd4241a4'],4,15,19,412374,3,,,,1402
b8911458944e242126adbd02ef342e50230ba0c3,1,Bryan Duxbury,2011-04-12 22:03:45+00:00,['f3a51e6b03679fa3b1b14a7616f57fc62be05b90'],3,9,12,412386,1,0.5,0.5,0,1402
10ed8e814f7351dad0efada087bff841fe5e9866,0,Jake Farrell,2011-04-13 19:42:35+00:00,['b8911458944e242126adbd02ef342e50230ba0c3'],1,1,2,412388,1,,,,1402
6f1e992f6c9a55d9584de1f2195c7295045e328e,1,Jake Farrell,2011-04-13 21:09:02+00:00,['10ed8e814f7351dad0efada087bff841fe5e9866'],0,85,85,412473,3,0.35,1,0.85,1403
daca3596f2b7d010cb5d1494caa4f52c6f78c846,0,Jake Farrell,2011-04-14 01:42:12+00:00,['6f1e992f6c9a55d9584de1f2195c7295045e328e'],2,1,3,412476,1,,,,1403
83693531db0893f59178991b20a0efb16a403004,0,Jake Farrell,2011-04-14 14:30:25+00:00,['daca3596f2b7d010cb5d1494caa4f52c6f78c846'],1,1,2,412478,1,,,,1403
65e7544643bba71bd426a3a8ba7ed559079fa2e2,0,Jake Farrell,2011-04-14 14:30:25+00:00,['2511cdcef91f3aad716ec0aaca54e37746300cbd'],1,1,2,412480,1,,,,1403
0b0c90a7f99ed82771aaa929b0287e1749b836b0,0,Roger Meier,2011-04-16 18:55:11+00:00,['83693531db0893f59178991b20a0efb16a403004'],1,5,6,412486,1,0,1,1,1403
6b38cf68058c335a55b62752ccb126263df34cbb,0,Roger Meier,2011-04-16 20:05:51+00:00,['0b0c90a7f99ed82771aaa929b0287e1749b836b0'],2,7,9,412495,1,0,1,0,1403
5671a55f8e974828fde5ce212b6c518bb4c3ebea,0,Bryan Duxbury,2011-04-18 17:29:06+00:00,['6b38cf68058c335a55b62752ccb126263df34cbb'],4,8,12,412507,1,0,0,1,1403
330b5ae1bf198bdf719f4f2cc7bddfb0368f4070,0,Roger Meier,2011-04-18 19:46:02+00:00,['5671a55f8e974828fde5ce212b6c518bb4c3ebea'],1,1,2,412509,1,,,,1403
87e4980df053959d5e6c002a901c210aa9c882e4,1,Roger Meier,2011-04-19 19:47:03+00:00,['330b5ae1bf198bdf719f4f2cc7bddfb0368f4070'],0,373,373,412882,6,0.830188679,1,0.669811321,1409
4b8faf9e20dcd8716c456a6ddc1a58c0911ed958,0,Jake Farrell,2011-04-19 21:11:54+00:00,['87e4980df053959d5e6c002a901c210aa9c882e4'],74,149,223,413105,2,,,,1410
b46cbbf3182dd2792ad3d34ddb083fed91573be4,0,Jake Farrell,2011-04-19 21:11:54+00:00,['65e7544643bba71bd426a3a8ba7ed559079fa2e2'],108,78,186,413291,2,,,,1411
680114defb1ce478a0adf98606d427cea76fcff5,0,Jake Farrell,2011-04-19 21:15:17+00:00,['4b8faf9e20dcd8716c456a6ddc1a58c0911ed958'],42,146,188,413479,2,,,,1411
11676adeb37b8f13c0abd6b2dade85cadcc58382,0,Jake Farrell,2011-04-19 21:15:17+00:00,['b46cbbf3182dd2792ad3d34ddb083fed91573be4'],42,146,188,413667,2,,,,1411
ebf0bec6707b9154f0ceb4f7b268bdbfee36e464,0,Jake Farrell,2011-04-20 15:23:26+00:00,['680114defb1ce478a0adf98606d427cea76fcff5'],1,1,2,413669,1,,,,1411
209d6dcc0e2fece7e28e3092a8d7c52a7ab0d23f,0,Jake Farrell,2011-04-20 16:35:20+00:00,['11676adeb37b8f13c0abd6b2dade85cadcc58382'],79,70,149,413818,2,,,,1411
ad6426cfd0542a7c7a2a9ed0b2ff29329a0462cb,1,Jake Farrell,2011-04-20 16:35:20+00:00,['ebf0bec6707b9154f0ceb4f7b268bdbfee36e464'],70,22,92,413910,2,,,,1411
3ecea5005880b9fb86fc854b85e6812897d0683b,0,Jake Farrell,2011-04-20 19:48:12+00:00,['209d6dcc0e2fece7e28e3092a8d7c52a7ab0d23f'],1,1,2,413912,1,,,,1411
e74caa84e3197f4bfb6bea0b74b4427eb305a6c2,1,Jake Farrell,2011-04-20 19:48:12+00:00,['ad6426cfd0542a7c7a2a9ed0b2ff29329a0462cb'],1,1,2,413914,1,,,,1411
5a53060de2af5959db0ef21ee4a865ae3fa67fd3,0,Jake Farrell,2011-04-20 20:11:07+00:00,['3ecea5005880b9fb86fc854b85e6812897d0683b'],0,9,9,413923,1,,,,1411
b0cdd91a8365a001d0719cce21ddafaa8fd28fc0,0,Jake Farrell,2011-04-26 14:18:07+00:00,['e74caa84e3197f4bfb6bea0b74b4427eb305a6c2'],1,0,1,413924,1,,,,1411
6ece9be5c7c5a1e4a1169dfa7f98ff1bbbe1fc47,0,Jake Farrell,2011-04-26 15:44:50+00:00,['b0cdd91a8365a001d0719cce21ddafaa8fd28fc0'],1,12,13,413937,1,,,,1411
b34b83e89d678b5d3ed1a91c2c9071fbb75c6b31,0,Roger Meier,2011-04-27 20:14:33+00:00,['6ece9be5c7c5a1e4a1169dfa7f98ff1bbbe1fc47'],21,21,42,413979,1,,,,1411
05e0cdb4542b9ae0c3db0d841004b4acc1a73033,0,Jake Farrell,2011-05-05 13:45:26+00:00,['b34b83e89d678b5d3ed1a91c2c9071fbb75c6b31'],0,7,7,413986,1,,,,1411
aeb4411d1cb9914b7a3985726d47733d2ab511a5,0,Jake Farrell,2011-05-19 19:23:26+00:00,['05e0cdb4542b9ae0c3db0d841004b4acc1a73033'],1,2,3,413989,1,0,0,0,1411
c023d90e3ba48f6d77b27719aab5bc58c926f7db,0,Jake Farrell,2011-05-20 19:04:13+00:00,['aeb4411d1cb9914b7a3985726d47733d2ab511a5'],35,149,184,414173,3,,,,1411
5860f8850e049a22e69022697a899958aa00b534,0,Roger Meier,2011-05-22 09:59:34+00:00,['c023d90e3ba48f6d77b27719aab5bc58c926f7db'],3,3,6,414179,2,,,,1411
b9e47c4ba9750dbfc63d0f6d7aac9a9c83734716,1,Bryan Duxbury,2011-05-23 18:30:06+00:00,['5860f8850e049a22e69022697a899958aa00b534'],1,1,2,414181,1,,,,1411
9a42239eec13ae69ed6cd8b623bf438d2a5b9d74,1,Bryan Duxbury,2011-05-23 21:41:02+00:00,['b9e47c4ba9750dbfc63d0f6d7aac9a9c83734716'],2,12,14,414195,2,0,0.714285714,0.285714286,1411
210d766d896849696e47c174df45686265e679d9,1,Jake Farrell,2011-05-25 21:07:29+00:00,['9a42239eec13ae69ed6cd8b623bf438d2a5b9d74'],9,15,24,414219,2,,,,1411
b94b5514b54581cc207cfcbeea352c050de68e67,0,Roger Meier,2011-05-30 20:14:00+00:00,['210d766d896849696e47c174df45686265e679d9'],2,0,2,414221,1,,,,1411
911d2f1576197fbc4cc0f6b98c0fd5998400f906,1,Bryan Duxbury,2011-05-31 20:03:29+00:00,['b94b5514b54581cc207cfcbeea352c050de68e67'],25,106,131,414352,2,0.203125,0,0.328125,1411
462af9de2a8d2f46288b84e3d6ce34a1986d8fd7,0,Roger Meier,2011-05-31 20:33:51+00:00,['911d2f1576197fbc4cc0f6b98c0fd5998400f906'],4,6,10,414362,1,0,0,0,1411
bb09f4442a783d9e9d8d46501b9e2f40ecf6e4ae,1,Roger Meier,2011-05-31 20:35:37+00:00,['462af9de2a8d2f46288b84e3d6ce34a1986d8fd7'],24,15,39,414401,8,1,0.5,0,1411
5075a196770acda37ad75c23913f3d49973db35a,0,Bryan Duxbury,2011-06-01 17:19:57+00:00,['bb09f4442a783d9e9d8d46501b9e2f40ecf6e4ae'],5,6,11,414412,1,,,,1411
fb1412d916a68dd4aa249cd93b793e4dcfebda0c,0,Bryan Duxbury,2011-06-01 17:23:33+00:00,['5075a196770acda37ad75c23913f3d49973db35a'],1,1,2,414414,1,,,,1411
5218cc17427b81bcadbc9bc32e56ef6a4755e92e,1,Bryan Duxbury,2011-06-01 17:43:39+00:00,['fb1412d916a68dd4aa249cd93b793e4dcfebda0c'],1,7,8,414422,1,0,0,1,1411
c1fe30b94f529bbd56d69e1e17c4e9aef4037df2,0,Jake Farrell,2011-06-01 20:34:26+00:00,['5218cc17427b81bcadbc9bc32e56ef6a4755e92e'],1,1,2,414424,1,,,,1411
73b8dfc92ce2ca51d098e3780d84665698a4a94d,0,Jake Farrell,2011-06-02 16:13:18+00:00,['c1fe30b94f529bbd56d69e1e17c4e9aef4037df2'],103,3,106,414530,2,,,,1411
5309bd022959bed1592d3d70da97eaebc98aa282,0,Jake Farrell,2011-06-03 17:03:00+00:00,['73b8dfc92ce2ca51d098e3780d84665698a4a94d'],2,15,17,414547,1,,,,1411
18f1050e71894472ff4ce70fa3b393fa2c77e3cd,1,Roger Meier,2011-06-04 08:57:43+00:00,['5309bd022959bed1592d3d70da97eaebc98aa282'],5,11,16,414563,2,0,0,1,1411
1ebeffb0d8be47c9e37579d89a39968008df9b2e,1,Roger Meier,2011-06-06 18:00:03+00:00,['18f1050e71894472ff4ce70fa3b393fa2c77e3cd'],5,5,10,414573,1,,,,1411
ca142b0bc812394d91d3a07e4e8b6d0b306d5d4b,1,Roger Meier,2011-06-07 17:59:07+00:00,['1ebeffb0d8be47c9e37579d89a39968008df9b2e'],106,196,302,414875,3,0,0,1,1411
63c2d378c53ab7340466495b49451e68a7411c6c,0,Bryan Duxbury,2011-06-08 17:46:55+00:00,['ca142b0bc812394d91d3a07e4e8b6d0b306d5d4b'],0,32,32,414907,2,0,1,1,1411
b7c69711e70e1337d0587ac3b50b283ca860a19d,0,Bryan Duxbury,2011-06-08 22:53:11+00:00,['63c2d378c53ab7340466495b49451e68a7411c6c'],1,1,2,414909,1,,,,1411
aad0d6510c0f349c9c9d93fa044b1f8d5a15dbd1,1,Bryan Duxbury,2011-06-08 23:51:24+00:00,['b7c69711e70e1337d0587ac3b50b283ca860a19d'],9,4,13,414922,1,1,0,0,1411
f3138ad24b124446814167d12fb5004691cf4024,1,Bryan Duxbury,2011-06-09 00:21:55+00:00,['aad0d6510c0f349c9c9d93fa044b1f8d5a15dbd1'],2,2,4,414926,1,,,,1411
9579b6492256f09d221b6394f4b0c68ae938565c,1,Bryan Duxbury,2011-06-09 00:36:55+00:00,['f3138ad24b124446814167d12fb5004691cf4024'],68,66,134,415060,1,1,1,0,1411
7a79d39957376b7435a713227963dcb90a7ef3f5,0,Bryan Duxbury,2011-06-09 00:40:47+00:00,['9579b6492256f09d221b6394f4b0c68ae938565c'],3,4,7,415067,1,1,1,1,1411
38dcb685e15fe8fc562152b8cd5d707106591b56,0,Jake Farrell,2011-06-09 18:55:12+00:00,['7a79d39957376b7435a713227963dcb90a7ef3f5'],4,20,24,415091,1,0,0,0,1411
3ad8081af4eee1372eee41cd980cb58f4bc757f5,0,Jake Farrell,2011-06-09 19:14:22+00:00,['38dcb685e15fe8fc562152b8cd5d707106591b56'],1,1,2,415093,1,,,,1411
af7804e29acc0d8a092e092f6b9e057afbc343ff,0,Roger Meier,2011-06-09 21:35:11+00:00,['3ad8081af4eee1372eee41cd980cb58f4bc757f5'],1,3,4,415097,1,0,1,1,1411
df8a0e6fca0dd0513a1b89a2feaf03f9a0056416,0,Bryan Duxbury,2011-06-09 22:46:28+00:00,['af7804e29acc0d8a092e092f6b9e057afbc343ff'],6,12,18,415115,5,0,1,1,1411
9d8e8f87ed0648c48357c76bf6abccb6e2e964a6,1,Roger Meier,2011-06-14 19:38:27+00:00,['df8a0e6fca0dd0513a1b89a2feaf03f9a0056416'],25,31,56,415171,4,0,0,0,1411
6e292e5bfa4f06b63eb39afb266eeda6807250fc,0,Bryan Duxbury,2011-06-15 20:34:53+00:00,['9d8e8f87ed0648c48357c76bf6abccb6e2e964a6'],1,3,4,415175,1,,,,1411
d1df20a20d1f23321bfdd9ca06ab03a71ceba51d,0,Bryan Duxbury,2011-06-15 20:52:57+00:00,['6e292e5bfa4f06b63eb39afb266eeda6807250fc'],14,17,31,415206,5,1,1,1,1411
a1c416fbbd46d632376bd47d5dca908904e8cba8,1,Roger Meier,2011-06-17 19:40:48+00:00,['d1df20a20d1f23321bfdd9ca06ab03a71ceba51d'],0,28,28,415234,1,0.6,1,1,1411
3d3f42103ca2427da24f32d896e545618ae769eb,1,Anthony F. Molinaro,2011-06-18 03:54:04+00:00,['a1c416fbbd46d632376bd47d5dca908904e8cba8'],59,90,149,415383,2,,,,1411
e49a44ab1d8a386909ad6f52f503374041a2b583,0,Anthony F. Molinaro,2011-06-18 06:04:01+00:00,['3d3f42103ca2427da24f32d896e545618ae769eb'],1,31,32,415415,4,,,,1413
4b212b4b7f2f33277bcefcd68f3c678b2f9cff34,0,Bryan Duxbury,2011-06-20 21:42:17+00:00,['e49a44ab1d8a386909ad6f52f503374041a2b583'],2,7,9,415424,1,,,,1413
76bd0050ce96f7f7bf243c8a967d2e27bebb1726,0,Anthony F. Molinaro,2011-06-20 22:03:40+00:00,['4b212b4b7f2f33277bcefcd68f3c678b2f9cff34'],1,1,2,415426,1,,,,1413
0680a836344a4d3927131d26c1b38c2d7b379517,0,Roger Meier,2011-06-21 04:42:43+00:00,['76bd0050ce96f7f7bf243c8a967d2e27bebb1726'],3,13,16,415442,1,,,,1413
917d89825f1e4345b08c73a0159c4bd5a158a25c,1,Anthony F. Molinaro,2011-06-21 06:20:18+00:00,['0680a836344a4d3927131d26c1b38c2d7b379517'],274,168,442,415884,17,,,,1417
2079bfe71296d4aa357b461e07c67bdc09d4fa5b,0,Roger Meier,2011-06-21 14:09:13+00:00,['917d89825f1e4345b08c73a0159c4bd5a158a25c'],2,2,4,415888,2,,,,1417
8588624d0f089719abc9d893306cf98178365bad,0,Anthony F. Molinaro,2011-06-21 17:05:05+00:00,['2079bfe71296d4aa357b461e07c67bdc09d4fa5b'],1,2,3,415891,1,,,,1417
49c06dd9274a00d4c0e146879f473ea5cf8a0261,0,Anthony F. Molinaro,2011-06-22 16:44:19+00:00,['8588624d0f089719abc9d893306cf98178365bad'],2,3,5,415896,1,,,,1417
e594bf7e20bf10621b2b8e4455d7b252c55f9dd6,1,Roger Meier,2011-06-22 23:01:02+00:00,['49c06dd9274a00d4c0e146879f473ea5cf8a0261'],3,1,4,415900,1,,,,1417
439db4dd631f6f3998f48fec5dd3321d52d636e2,0,Anthony F. Molinaro,2011-06-23 17:43:05+00:00,['e594bf7e20bf10621b2b8e4455d7b252c55f9dd6'],2,0,2,415902,1,,,,1417
3c9530c3fae2aade63cd2f36868db8d126776688,0,Bryan Duxbury,2011-06-23 21:20:34+00:00,['439db4dd631f6f3998f48fec5dd3321d52d636e2'],1,1,2,415904,1,,,,1417
35dd47bc7e92e4680de208f2277a1f5de7643634,0,Bryan Duxbury,2011-06-23 22:21:20+00:00,['3c9530c3fae2aade63cd2f36868db8d126776688'],1,6,7,415911,1,,,,1417
dfb8ba482e23077b0f3b1ec73d7cd0d3f6d401a1,0,Jake Farrell,2011-06-24 12:58:47+00:00,['35dd47bc7e92e4680de208f2277a1f5de7643634'],10,1,11,415922,1,0,0,0,1417
d3b9dca285cd4642f676d4e7642ac2e8e55eb836,1,Roger Meier,2011-06-24 14:01:10+00:00,['dfb8ba482e23077b0f3b1ec73d7cd0d3f6d401a1'],154,139,293,416215,9,1,1,1,1418
4d116e18e7682305ce7802117370cf532e510e63,0,Jake Farrell,2011-06-27 18:44:04+00:00,['d3b9dca285cd4642f676d4e7642ac2e8e55eb836'],2,2,4,416219,1,,,,1418
82dc2e2e96807965ea6061c0da973b5313195608,0,Bryan Duxbury,2011-06-28 17:43:30+00:00,['4d116e18e7682305ce7802117370cf532e510e63'],100,1,101,416320,2,0,0,0,1418
ad0ad824d2fb8c68b77e4a8a982225cf879f878d,1,Bryan Duxbury,2011-06-28 18:46:03+00:00,['82dc2e2e96807965ea6061c0da973b5313195608'],51,251,302,416622,15,0.697183099,1,0.774647887,1418
2323aa9c1cd7926d68b487013f847b4b2bf85bb0,0,Bryan Duxbury,2011-06-30 18:59:18+00:00,['ad0ad824d2fb8c68b77e4a8a982225cf879f878d'],5,8,13,416635,1,1,1,1,1418
d580dc6b8a4a456669a3695ffe2755644ddee1cf,0,Bryan Duxbury,2011-06-30 20:47:09+00:00,['2323aa9c1cd7926d68b487013f847b4b2bf85bb0'],5,0,5,416640,1,,,,1418
0266416dbf8e815a5ef9f9db1eb2868065b45d8a,0,Bryan Duxbury,2011-06-30 20:48:30+00:00,['d580dc6b8a4a456669a3695ffe2755644ddee1cf'],0,0,0,416640,0,,,,1418
57a45ab3d39388eb8dd9935bf478861df461f9e9,0,Roger Meier,2011-07-02 08:53:05+00:00,['0266416dbf8e815a5ef9f9db1eb2868065b45d8a'],0,0,0,416640,0,,,,1418
0bb3db2eedc2ae91088b6caffc2b75fb3a2a5e27,1,Roger Meier,2011-07-02 22:33:32+00:00,['57a45ab3d39388eb8dd9935bf478861df461f9e9'],2,49,51,416691,1,,,,1418
30aae0ca877c9f5863ff881b29edc6a38df9d85a,1,Roger Meier,2011-07-08 12:23:31+00:00,['0bb3db2eedc2ae91088b6caffc2b75fb3a2a5e27'],21,60,81,416772,2,1,0,1,1418
6b0d4567167f689de4a3bd2f7475de0fd82d3bdc,0,Roger Meier,2011-07-08 12:44:29+00:00,['30aae0ca877c9f5863ff881b29edc6a38df9d85a'],65,59,124,416896,2,0,0,0,1418
9659d4d3b7ec458c6e273eb783ff7cc82adb3102,0,Roger Meier,2011-07-08 12:51:15+00:00,['6b0d4567167f689de4a3bd2f7475de0fd82d3bdc'],0,1,1,416897,1,,,,1418
fd39193aa00d2098184b452bd955bd60ae39f86d,0,Jake Farrell,2011-07-08 17:32:44+00:00,['9659d4d3b7ec458c6e273eb783ff7cc82adb3102'],1,0,1,416898,1,,,,1418
646218507478a0e827d64fea76ef1d7611f9a292,0,Jake Farrell,2011-07-11 13:47:25+00:00,['fd39193aa00d2098184b452bd955bd60ae39f86d'],1,2,3,416901,1,,,,1418
6e48e98580e0034b9e82e5938c31d193280c163e,1,Anthony F. Molinaro,2011-07-12 18:56:15+00:00,['646218507478a0e827d64fea76ef1d7611f9a292'],0,240,240,417141,1,,,,1419
b7bd5626aa1858c3b315c0df252bf67de6923feb,1,Bryan Duxbury,2011-07-13 17:58:05+00:00,['6e48e98580e0034b9e82e5938c31d193280c163e'],44,162,206,417347,9,0.21978022,0.032967033,1,1419
54df97c507aa4fb49523166b477bd82762fd9711,0,Bryan Duxbury,2011-07-13 18:11:29+00:00,['b7bd5626aa1858c3b315c0df252bf67de6923feb'],3,6,9,417356,1,1,1,1,1419
11dfc8bb730e6d9813117cde312f1b8abbeefa36,0,Bryan Duxbury,2011-07-13 18:15:41+00:00,['54df97c507aa4fb49523166b477bd82762fd9711'],0,678,678,418034,1,0.618336887,0.746268657,0.814498934,1420
4e98a258b246d3c17469ab54beb725fb738053e2,0,Bryan Duxbury,2011-07-13 21:17:26+00:00,['11dfc8bb730e6d9813117cde312f1b8abbeefa36'],0,11,11,418045,1,1,1,1,1420
cdbf36c6082a3931e41d5d1fb8ba8b5cb3eade23,0,Jake Farrell,2011-07-14 21:25:08+00:00,['4e98a258b246d3c17469ab54beb725fb738053e2'],2,0,2,418047,1,1,1,0,1420
a35944bfe2fabda4816e4396f92280ee9fcf789d,1,Roger Meier,2011-07-15 20:16:43+00:00,['cdbf36c6082a3931e41d5d1fb8ba8b5cb3eade23'],9,59,68,418115,3,0.9,1,1,1420
7e056e7572c642bd7f5d5677261763f05a17e1dd,1,Roger Meier,2011-07-17 07:28:28+00:00,['a35944bfe2fabda4816e4396f92280ee9fcf789d'],13,226,239,418354,7,0.86,0.86,0.693333333,1420
1e20e9f589f7a79b1e355c75fb66b44cdf512fc4,0,Roger Meier,2011-07-17 14:47:48+00:00,['7e056e7572c642bd7f5d5677261763f05a17e1dd'],0,1,1,418355,1,,,,1420
a8cef6e55bcbcf7045adbc3ccca5e59e7c504f6b,1,Roger Meier,2011-07-17 18:55:59+00:00,['1e20e9f589f7a79b1e355c75fb66b44cdf512fc4'],14,51,65,418420,12,0.228571429,0.8,0.457142857,1420
9623fc5476b8c7225b7d9f543d631e5240891f99,0,Jake Farrell,2011-07-25 13:22:14+00:00,['a8cef6e55bcbcf7045adbc3ccca5e59e7c504f6b'],1,1,2,418422,1,,,,1420
285cfaa19943c168f7400424a8abde37da2e143f,1,Roger Meier,2011-07-28 17:51:36+00:00,['9623fc5476b8c7225b7d9f543d631e5240891f99'],16,17,33,418455,4,1,1,1,1420
d2f8da4bb8d0c48bbbc0bf0cbe97b3dc1c84188c,0,Roger Meier,2011-07-28 18:04:30+00:00,['285cfaa19943c168f7400424a8abde37da2e143f'],3,9,12,418467,1,1,1,1,1420
3da317bda100130b2f615034c46b0944888f0f14,1,Roger Meier,2011-07-28 18:35:51+00:00,['d2f8da4bb8d0c48bbbc0bf0cbe97b3dc1c84188c'],2,3,5,418472,1,,,,1420
040b12483ab37ebb9d8c0e0251b17b6540783b66,0,Roger Meier,2011-07-28 18:49:39+00:00,['3da317bda100130b2f615034c46b0944888f0f14'],0,1,1,418473,1,0,0,1,1420
0b26725ceb2c47e0b006d50a83f561e175bc6ba8,1,Roger Meier,2011-07-29 21:08:04+00:00,['040b12483ab37ebb9d8c0e0251b17b6540783b66'],4,125,129,418602,3,0.946428571,0.696428571,0.839285714,1421
bb267d48e0934d486e4276d90326e385495cc2ec,1,Roger Meier,2011-07-30 15:10:42+00:00,['0b26725ceb2c47e0b006d50a83f561e175bc6ba8'],376,390,766,419368,3,0.777777778,1,1,1422
472f9e190c982454642e4edeca49b136722b27ef,1,Roger Meier,2011-08-02 10:55:47+00:00,['bb267d48e0934d486e4276d90326e385495cc2ec'],3,8,11,419379,2,1,1,1,1422
d9b32835eac9fbdc54133ed9791671fa8a5c4b4d,0,Bryan Duxbury,2011-08-02 20:51:55+00:00,['472f9e190c982454642e4edeca49b136722b27ef'],1,1,2,419381,1,,,,1422
4e0192f660bfd83921842a9e59d04c681100156a,0,Bryan Duxbury,2011-08-02 22:37:16+00:00,['d9b32835eac9fbdc54133ed9791671fa8a5c4b4d'],4,4,8,419389,1,,,,1422
b342ddf00b9abc318c1075a8942928f1ef324f7f,1,Bryan Duxbury,2011-08-02 23:10:32+00:00,['4e0192f660bfd83921842a9e59d04c681100156a'],1,7,8,419397,1,0,0,1,1422
c1905587872fe7a78adcc9d8c6d0c091ac7b80cc,0,Roger Meier,2011-08-02 23:37:36+00:00,['b342ddf00b9abc318c1075a8942928f1ef324f7f'],4,11,15,419412,2,0,1,0.5,1422
345ecc739ab145f9a0e7c27bbcb4ee72ccd3a86b,0,Roger Meier,2011-08-03 09:49:27+00:00,['c1905587872fe7a78adcc9d8c6d0c091ac7b80cc'],6,37,43,419455,12,,,,1422
9e0f0743f377e59ee2aa21666c18bb3b092661f5,1,Roger Meier,2011-08-03 17:36:55+00:00,['345ecc739ab145f9a0e7c27bbcb4ee72ccd3a86b'],0,6,6,419461,2,,,,1422
184281c1a1a9a1f1fe0cbbdf4a97926936082028,0,Roger Meier,2011-08-03 20:12:32+00:00,['9e0f0743f377e59ee2aa21666c18bb3b092661f5'],0,11,11,419472,1,0,0,1,1422
edf0d1dda0002e1b7b9d036855d750a1838a42f8,1,Roger Meier,2011-08-03 21:21:43+00:00,['184281c1a1a9a1f1fe0cbbdf4a97926936082028'],519,117,636,420108,5,0.836956522,0.570652174,0.10326087,1423
52e751d13799c5b170ebe44aff5635bb32ee2bc4,0,Roger Meier,2011-08-04 21:23:27+00:00,['edf0d1dda0002e1b7b9d036855d750a1838a42f8'],15,4,19,420127,1,1,1,0,1423
3075ffc5631dd173f5f258312bf9943d06e82d0f,0,Roger Meier,2011-08-04 22:36:07+00:00,['52e751d13799c5b170ebe44aff5635bb32ee2bc4'],1,1,2,420129,1,0,0,1,1423
013b2e55385119533dac324358157b6cd80f1838,0,Roger Meier,2011-08-04 22:37:16+00:00,['3075ffc5631dd173f5f258312bf9943d06e82d0f'],2,2,4,420133,1,,,,1423
de8d1857e8492f8d25abfb11a68ba9c90a49d99a,1,Roger Meier,2011-08-04 23:08:35+00:00,['013b2e55385119533dac324358157b6cd80f1838'],56,102,158,420291,1,0.592592593,0,0.62962963,1423
f32d13a9ad5508dcee627a9f0621316e1d523d20,0,Jake Farrell,2011-08-10 17:10:32+00:00,['de8d1857e8492f8d25abfb11a68ba9c90a49d99a'],0,0,0,420291,0,,,,1423
7ac3d728bd2c8329674631b8d61a42d70eafb27f,0,Jake Farrell,2011-08-10 19:27:38+00:00,['f32d13a9ad5508dcee627a9f0621316e1d523d20'],1,129,130,420421,2,,,,1423
1121b47c09470a454a28a46825f92ef29c4dc273,1,Bryan Duxbury,2011-08-11 18:50:58+00:00,['de8d1857e8492f8d25abfb11a68ba9c90a49d99a'],546,910,1456,421877,10,0.573170732,0.5,0.841463415,1429
dfffdd8726cbf7b6a309ab354c638ede92d2f215,0,Bryan Duxbury,2011-08-11 18:54:11+00:00,['1121b47c09470a454a28a46825f92ef29c4dc273'],3,3,6,421883,2,,,,1429
be81e01f285684ec831fb30e121117335f2b2d2f,0,Jake Farrell,2011-08-11 19:09:13+00:00,['7ac3d728bd2c8329674631b8d61a42d70eafb27f'],25,29,54,421937,7,,,,1429
c5555a280134b0664615ebcb1ffee838eaa7c09b,0,Jake Farrell,2011-08-11 19:11:26+00:00,['dfffdd8726cbf7b6a309ab354c638ede92d2f215'],3,0,3,421940,1,,,,1429
ea3b5707cdbac60cc8d108a6e61c6cbac1f1b378,0,Jake Farrell,2011-08-11 20:58:39+00:00,['be81e01f285684ec831fb30e121117335f2b2d2f'],0,1,1,421941,1,,,,1429
9c762585643681eea62fb94649885efcdd973c5b,1,Jake Farrell,2011-08-13 21:29:36+00:00,['c5555a280134b0664615ebcb1ffee838eaa7c09b'],8,143,151,422092,10,,,,1429
aac34848b9ac2a61ab37f4e31c7d6773d57d02d4,0,Jake Farrell,2011-08-13 22:24:26+00:00,['ea3b5707cdbac60cc8d108a6e61c6cbac1f1b378'],1,1,2,422094,1,,,,1429
74362e0e8af69fb78b8fbf170cf4505ce6b3e4c3,0,Jake Farrell,2011-08-16 17:13:41+00:00,['9c762585643681eea62fb94649885efcdd973c5b'],7,6,13,422107,1,,,,1429
ff1c69bc1ca625a5bc0e3cb12d678f86920fc488,1,Jake Farrell,2011-08-17 19:00:33+00:00,['74362e0e8af69fb78b8fbf170cf4505ce6b3e4c3'],16,28,44,422151,1,,,,1429
69bba6ef4630674f8dea0201ffdafe511278404b,0,Jake Farrell,2011-08-17 19:00:33+00:00,['aac34848b9ac2a61ab37f4e31c7d6773d57d02d4'],19,31,50,422201,1,,,,1429
c7206a40117da7d1f4a8a98ea52099825bea3b45,1,Bryan Duxbury,2011-08-17 23:17:04+00:00,['ff1c69bc1ca625a5bc0e3cb12d678f86920fc488'],7,70,77,422278,4,0,0.6,1,1429
5fc71fd56a522dc2e1b0be5012848276bc105752,1,Bryan Duxbury,2011-08-18 00:02:50+00:00,['c7206a40117da7d1f4a8a98ea52099825bea3b45'],556,1294,1850,424128,6,0.701538462,0.867692308,0.966153846,1433
b6af6dbf0579a0b2cf3577f160c1a99d036df2bb,0,Roger Meier,2011-08-18 20:31:16+00:00,['5fc71fd56a522dc2e1b0be5012848276bc105752'],0,3,3,424131,1,1,1,1,1433
887ff756cb6ead9d5b764064ffc4973be8065b59,0,Roger Meier,2011-08-19 11:25:39+00:00,['b6af6dbf0579a0b2cf3577f160c1a99d036df2bb'],1,18,19,424150,3,0,0.333333333,1,1433
0b7eeb59750fef5be018e6ec406da2da5be13c1b,0,Bryan Duxbury,2011-08-19 18:23:39+00:00,['887ff756cb6ead9d5b764064ffc4973be8065b59'],2,9,11,424161,1,,,,1433
235f8b5899b2c5b75cb83975695da1377f0cac0c,0,Bryan Duxbury,2011-08-19 18:27:47+00:00,['0b7eeb59750fef5be018e6ec406da2da5be13c1b'],0,9,9,424170,1,,,,1433
160cbe67184f81cf1b638ea485300c283b6b9954,0,Bryan Duxbury,2011-08-19 18:32:51+00:00,['235f8b5899b2c5b75cb83975695da1377f0cac0c'],4,4,8,424178,1,,,,1433
da9c6e1aba082e0026a636685f1401c1fe3d97a5,0,Bryan Duxbury,2011-08-22 16:59:20+00:00,['160cbe67184f81cf1b638ea485300c283b6b9954'],4,0,4,424182,1,1,1,1,1433
0c3c8959a3b87b0965755ec84ed48af1fe0cbb31,0,Roger Meier,2011-08-22 21:38:16+00:00,['da9c6e1aba082e0026a636685f1401c1fe3d97a5'],0,1,1,424183,1,,,,1433
a94d2e5921b6bba6c0a677955edc310fb700be14,0,Roger Meier,2011-08-22 21:38:50+00:00,['0c3c8959a3b87b0965755ec84ed48af1fe0cbb31'],6,32,38,424221,1,0,0,0,1433
b7d7227eb0b11f3a8009d45fbbc7745ad2cbfb8c,0,Roger Meier,2011-08-23 20:27:19+00:00,['a94d2e5921b6bba6c0a677955edc310fb700be14'],14,16,30,424251,9,,,,1433
1b90e3dc25b22cc7b8057b85a0cfa6d524abaad0,0,Bryan Duxbury,2011-08-23 23:21:59+00:00,['b7d7227eb0b11f3a8009d45fbbc7745ad2cbfb8c'],48,101,149,424400,1,0,0,0,1433
8eebc2c3e0abdf1be46254bd7bf912b63c2cf8cb,0,Bryan Duxbury,2011-08-23 23:26:58+00:00,['1b90e3dc25b22cc7b8057b85a0cfa6d524abaad0'],45,46,91,424491,1,0,0,1,1433
bce6fadf3b1c237aab4b65d3d99b72520ba79689,1,Bryan Duxbury,2011-08-24 00:22:30+00:00,['8eebc2c3e0abdf1be46254bd7bf912b63c2cf8cb'],6,16,22,424513,2,,,,1433
0fa8ff7fd44b127c3e2e4de6bca8d334f3a0a162,0,Bryan Duxbury,2011-08-24 00:28:18+00:00,['bce6fadf3b1c237aab4b65d3d99b72520ba79689'],2,5,7,424520,2,0.333333333,1,0.666666667,1433
3746b29b8a4358d28944b0f23642ce940455c6d2,1,Bryan Duxbury,2011-08-24 00:35:52+00:00,['0fa8ff7fd44b127c3e2e4de6bca8d334f3a0a162'],21,101,122,424642,2,1,1,1,1433
b68f16634a013ab057c652255e571eed5d8677b8,0,Bryan Duxbury,2011-08-24 18:35:55+00:00,['3746b29b8a4358d28944b0f23642ce940455c6d2'],130,216,346,424988,1,1,1,0,1433
cff83579d73d6673a933fbb4379f034404804a9a,0,Bryan Duxbury,2011-08-24 20:53:03+00:00,['b68f16634a013ab057c652255e571eed5d8677b8'],1,2,3,424991,2,,,,1433
76c43688ba909af175e80635a5c38ff021cce7e5,1,Bryan Duxbury,2011-08-24 21:26:48+00:00,['cff83579d73d6673a933fbb4379f034404804a9a'],1,46,47,425038,2,0,1,1,1433
37874ca8486cdce5a4b7f87c9c0b2fb3516aee5b,0,Bryan Duxbury,2011-08-25 17:28:23+00:00,['76c43688ba909af175e80635a5c38ff021cce7e5'],2,2,4,425042,1,,,,1433
756d73e464e74807f896f160615d5af2117e24a7,1,Bryan Duxbury,2011-08-25 17:30:21+00:00,['37874ca8486cdce5a4b7f87c9c0b2fb3516aee5b'],2,4,6,425048,1,0,0,1,1433
1e9875878aee4218fbbc8fbc768e86b25c8d9ef5,1,Bryan Duxbury,2011-08-25 17:33:03+00:00,['756d73e464e74807f896f160615d5af2117e24a7'],26,26,52,425100,4,,,,1433
e04159c52b31bb263cb0bb37895854bb3905d0ce,0,Bryan Duxbury,2011-08-25 17:43:56+00:00,['1e9875878aee4218fbbc8fbc768e86b25c8d9ef5'],6,9,15,425115,1,0,0,1,1433
6df4d34447e183570765550639e97666c273b203,0,Jake Farrell,2011-08-25 22:02:38+00:00,['e04159c52b31bb263cb0bb37895854bb3905d0ce'],1,0,1,425116,1,,,,1433
b5c618a66d296a9503bf3e33307150ddc120ac9d,0,Jake Farrell,2011-08-26 02:42:14+00:00,['6df4d34447e183570765550639e97666c273b203'],0,1,1,425117,1,1,1,1,1433
13b21184f4b24c48db19408d79339c6ede01a027,0,Jake Farrell,2011-08-28 18:24:45+00:00,['b5c618a66d296a9503bf3e33307150ddc120ac9d'],1,1,2,425119,1,,,,1433
47f5ab3f060463b947144fd7ba1d3899b963a3c7,0,Jake Farrell,2011-08-29 15:27:41+00:00,['13b21184f4b24c48db19408d79339c6ede01a027'],1,1,2,425121,1,,,,1433
b8c8e0b9bcb576f02a2a2741be1927b60e900d4e,0,Bryan Duxbury,2011-08-29 17:50:31+00:00,['47f5ab3f060463b947144fd7ba1d3899b963a3c7'],17,266,283,425404,3,1,1,0.416666667,1434
c7fed1f90c242b6b77321b7ecc4744872a7cceff,0,Bryan Duxbury,2011-08-29 18:01:24+00:00,['b8c8e0b9bcb576f02a2a2741be1927b60e900d4e'],78,51,129,425533,1,1,0,1,1434
9759266f2da68ce665b3b050cf5d8f37f8fc556f,0,Bryan Duxbury,2011-08-29 18:05:26+00:00,['c7fed1f90c242b6b77321b7ecc4744872a7cceff'],3,4,7,425540,1,1,1,1,1434
012dfdab4cdc1cae4b23cfed91b9ade8a9c8aacb,1,Jake Farrell,2011-08-29 18:18:55+00:00,['9759266f2da68ce665b3b050cf5d8f37f8fc556f'],1,10,11,425551,1,,,,1434
6993569d0405bfb9801d7e5e09e2468badab271e,0,Jake Farrell,2011-08-29 18:22:11+00:00,['012dfdab4cdc1cae4b23cfed91b9ade8a9c8aacb'],0,1,1,425552,1,,,,1434
2cb3913f998350922630a354444101b4311ff676,0,Jake Farrell,2011-08-29 18:34:41+00:00,['6993569d0405bfb9801d7e5e09e2468badab271e'],10,6,16,425568,1,,,,1434
489f8f1d5961419d895cb6939b702a5e04efee66,0,Bryan Duxbury,2011-08-29 18:50:12+00:00,['2cb3913f998350922630a354444101b4311ff676'],1,2,3,425571,1,0,0,1,1434
526fa8e47f55bb74c87ff8a801204bbb91d50ba1,1,Bryan Duxbury,2011-08-29 20:28:23+00:00,['489f8f1d5961419d895cb6939b702a5e04efee66'],285,291,576,426147,2,0.4,1,0.4,1434
9c39f7765e73efa7d379cda1c2ab141f2f7040e7,1,Jake Farrell,2011-08-30 19:12:10+00:00,['526fa8e47f55bb74c87ff8a801204bbb91d50ba1'],1727,96,1823,427970,8,0.233716475,0.137931034,0.068007663,1436
266b1737a5ce7ecdafdf5274f66bd46315f7dfde,0,Bryan Duxbury,2011-09-01 16:50:28+00:00,['9c39f7765e73efa7d379cda1c2ab141f2f7040e7'],7,9,16,427986,2,,,,1436
c58c9e8e41051fa673d3b4ae7656e5471c39b786,0,Bryan Duxbury,2011-09-01 16:52:56+00:00,['266b1737a5ce7ecdafdf5274f66bd46315f7dfde'],1,2,3,427989,1,,,,1436
2173ce025062692bb4f5525373f25ffacf1f9930,1,Bryan Duxbury,2011-09-01 18:00:37+00:00,['c58c9e8e41051fa673d3b4ae7656e5471c39b786'],0,189,189,428178,2,0.068376068,0.982905983,0.982905983,1436
6dd9cd0e3bb0bac0d4a70594956d035b75d4d7c8,0,Bryan Duxbury,2011-09-01 18:06:20+00:00,['2173ce025062692bb4f5525373f25ffacf1f9930'],14,89,103,428281,6,0.615384615,0.653846154,0.576923077,1436
7a9fb8179685ed7d82bf2f60ddd39157cdaf1d82,1,Bryan Duxbury,2011-09-01 18:31:53+00:00,['6dd9cd0e3bb0bac0d4a70594956d035b75d4d7c8'],91,351,442,428723,8,0.897297297,1,0.027027027,1436
adaf82615bb0c59435dc5857541941d2a0b426c7,0,Bryan Duxbury,2011-09-01 18:54:07+00:00,['7a9fb8179685ed7d82bf2f60ddd39157cdaf1d82'],5,3,8,428731,2,,,,1436
267c181c6a029b45a0ab199d22804a908a993580,0,Roger Meier,2011-09-02 20:33:33+00:00,['adaf82615bb0c59435dc5857541941d2a0b426c7'],2,1,3,428734,2,1,1,0,1436
212022cce6f31e363aa80c7b23336727b953d76f,0,Roger Meier,2011-09-02 21:45:44+00:00,['267c181c6a029b45a0ab199d22804a908a993580'],3,19,22,428756,1,1,1,1,1436
2fa9c31e065fc35186c92c5d8b8c078b4f8d5a5f,0,Roger Meier,2011-09-05 19:15:53+00:00,['212022cce6f31e363aa80c7b23336727b953d76f'],4,103,107,428863,17,,,,1436
c4beda980278118b3a4348dc5113de56567df061,1,Jake Farrell,2011-09-06 15:19:18+00:00,['2fa9c31e065fc35186c92c5d8b8c078b4f8d5a5f'],4,6,10,428873,1,0,0,0,1436
eb7a755af4cb983e130194985c7f54a742ece889,0,Jake Farrell,2011-09-06 16:26:58+00:00,['c4beda980278118b3a4348dc5113de56567df061'],4,4,8,428881,1,,,,1436
f0998737041274c821169e1d678316e3fac8d123,0,Bryan Duxbury,2011-09-07 18:12:34+00:00,['eb7a755af4cb983e130194985c7f54a742ece889'],4,22,26,428907,2,0,1,1,1436
251939c6b1b2fc72ce47da97dc7f9844cbd93e16,0,Jake Farrell,2011-09-08 16:57:40+00:00,['f0998737041274c821169e1d678316e3fac8d123'],2,2,4,428911,1,,,,1436
4013fa3117546536bc21f469100e144f20d50f01,0,Jake Farrell,2011-09-09 04:10:32+00:00,['251939c6b1b2fc72ce47da97dc7f9844cbd93e16'],4,11,15,428926,2,0.8,0.8,0.8,1436
2e9f5105b8c12ba59d6494963ec9ce389558a6f3,0,Jake Farrell,2011-09-09 04:32:36+00:00,['4013fa3117546536bc21f469100e144f20d50f01'],1,1,2,428928,1,,,,1436
6869112f5ed4f5b91b1a67f4f835d497c0440ff4,1,Roger Meier,2011-09-09 06:19:35+00:00,['2e9f5105b8c12ba59d6494963ec9ce389558a6f3'],0,6,6,428934,2,,,,1436
4f8a523fa00eee667c32c2b61473c0f5efc98399,1,Roger Meier,2011-09-09 08:17:02+00:00,['6869112f5ed4f5b91b1a67f4f835d497c0440ff4'],8,27,35,428969,3,0.647058824,0,0.647058824,1436
08077bf9d8c6c212f5ff384c94423b6f76892358,0,Roger Meier,2011-09-11 07:28:54+00:00,['4f8a523fa00eee667c32c2b61473c0f5efc98399'],16,54,70,429039,2,0,0,1,1436
b288050682c33761a96682c84f4e4edd4301e9d1,0,Roger Meier,2011-09-11 09:09:52+00:00,['08077bf9d8c6c212f5ff384c94423b6f76892358'],2,2,4,429043,1,,,,1436
f4eec7a57b4c6ab08a545033fd3840586510ae8b,1,Roger Meier,2011-09-11 18:16:21+00:00,['b288050682c33761a96682c84f4e4edd4301e9d1'],125,758,883,429926,16,0.356741573,0.696629213,0.530898876,1437
a93848b68414c921f50062c970e2c9a5e6914435,0,Roger Meier,2011-09-12 22:20:11+00:00,['f4eec7a57b4c6ab08a545033fd3840586510ae8b'],2,8,10,429936,1,,,,1437
c3f033f40b382e94c99f0cad2e79924bb7ac3e9b,1,Roger Meier,2011-09-13 13:54:05+00:00,['a93848b68414c921f50062c970e2c9a5e6914435'],5,273,278,430214,3,0,0,0,1438
1fd248fa040240189bd99f007a462c2f89f65b60,0,Roger Meier,2011-09-13 13:54:46+00:00,['c3f033f40b382e94c99f0cad2e79924bb7ac3e9b'],2,2,4,430218,1,,,,1438
627f1a00885052a8eb86e52aaf00bc66b5ebacd2,0,Jake Farrell,2011-09-14 03:43:49+00:00,['1fd248fa040240189bd99f007a462c2f89f65b60'],2,16,18,430236,3,,,,1438
32e7b2c7e312b77a95c0550840b464b585536cd1,1,Jake Farrell,2011-09-14 06:19:10+00:00,['627f1a00885052a8eb86e52aaf00bc66b5ebacd2'],1,14,15,430251,2,1,1,0.8,1438
508b31726970bdda43e8fa925b08a2a594046f61,0,Roger Meier,2011-09-16 12:02:57+00:00,['32e7b2c7e312b77a95c0550840b464b585536cd1'],0,9,9,430260,2,,,,1438
84e4a3c1819346dc5e5fcc4c4701e6c43afa1041,1,Roger Meier,2011-09-16 20:58:44+00:00,['508b31726970bdda43e8fa925b08a2a594046f61'],22,1750,1772,432032,27,0.18079096,0.276836158,0.570621469,1461
a653067e8ca6d56116af3ed4613e6f1b26363251,1,Anthony F. Molinaro,2011-09-18 04:57:50+00:00,['84e4a3c1819346dc5e5fcc4c4701e6c43afa1041'],6,670,676,432708,5,,,,1463
7e3b866a3558411e99986144061339c21f6125c0,0,Jake Farrell,2011-09-19 23:38:39+00:00,['a653067e8ca6d56116af3ed4613e6f1b26363251'],7,8,15,432723,2,,,,1463
e80a194c473e94f90b30919da29cbe9b4542e244,0,Bryan Duxbury,2011-09-20 18:45:56+00:00,['7e3b866a3558411e99986144061339c21f6125c0'],2,17,19,432742,4,1,1,1,1463
18784d7ccc323b960a301109c926bffc8616cd33,1,Bryan Duxbury,2011-09-20 22:53:31+00:00,['e80a194c473e94f90b30919da29cbe9b4542e244'],40,219,259,433001,3,0.252252252,1,1,1463
dec8c54f8e30f9b8cddcf6069647eb03ffb06d83,0,Jake Farrell,2011-09-21 00:15:27+00:00,['18784d7ccc323b960a301109c926bffc8616cd33'],111,20,131,433132,3,,,,1463
4bd4f0ec259bdf74d78763766b1dc34bf321665b,1,Jake Farrell,2011-09-22 21:15:02+00:00,['dec8c54f8e30f9b8cddcf6069647eb03ffb06d83'],4,8,12,433144,2,,,,1463
8cd3b1aa3c109dc8b8f1d9eccc46a404d85d1a7e,1,Roger Meier,2011-09-23 14:25:22+00:00,['4bd4f0ec259bdf74d78763766b1dc34bf321665b'],26,406,432,433576,9,1,1,0,1466
52092377395d2c8d763b7c0642efc4ce4eb5f130,0,Jake Farrell,2011-09-23 17:24:00+00:00,['8cd3b1aa3c109dc8b8f1d9eccc46a404d85d1a7e'],2,2,4,433580,1,,,,1466
db3c9249c831ac44b95673b2d91c3f3056766769,0,Roger Meier,2011-09-25 07:16:17+00:00,['52092377395d2c8d763b7c0642efc4ce4eb5f130'],4,26,30,433610,2,0.166666667,0,1,1466
7dcd49f1f9034773c9ee890a579d063e6936b6f5,1,Jake Farrell,2011-09-26 15:29:03+00:00,['db3c9249c831ac44b95673b2d91c3f3056766769'],2,2,4,433614,1,,,,1466
f35741729fb2b28a6dd14d4194e0bfab275f4b85,0,Bryan Duxbury,2011-09-26 20:32:59+00:00,['7dcd49f1f9034773c9ee890a579d063e6936b6f5'],2,2,4,433618,2,,,,1466
40d51a28d7c49074a8c9de585540aa47c2b683ee,1,Bryan Duxbury,2011-09-26 21:29:15+00:00,['f35741729fb2b28a6dd14d4194e0bfab275f4b85'],12,32,44,433662,4,0.75,0.75,1,1466
44b2bb6bb591ee106f1bcbbea328a736a70fdc91,0,Bryan Duxbury,2011-09-27 17:07:19+00:00,['40d51a28d7c49074a8c9de585540aa47c2b683ee'],7,9,16,433678,1,,,,1466
9a1d2f01c6fc7726432292dbec2a741d6a72684c,0,Bryan Duxbury,2011-09-29 22:51:54+00:00,['44b2bb6bb591ee106f1bcbbea328a736a70fdc91'],0,88,88,433766,1,0.135135135,0.135135135,1,1467
3516e0e306c4ae124dba3ed8f997c8820bcd0864,1,Roger Meier,2011-09-30 20:23:34+00:00,['9a1d2f01c6fc7726432292dbec2a741d6a72684c'],1,6,7,433773,1,0,0,1,1467
3faaedf46b0c99096f0a18820782362886530e8e,1,Roger Meier,2011-10-02 10:51:45+00:00,['3516e0e306c4ae124dba3ed8f997c8820bcd0864'],83,762,845,434618,27,0,0,1,1472
20e6ef136e411c3d263d7cbbb8b22bc4de31d8b8,0,Roger Meier,2011-10-03 19:37:09+00:00,['3faaedf46b0c99096f0a18820782362886530e8e'],3,3,6,434624,1,,,,1472
7301eced16c2f1a00b197de1cebb98e146834ea3,0,Jake Farrell,2011-10-04 14:59:40+00:00,['20e6ef136e411c3d263d7cbbb8b22bc4de31d8b8'],1,1,2,434626,1,,,,1472
2ce7f66deab8602b6de2422aaa520a1b2e508e60,0,Jake Farrell,2011-10-07 00:04:56+00:00,['7301eced16c2f1a00b197de1cebb98e146834ea3'],1,1,2,434628,1,,,,1472
336a1599d7e1611edd1dfc93a8a952bbd8717f64,0,Jake Farrell,2011-10-07 00:10:20+00:00,['2ce7f66deab8602b6de2422aaa520a1b2e508e60'],2,2,4,434632,1,,,,1472
b5d94e07c481bacb0de55dfc9c16b2cf86feb25c,0,Jake Farrell,2011-10-07 00:14:34+00:00,['336a1599d7e1611edd1dfc93a8a952bbd8717f64'],2,3,5,434637,1,0,0,1,1472
51700649d0adbd0bbdf407ba251170a29f04e691,0,Jake Farrell,2011-10-07 00:17:25+00:00,['b5d94e07c481bacb0de55dfc9c16b2cf86feb25c'],2,4,6,434643,1,0,1,1,1472
581481f232be3f70945f2333c9a53ae5ea5346f8,0,Jake Farrell,2011-10-07 00:25:46+00:00,['51700649d0adbd0bbdf407ba251170a29f04e691'],1,1,2,434645,1,,,,1472
2361dd17114d1b5211ca4afd7fde03a9ea95b83a,0,Jake Farrell,2011-10-07 17:41:48+00:00,['581481f232be3f70945f2333c9a53ae5ea5346f8'],1,1,2,434647,1,,,,1472
fae04ead811fa92957dbc6578c1fcd52e16c320c,0,Jake Farrell,2011-10-07 23:15:03+00:00,['2361dd17114d1b5211ca4afd7fde03a9ea95b83a'],1,1,2,434649,1,,,,1472
878a948894a82fea1f01acf1c0cda0c2297fcafb,1,Roger Meier,2011-10-11 19:02:37+00:00,['fae04ead811fa92957dbc6578c1fcd52e16c320c'],77,262,339,434988,12,0.6,0.6,0,1472
bf12239d2e98d475c5506e5511cc0fe3fea148da,0,Roger Meier,2011-10-11 19:48:57+00:00,['878a948894a82fea1f01acf1c0cda0c2297fcafb'],0,3,3,434991,1,,,,1472
6c928f3f5f91afa0917f4625f39b4048865a6027,0,Bryan Duxbury,2011-10-13 21:32:52+00:00,['bf12239d2e98d475c5506e5511cc0fe3fea148da'],2,8,10,435001,2,,,,1472
857a8b8bf81d4ead905e02527727a751720ffdbc,1,Roger Meier,2011-10-14 06:35:28+00:00,['6c928f3f5f91afa0917f4625f39b4048865a6027'],0,114,114,435115,2,0.516483516,0.714285714,1,1472
7ae13e10f7cb0e0c6107cb849d33b9a46b299840,1,Jake Farrell,2011-10-18 14:35:26+00:00,['857a8b8bf81d4ead905e02527727a751720ffdbc'],1,7904,7905,443020,20,0.127579737,0.349437148,0.49249531,1486
711c70c786abf91dc784a002edc4bdab468f3d8e,0,Jake Farrell,2011-10-18 15:31:17+00:00,['7ae13e10f7cb0e0c6107cb849d33b9a46b299840'],2,2,4,443024,1,,,,1486
0dab3832c719f7f4e87d87ab098ca967adfa807d,0,Roger Meier,2011-10-18 22:19:30+00:00,['711c70c786abf91dc784a002edc4bdab468f3d8e'],25,21,46,443070,4,,,,1486
266a6b5c113538ba95a21e6b308389c9d59c6762,0,Roger Meier,2011-10-19 09:27:01+00:00,['0dab3832c719f7f4e87d87ab098ca967adfa807d'],12,17,29,443099,1,,,,1486
c92b65311c7b2c5582404da9674bbfa60592d9ba,1,Jake Farrell,2011-10-20 02:11:02+00:00,['266a6b5c113538ba95a21e6b308389c9d59c6762'],4,5,9,443108,1,,,,1486
3b54621793a9c0ff45ad6e5b32600dad5f888bcd,0,Jake Farrell,2011-10-20 02:49:48+00:00,['c92b65311c7b2c5582404da9674bbfa60592d9ba'],38,1,39,443147,1,1,0.25,0.3125,1486
8514755daf15d0bf66d121f492874c00f460d973,1,Jake Farrell,2011-10-20 13:30:08+00:00,['3b54621793a9c0ff45ad6e5b32600dad5f888bcd'],50,74,124,443271,1,0.823529412,0.882352941,0,1486
bcbf6d6fcda19768ab526e4dd15422584e9db79e,0,Bryan Duxbury,2011-10-24 17:29:16+00:00,['8514755daf15d0bf66d121f492874c00f460d973'],4,4,8,443279,1,,,,1486
0c0f651e1079ffa95be0d5b9a768fdef8af9dc9b,1,Jake Farrell,2011-10-25 02:20:26+00:00,['bcbf6d6fcda19768ab526e4dd15422584e9db79e'],1,23,24,443303,1,0,0,0,1486
d09362c5c734b5032372a2c8bfc8c6afcb632149,0,Jake Farrell,2011-10-26 02:25:07+00:00,['0c0f651e1079ffa95be0d5b9a768fdef8af9dc9b'],12,2,14,443317,2,1,1,1,1486
d2b3bb4e236cd8383c97be665fa3324bc900ef64,0,Jake Farrell,2011-10-26 02:29:48+00:00,['d09362c5c734b5032372a2c8bfc8c6afcb632149'],20,4,24,443341,1,1,1,1,1486
806d298042243f1005c062a920b358c95444c9dd,0,Jake Farrell,2011-10-26 02:33:31+00:00,['d2b3bb4e236cd8383c97be665fa3324bc900ef64'],7,10,17,443358,1,,,,1486
f55f33bfbacde6fb83892aef14b4cb4751517180,0,Jake Farrell,2011-10-26 02:40:14+00:00,['806d298042243f1005c062a920b358c95444c9dd'],3,3,6,443364,1,,,,1486
1290d42162c1de8a256d3db9c118d308f5cceb84,0,Jake Farrell,2011-10-26 12:36:17+00:00,['f55f33bfbacde6fb83892aef14b4cb4751517180'],2,2,4,443368,1,,,,1486
73a921f85c57fd9dda26f91405999455eab8582b,0,Jake Farrell,2011-10-31 14:07:14+00:00,['1290d42162c1de8a256d3db9c118d308f5cceb84'],2,16,18,443386,3,,,,1486
601bb5e87feb0b88c1fdbaeb087a8a656c5290a1,0,Jake Farrell,2011-10-31 14:13:13+00:00,['73a921f85c57fd9dda26f91405999455eab8582b'],0,8,8,443394,1,0,0,0,1486
aad3d1d63ecedd9b82bb9007d2b22f0c16572c66,0,Jake Farrell,2011-11-01 01:08:46+00:00,['601bb5e87feb0b88c1fdbaeb087a8a656c5290a1'],1,1,2,443396,1,,,,1486
61188a47975da49fd6f28789cf2b45590766fa96,0,Roger Meier,2011-11-01 21:03:33+00:00,['aad3d1d63ecedd9b82bb9007d2b22f0c16572c66'],2,3,5,443401,1,0,0,0,1486
e7bdf70daba05e2fa704a3562eb924573342777b,0,Bryan Duxbury,2011-11-02 22:40:01+00:00,['61188a47975da49fd6f28789cf2b45590766fa96'],3,3,6,443407,1,,,,1486
df971daf373ceda6de2f76e5f0713c64b6d2e242,1,Bryan Duxbury,2011-11-04 00:23:30+00:00,['e7bdf70daba05e2fa704a3562eb924573342777b'],4,54,58,443465,3,0,0.166666667,1,1486
17b8469d169adfbab5ae60a957ec4a7f71c2b44a,0,Roger Meier,2011-11-04 11:55:49+00:00,['df971daf373ceda6de2f76e5f0713c64b6d2e242'],0,1,1,443466,1,1,1,1,1486
48bb0e2ad4e5fb10cc832e05a2af4f505c5b0922,1,Jake Farrell,2011-11-05 13:16:34+00:00,['17b8469d169adfbab5ae60a957ec4a7f71c2b44a'],1,1,2,443468,1,,,,1486
28459dc9c56eb2b4148d719d5559eaac669eff06,0,Jake Farrell,2011-11-05 13:36:27+00:00,['48bb0e2ad4e5fb10cc832e05a2af4f505c5b0922'],1,6,7,443475,4,,,,1486
1b6153bdd145be14ce2a58cee2858d07ae60b829,1,Roger Meier,2011-11-06 10:37:11+00:00,['28459dc9c56eb2b4148d719d5559eaac669eff06'],1,1,2,443477,1,,,,1486
38315786e5c9e972aef50433b401dcff23259cae,1,Roger Meier,2011-11-06 11:29:41+00:00,['1b6153bdd145be14ce2a58cee2858d07ae60b829'],41,35,76,443553,7,,,,1486
6f7681f91d1cdf41be657978d819d94b6024c434,1,Roger Meier,2011-11-06 12:04:28+00:00,['38315786e5c9e972aef50433b401dcff23259cae'],4,2,6,443559,3,0.5,0.5,1,1486
605c760ba690056e562f38395d6b40e5b2bacd8c,1,Jake Farrell,2011-11-06 15:02:30+00:00,['6f7681f91d1cdf41be657978d819d94b6024c434'],1,1,2,443561,1,,,,1486
ceead00409628055eff057afd2d78565ddfa6eb1,0,Jake Farrell,2011-11-06 16:07:45+00:00,['605c760ba690056e562f38395d6b40e5b2bacd8c'],27,44,71,443632,2,,,,1487
d5df77a90626ffddaa00b351eda4dbf0810c1836,1,Jake Farrell,2011-11-06 17:43:44+00:00,['ceead00409628055eff057afd2d78565ddfa6eb1'],4,31,35,443667,3,,,,1488
9e7a88267c1a45d06ca3f332f683e2bbfa4eb9a0,1,Jake Farrell,2011-11-06 19:58:32+00:00,['d5df77a90626ffddaa00b351eda4dbf0810c1836'],1,2,3,443670,1,,,,1488
c965dda2ddcea60dad5286702d6d2fd7bf05afdd,1,Jake Farrell,2011-11-06 20:29:26+00:00,['9e7a88267c1a45d06ca3f332f683e2bbfa4eb9a0'],14,4,18,443688,1,,,,1488
d889d8ddfa08f9177eb26bbfab5ea1938462e296,0,Jake Farrell,2011-11-06 23:40:07+00:00,['c965dda2ddcea60dad5286702d6d2fd7bf05afdd'],1,1,2,443690,1,,,,1488
34e1db48db9eea73cc346e08ce32855353df8430,0,Jake Farrell,2011-11-08 01:39:47+00:00,['d889d8ddfa08f9177eb26bbfab5ea1938462e296'],0,8,8,443698,1,,,,1488
5d85bbcabe9339357f6f3f01920d5da1ac42fdcd,1,Jake Farrell,2011-11-09 15:24:25+00:00,['34e1db48db9eea73cc346e08ce32855353df8430'],7,7,14,443712,1,,,,1488
8941458f721a1fcc4220adb7e8c14eddc77f8691,0,Jake Farrell,2011-11-10 00:53:17+00:00,['5d85bbcabe9339357f6f3f01920d5da1ac42fdcd'],27,26,53,443765,21,,,,1488
27274229510ce6c99f20dad2d11fc2d7acc6e8d3,1,Jake Farrell,2011-11-10 20:32:44+00:00,['8941458f721a1fcc4220adb7e8c14eddc77f8691'],1068,2437,3505,447270,8,,,,1490
29defeb6a71d8f1e71c6ff1d614f68c65897a97d,0,Jake Farrell,2011-11-10 21:11:46+00:00,['27274229510ce6c99f20dad2d11fc2d7acc6e8d3'],50,50,100,447370,1,,,,1490
e24ba11cbbe3b6d9abb264483ee47016947a80c2,0,Jake Farrell,2011-11-12 14:18:30+00:00,['29defeb6a71d8f1e71c6ff1d614f68c65897a97d'],1,1,2,447372,1,,,,1490
02357f29e845fc21134d2a8498f237818e1687ad,0,Bryan Duxbury,2011-11-14 23:12:20+00:00,['e24ba11cbbe3b6d9abb264483ee47016947a80c2'],1,1,2,447374,1,,,,1490
2a266cb59504fa56dd693fa7c62072a48c70e9b5,0,Jake Farrell,2011-11-16 12:12:37+00:00,['02357f29e845fc21134d2a8498f237818e1687ad'],0,1,1,447375,1,,,,1490
e0c531673657fb85ed9cc653c1976bd1810deb76,1,Jake Farrell,2011-11-16 12:58:36+00:00,['2a266cb59504fa56dd693fa7c62072a48c70e9b5'],59,54,113,447488,9,,,,1490
1b533e9177c1d5fa9a37148af075df10e6e511b1,0,Roger Meier,2011-11-16 19:11:34+00:00,['e0c531673657fb85ed9cc653c1976bd1810deb76'],0,4,4,447492,2,,,,1490
e34009b76cfa255e216eac79f673bd7e0798119e,1,Jake Farrell,2011-11-17 00:17:29+00:00,['1b533e9177c1d5fa9a37148af075df10e6e511b1'],105,338,443,447935,1,,,,1490
a6c031ad41716173007677dda5e244d7b1314a3d,0,Jake Farrell,2011-11-21 13:52:51+00:00,['e34009b76cfa255e216eac79f673bd7e0798119e'],4,4,8,447943,1,,,,1490
ac10256fccfcc9a31946c26777007a41d7766489,0,Jake Farrell,2011-11-23 14:30:41+00:00,['a6c031ad41716173007677dda5e244d7b1314a3d'],12,24,36,447979,3,1,1,1,1490
289cbb2e4c3550caf1011548bda1996383100c7c,0,Roger Meier,2011-11-23 20:44:09+00:00,['ac10256fccfcc9a31946c26777007a41d7766489'],17,17,34,448013,6,,,,1490
94519b394374391b4d026163f227dec43863e9bd,1,Roger Meier,2011-11-23 21:02:46+00:00,['289cbb2e4c3550caf1011548bda1996383100c7c'],1,10,11,448024,1,0,1,1,1490
a0dd75d7c871370341c27388ffed5ed66917098f,1,Jake Farrell,2011-11-26 05:23:09+00:00,['94519b394374391b4d026163f227dec43863e9bd'],29,72,101,448125,1,0.208333333,1,1,1490
a1b671dba75e15203881ae40f2b580645ef4b7ed,0,Jake Farrell,2011-11-26 18:24:43+00:00,['a0dd75d7c871370341c27388ffed5ed66917098f'],21,49,70,448195,1,0.684210526,0.473684211,0.842105263,1490
c303ab8ba5582e848bd5a794a1a87cefc57e693d,0,Jake Farrell,2011-11-26 18:59:52+00:00,['a1b671dba75e15203881ae40f2b580645ef4b7ed'],0,0,0,448195,0,,,,1490
48d2e64d6ae2277a554e90d06735971e964f6de4,0,Jake Farrell,2011-11-26 19:51:38+00:00,['c303ab8ba5582e848bd5a794a1a87cefc57e693d'],14,21,35,448230,14,,,,1490
be691f4ebfcc0496aaefc464803210e4e40f62ad,0,Jake Farrell,2011-11-26 21:24:24+00:00,['48d2e64d6ae2277a554e90d06735971e964f6de4'],0,112,112,448342,1,,,,1490
828789580b253522c5bddb76d82ee8ab4e98d74a,0,Jake Farrell,2011-11-28 20:00:10+00:00,['a1b671dba75e15203881ae40f2b580645ef4b7ed'],23,0,23,448365,2,,,,1490
b03a59cc5c3e71c74c6d374e67bd45de6b270eea,0,Jake Farrell,2011-11-29 16:45:51+00:00,['828789580b253522c5bddb76d82ee8ab4e98d74a'],40,123,163,448528,11,1,1,0.625,1491
9901069442f25fb8783fb62b9899b4e81937717b,1,Jake Farrell,2011-11-30 02:09:46+00:00,['b03a59cc5c3e71c74c6d374e67bd45de6b270eea'],53,53,106,448634,13,,,,1491
3775a683af521f15632d0809f56d87b61ba49939,1,Jake Farrell,2011-12-06 00:48:04+00:00,['9901069442f25fb8783fb62b9899b4e81937717b'],2,2,4,448638,1,,,,1491
6fa2b30940188fef9f1eaba539dedfa4ddc0946f,1,Jake Farrell,2011-12-06 00:59:30+00:00,['3775a683af521f15632d0809f56d87b61ba49939'],11,12,23,448661,2,0,0,1,1491
9689d89df17d0876e4928fa80407225cfd46bb23,1,Jake Farrell,2011-12-06 01:07:17+00:00,['6fa2b30940188fef9f1eaba539dedfa4ddc0946f'],103,413,516,449177,15,0.020833333,0,0.15625,1492
b0d9560c330fedb49be6b2272b95c83b000fd415,1,Jake Farrell,2011-12-06 01:17:26+00:00,['9689d89df17d0876e4928fa80407225cfd46bb23'],265,636,901,450078,3,0.095238095,0.349206349,0.708994709,1492
753b6c5674d3d5eb466fca8d7f28dddff31a2ab7,0,Jake Farrell,2011-12-06 01:41:59+00:00,['b0d9560c330fedb49be6b2272b95c83b000fd415'],5,18,23,450101,1,1,1,1,1492
a2c5674920905df244526b88ba1caf3c1f6d8e86,0,Jake Farrell,2011-12-06 02:59:04+00:00,['753b6c5674d3d5eb466fca8d7f28dddff31a2ab7'],45,45,90,450191,1,,,,1492
21f8dc900a1c05fcf7d2454068a9fef046c81997,0,Jake Farrell,2011-12-06 03:13:55+00:00,['a2c5674920905df244526b88ba1caf3c1f6d8e86'],1,1,2,450193,1,,,,1492
23bf35daa32231ca00b8a12d91f503f3f8ebf1f7,0,Jake Farrell,2011-12-08 02:02:20+00:00,['21f8dc900a1c05fcf7d2454068a9fef046c81997'],116,422,538,450731,4,0.383928571,0.125,0.205357143,1494
f05e1486e4b213842d362f8be62cd0352f29fbe3,0,Jake Farrell,2011-12-08 02:08:38+00:00,['23bf35daa32231ca00b8a12d91f503f3f8ebf1f7'],0,4,4,450735,1,0,1,1,1494
406fc7497d4c40d4ed3ed99227cf7b90b63150e5,0,Roger Meier,2011-12-08 11:32:21+00:00,['f05e1486e4b213842d362f8be62cd0352f29fbe3'],4,4,8,450743,2,,,,1494
5b1e3c7bf17fcdbaade18e43137fda4bcbfe1e53,1,Roger Meier,2011-12-08 13:20:12+00:00,['406fc7497d4c40d4ed3ed99227cf7b90b63150e5'],1,1,2,450745,1,,,,1494
284a9b56d73194d8a123f7bf88e2dace9c3cbec0,1,Roger Meier,2011-12-08 13:39:56+00:00,['5b1e3c7bf17fcdbaade18e43137fda4bcbfe1e53'],28,554,582,451327,9,0.325581395,0.480620155,0.976744186,1496
d0cdecf4a1baec625cf73e91b0cef406c7b4039e,1,Roger Meier,2011-12-08 19:34:01+00:00,['284a9b56d73194d8a123f7bf88e2dace9c3cbec0'],6,7,13,451340,3,1,0,1,1496
6c26fad24613c208cdc5d268dd96bcf7d91f312d,1,Roger Meier,2011-12-08 20:44:16+00:00,['d0cdecf4a1baec625cf73e91b0cef406c7b4039e'],8,11,19,451359,2,1,1,1,1496
3318201c2f6d7dd6c9d10b120556bc9567184f18,1,Jake Farrell,2011-12-08 21:15:50+00:00,['6c26fad24613c208cdc5d268dd96bcf7d91f312d'],3,66,69,451428,1,0.054054054,0.783783784,0.810810811,1496
12ac2acfaf3532eb200f499e528dec04931f67ed,0,Jake Farrell,2011-12-09 02:21:37+00:00,['3318201c2f6d7dd6c9d10b120556bc9567184f18'],0,2,2,451430,1,,,,1496
343c61d6a7f06e65de8087499675d7b8295e41b2,1,Jake Farrell,2011-12-09 02:29:56+00:00,['12ac2acfaf3532eb200f499e528dec04931f67ed'],22,86,108,451538,2,0.09375,0.09375,0.703125,1496
38b7d07072b1d531856a74d30a4e8c9c329b2c42,0,Roger Meier,2011-12-09 10:36:05+00:00,['343c61d6a7f06e65de8087499675d7b8295e41b2'],6,24,30,451568,2,,,,1496
8516f58b77a7911c42561d7cc53024fbfab9cea9,0,Roger Meier,2011-12-09 18:42:46+00:00,['38b7d07072b1d531856a74d30a4e8c9c329b2c42'],5,16,21,451589,1,,,,1496
e1d2458f1a84c1e975d8b73260324d7ca823bf75,0,Roger Meier,2011-12-09 19:33:07+00:00,['8516f58b77a7911c42561d7cc53024fbfab9cea9'],0,8,8,451597,1,0,1,1,1496
aad8fb4fecb834ae200c6b22535de1fa774fbb36,0,Roger Meier,2011-12-10 21:50:10+00:00,['e1d2458f1a84c1e975d8b73260324d7ca823bf75'],0,6,6,451603,1,0,0,0,1496
3781c2419c8e9b4b2f37e4317519f142efc1768d,1,Roger Meier,2011-12-11 20:07:21+00:00,['aad8fb4fecb834ae200c6b22535de1fa774fbb36'],3,39,42,451645,2,0.545454545,0.636363636,1,1496
1d282a95c604019cc7b4f885738daa61b7974ca4,0,Roger Meier,2011-12-11 20:30:21+00:00,['3781c2419c8e9b4b2f37e4317519f142efc1768d'],16,16,32,451677,1,,,,1496
3fc481961778b1ec5faebd2b42d9a15d8b875e35,1,Roger Meier,2011-12-11 21:05:35+00:00,['1d282a95c604019cc7b4f885738daa61b7974ca4'],3,221,224,451901,4,0.593406593,0.593406593,1,1497
611f90cf9ee177367d6b1f53d2ebb8493b44eec1,1,Roger Meier,2011-12-11 22:08:51+00:00,['3fc481961778b1ec5faebd2b42d9a15d8b875e35'],134,133,267,452168,8,,,,1497
ca10fd4a51b218accd2f616b89ce76464f7e847a,0,Roger Meier,2011-12-12 22:00:23+00:00,['611f90cf9ee177367d6b1f53d2ebb8493b44eec1'],4,4,8,452176,4,,,,1497
de18f7bcff3ed58caeb90aea52ee406ff3f920c0,0,Roger Meier,2011-12-12 22:46:45+00:00,['ca10fd4a51b218accd2f616b89ce76464f7e847a'],0,27,27,452203,1,,,,1497
6e96965fdb19755489c0d35dee6d7fe868477b55,0,Roger Meier,2011-12-13 00:36:01+00:00,['de18f7bcff3ed58caeb90aea52ee406ff3f920c0'],0,18,18,452221,2,,,,1497
3371925d1804e6b7a4e94ef928ea897ded5e09fb,1,Bryan Duxbury,2011-12-13 18:33:15+00:00,['6e96965fdb19755489c0d35dee6d7fe868477b55'],4,4,8,452229,2,,,,1497
ea949fbaf915f04b584efe24a9706586b53193a5,0,Jake Farrell,2011-12-13 20:02:33+00:00,['3371925d1804e6b7a4e94ef928ea897ded5e09fb'],3,3,6,452235,3,,,,1497
a99027c708f3d920db68d72966e5bd221b7440e1,0,Jake Farrell,2011-12-13 20:12:26+00:00,['ea949fbaf915f04b584efe24a9706586b53193a5'],6,0,6,452241,1,,,,1497
12d705390d24359900256ceda15e00de4df4a6cd,1,Roger Meier,2011-12-14 23:35:28+00:00,['a99027c708f3d920db68d72966e5bd221b7440e1'],30,160,190,452431,12,0,0,1,1497
f3e48d4a2e0392d25b02fbfb2df51489744b250e,0,Jake Farrell,2011-12-14 23:48:22+00:00,['12d705390d24359900256ceda15e00de4df4a6cd'],1,1,2,452433,1,,,,1497
a2a9ee993e0fb7607ab1bf4173b7037e3c317c28,0,Jake Farrell,2011-12-15 20:50:31+00:00,['f3e48d4a2e0392d25b02fbfb2df51489744b250e'],1,1,2,452435,1,,,,1497
1e79cb40f5447b514cad823f14fd32235bf6d07b,0,Bryan Duxbury,2011-12-21 18:13:29+00:00,['a2a9ee993e0fb7607ab1bf4173b7037e3c317c28'],9,446,455,452890,5,0.485915493,0.492957746,0.767605634,1499
94eecc8259db0d62589b5bd28e8dfb986689ce01,1,Roger Meier,2011-12-21 21:23:28+00:00,['1e79cb40f5447b514cad823f14fd32235bf6d07b'],4,26,30,452920,1,0,0,0,1499
e7bec408825d53bf9d3e8a10c8afd889cdb28814,0,Bryan Duxbury,2011-12-22 19:04:16+00:00,['94eecc8259db0d62589b5bd28e8dfb986689ce01'],8,10,18,452938,1,,,,1499
a3df547c84b463934589beac7bc37b272b34d4ea,1,Bryan Duxbury,2011-12-27 22:26:59+00:00,['e7bec408825d53bf9d3e8a10c8afd889cdb28814'],1,53,54,452992,3,0,0,1,1499
9704630bab3dc502bbd216380f9bb5e6b13228f0,0,Bryan Duxbury,2012-01-03 17:28:45+00:00,['a3df547c84b463934589beac7bc37b272b34d4ea'],1,1,2,452994,1,,,,1499
6972041392314d526584e733781ca382a960b295,1,Bryan Duxbury,2012-01-03 17:32:30+00:00,['9704630bab3dc502bbd216380f9bb5e6b13228f0'],299,366,665,453659,18,0.24,0.7,0.54,1499
bad4174a57b849054293cc8f829c638383ecc2f5,0,Bryan Duxbury,2012-01-03 17:35:26+00:00,['6972041392314d526584e733781ca382a960b295'],0,1,1,453660,1,0,0,1,1499
c8d5d4d911afc08874c7b3fafbb700ceaee2e610,1,Roger Meier,2012-01-07 20:32:24+00:00,['bad4174a57b849054293cc8f829c638383ecc2f5'],1,20,21,453681,2,0,0,0,1499
45a372679de011d7bc3fecd053738cf505086b53,0,Roger Meier,2012-01-08 21:44:44+00:00,['c8d5d4d911afc08874c7b3fafbb700ceaee2e610'],13,27,40,453721,1,,,,1499
77e1e629131228cdeda3b740ef4cbf27a7af886b,0,Roger Meier,2012-01-08 21:49:12+00:00,['45a372679de011d7bc3fecd053738cf505086b53'],0,3,3,453724,1,,,,1499
333bbf3d8899a6a0e8971ed7abb10f51b4fc7867,1,Roger Meier,2012-01-08 21:51:08+00:00,['77e1e629131228cdeda3b740ef4cbf27a7af886b'],223,273,496,454220,10,0,0.032258065,1,1499
4d5157da020eb1965d0c36f565f1a2e228159e1e,0,Roger Meier,2012-01-09 21:23:19+00:00,['333bbf3d8899a6a0e8971ed7abb10f51b4fc7867'],0,122,122,454342,2,,,,1500
01b568cb5dd144470aee2cc638cc935792363b1c,0,Roger Meier,2012-01-10 21:30:02+00:00,['4d5157da020eb1965d0c36f565f1a2e228159e1e'],8,10,18,454360,4,,,,1500
0580d8dcb1874426559e0d40740bfb47b17c5188,0,Roger Meier,2012-01-10 22:11:36+00:00,['01b568cb5dd144470aee2cc638cc935792363b1c'],0,4,4,454364,1,,,,1500
eaa61d8fda8c5f326311d952bc19a851a8427db7,1,Roger Meier,2012-01-12 21:38:29+00:00,['0580d8dcb1874426559e0d40740bfb47b17c5188'],35,499,534,454898,12,0.780082988,1,0.850622407,1504
4749b4f66ef56aa7729e694d5d78feeedf827f61,1,Roger Meier,2012-01-17 12:25:22+00:00,['eaa61d8fda8c5f326311d952bc19a851a8427db7'],7,12,19,454917,2,,,,1504
d77d180355a28ea5523480c2bd3bf34633711fd6,1,Jake Farrell,2012-01-17 14:28:05+00:00,['4749b4f66ef56aa7729e694d5d78feeedf827f61'],1,1,2,454919,1,,,,1504
36f7a72646c6b2b4501a1b41439713c762055ac8,0,Roger Meier,2012-01-17 19:18:13+00:00,['d77d180355a28ea5523480c2bd3bf34633711fd6'],2,2,4,454923,1,,,,1504
f0e517db99db763e5e7b2ab306990c381320ce62,1,Roger Meier,2012-01-17 21:20:56+00:00,['36f7a72646c6b2b4501a1b41439713c762055ac8'],17,197,214,455137,5,0.128787879,0.568181818,0.833333333,1504
26cbb388ecb9b06efccde5f62518681ee22b3e44,1,Roger Meier,2012-01-17 21:32:50+00:00,['f0e517db99db763e5e7b2ab306990c381320ce62'],1,1,2,455139,1,,,,1504
bc2be31e4805057bda22860713eba72ecf645cd4,0,Roger Meier,2012-01-20 14:34:49+00:00,['26cbb388ecb9b06efccde5f62518681ee22b3e44'],1,1,2,455141,1,,,,1504
3ac6d879280568e9a1a6efd7cd0255f34d4cb1ba,0,Roger Meier,2012-01-20 15:31:45+00:00,['bc2be31e4805057bda22860713eba72ecf645cd4'],3,3,6,455147,1,,,,1504
0838bf56f5c6088070c32da46784be0ba566a721,0,Roger Meier,2012-01-20 19:42:23+00:00,['3ac6d879280568e9a1a6efd7cd0255f34d4cb1ba'],0,4,4,455151,1,0,0,1,1504
b33967be7632161721be57184d93db3e3ce77645,0,Roger Meier,2012-01-21 09:18:05+00:00,['0838bf56f5c6088070c32da46784be0ba566a721'],15,19,34,455185,5,,,,1504
33b720a958987fd8edf9021c8d40de9e338314b1,0,Roger Meier,2012-01-24 18:42:46+00:00,['b33967be7632161721be57184d93db3e3ce77645'],0,1596,1596,456781,6,0.808837656,0.853986551,0.954851105,1508
6823b6d729b05c29150c037aff4535aae0595a7e,0,Roger Meier,2012-01-24 19:35:09+00:00,['33b720a958987fd8edf9021c8d40de9e338314b1'],0,10,10,456791,1,,,,1508
ac70b5f832ddcc9cd2733ed0361536a58a6ec861,0,Roger Meier,2012-01-24 20:18:07+00:00,['6823b6d729b05c29150c037aff4535aae0595a7e'],4,3,7,456798,2,,,,1508
ba021466824299c6122e26b8850759f0a17314c0,0,Jake Farrell,2012-01-27 03:06:54+00:00,['ac70b5f832ddcc9cd2733ed0361536a58a6ec861'],5,5,10,456808,1,,,,1508
100f616afd0f31346f958339cc83f71330fd7593,0,Jake Farrell,2012-01-27 03:19:01+00:00,['ba021466824299c6122e26b8850759f0a17314c0'],8,18,26,456834,1,1,1,1,1508
b2c49527999528c2d9f28486d358e6ff3c3cc9dc,0,Jake Farrell,2012-01-27 04:01:54+00:00,['100f616afd0f31346f958339cc83f71330fd7593'],6,11,17,456851,3,1,1,1,1508
6ce2704a14bb109d2d9e29d1b77974f57b2e8636,1,Jake Farrell,2012-01-27 04:32:17+00:00,['b2c49527999528c2d9f28486d358e6ff3c3cc9dc'],2,4,6,456857,1,0,0,1,1508
f9f01fa1e054ff28d7b8023eeb53cd5ba0ed6b1c,0,Jake Farrell,2012-01-27 04:48:26+00:00,['6ce2704a14bb109d2d9e29d1b77974f57b2e8636'],2,24,26,456883,3,0,0.933333333,0.933333333,1508
c00d83b26a4ae5211e2e7a92c6b8c377aded7b4e,1,Jake Farrell,2012-01-28 03:57:58+00:00,['f9f01fa1e054ff28d7b8023eeb53cd5ba0ed6b1c'],11,63,74,456957,1,0,0,0,1508
6f0f52758381643ac80172d2c53c00e00c898a8e,1,Jake Farrell,2012-01-31 03:39:30+00:00,['c00d83b26a4ae5211e2e7a92c6b8c377aded7b4e'],0,1236,1236,458193,3,0.750275028,0.805280528,0.97909791,1510
64af51bbbb6080b6f4343205cbb99e5faa81fd0f,1,Roger Meier,2012-02-06 20:46:06+00:00,['6f0f52758381643ac80172d2c53c00e00c898a8e'],35,77,112,458305,4,0,0,0,1510
afb9f970a42d4728f43a705e457ebce2d400992a,0,Jake Farrell,2012-02-09 16:17:50+00:00,['64af51bbbb6080b6f4343205cbb99e5faa81fd0f'],1,1,2,458307,1,,,,1510
86e89865872cf051e8272e5e33ca669fa68f4f85,1,Roger Meier,2012-02-10 19:53:20+00:00,['afb9f970a42d4728f43a705e457ebce2d400992a'],20,567,587,458894,8,0.467811159,0.931330472,0.845493562,1516
0bab154d9f3cac02b0c523e1e578bf5b87f494d0,0,Roger Meier,2012-02-10 21:08:36+00:00,['86e89865872cf051e8272e5e33ca669fa68f4f85'],85,0,85,458979,1,0.571428571,0.571428571,0.571428571,1516
19a991528f8ed41319737ee758b79ae8b66cd9f7,1,Roger Meier,2012-02-11 19:09:30+00:00,['0bab154d9f3cac02b0c523e1e578bf5b87f494d0'],161,164,325,459304,4,0,,,1516
b405ca6be839c5a7072cbe3cd3a584523b960058,0,Bryan Duxbury,2012-02-14 23:35:22+00:00,['19a991528f8ed41319737ee758b79ae8b66cd9f7'],4,12,16,459320,2,0,0.4,0.6,1516
2fbde0eff0e17b66e6c2ea931bd5882607e019c4,0,Roger Meier,2012-02-19 18:53:08+00:00,['b405ca6be839c5a7072cbe3cd3a584523b960058'],1,3,4,459324,1,0,1,0,1516
2b828b1a94a0421da098a0092fccdabec41d3124,0,Roger Meier,2012-02-22 07:08:36+00:00,['2fbde0eff0e17b66e6c2ea931bd5882607e019c4'],1,1,2,459326,1,,,,1516
cb4e116ea77b71405cf027f4ac46cc588de5d3ce,0,Anthony F. Molinaro,2012-02-22 19:33:43+00:00,['2b828b1a94a0421da098a0092fccdabec41d3124'],2,2,4,459330,1,,,,1516
efa2fcf32566728b7e0cad8011952fae77eca9a0,0,Anthony F. Molinaro,2012-02-22 19:44:50+00:00,['cb4e116ea77b71405cf027f4ac46cc588de5d3ce'],1,0,1,459331,1,,,,1516
b2507dbb0c9869acb8ff7fab6d3cd5b415a7c6ec,0,Bryan Duxbury,2012-02-22 21:14:10+00:00,['efa2fcf32566728b7e0cad8011952fae77eca9a0'],17,3,20,459351,1,1,1,1,1516
5b9693c9fa0e28eda52bd3e53c458d6398af7b36,0,Roger Meier,2012-02-28 19:32:55+00:00,['b2507dbb0c9869acb8ff7fab6d3cd5b415a7c6ec'],0,238,238,459589,3,,,,1519
8b1adf42e200be9d9e1d017e5c1d02c67912a051,1,Roger Meier,2012-02-28 20:34:06+00:00,['5b9693c9fa0e28eda52bd3e53c458d6398af7b36'],2,2,4,459593,1,,,,1519
35f977c28e14b45b35063b57d47c76f89d2921b3,1,Roger Meier,2012-02-28 20:50:13+00:00,['8b1adf42e200be9d9e1d017e5c1d02c67912a051'],12,12,24,459617,1,,,,1519
a81b040ee0408c1cad0c3515dd8513120754935a,0,Ilya Maykov,2012-02-29 00:39:38+00:00,['35f977c28e14b45b35063b57d47c76f89d2921b3'],1,245,246,459863,2,1,1,1,1520
f85ad517656fda3f1dad04dab50771614e4df95a,0,Bryan Duxbury,2012-02-29 01:12:27+00:00,['a81b040ee0408c1cad0c3515dd8513120754935a'],6,5,11,459874,1,,,,1520
c00011a7522a84f17e5d53ad1db7a9128c41c1e4,0,Ilya Maykov,2012-02-29 02:40:28+00:00,['f85ad517656fda3f1dad04dab50771614e4df95a'],7,21,28,459902,1,1,1,1,1520
9be7b3886027509c8c68f79fd8ac60c0005d09e2,1,Ilya Maykov,2012-03-01 05:56:39+00:00,['c00011a7522a84f17e5d53ad1db7a9128c41c1e4'],207,217,424,460326,1,1,1,0,1520
38087708b5ca5a575bb3bcbbf3c24ab181e1cfc1,0,Bryan Duxbury,2012-03-01 23:41:09+00:00,['9be7b3886027509c8c68f79fd8ac60c0005d09e2'],1,1,2,460328,1,,,,1520
68839504c2f13a058b17391414f40012e54ff398,0,Bryan Duxbury,2012-03-01 23:43:54+00:00,['38087708b5ca5a575bb3bcbbf3c24ab181e1cfc1'],1,2,3,460331,1,0,1,1,1520
363f6d414b824303f3c1f440620c4a2ac7581e47,0,Jake Farrell,2012-03-02 02:50:50+00:00,['68839504c2f13a058b17391414f40012e54ff398'],1,1,2,460333,1,,,,1520
4ca8c3b8197994b9933a33556144a3403d09f75e,0,Jake Farrell,2012-03-02 05:22:02+00:00,['363f6d414b824303f3c1f440620c4a2ac7581e47'],1,1,2,460335,1,,,,1520
ca620e3788b21936b3d9f6f3055c1629cedb9c3d,1,Jake Farrell,2012-03-02 05:56:03+00:00,['4ca8c3b8197994b9933a33556144a3403d09f75e'],13,76,89,460424,5,0.444444444,0.972222222,0,1520
17515db9349fef971f9ae4e6f104894fdd4d9694,1,Jake Farrell,2012-03-08 04:05:58+00:00,['ca620e3788b21936b3d9f6f3055c1629cedb9c3d'],23,82,105,460529,1,0,0,0,1520
9c6773aeef8ae25444bf9b4830edfe80b2e9aa7e,1,Jake Farrell,2012-03-22 02:40:45+00:00,['17515db9349fef971f9ae4e6f104894fdd4d9694'],5,12,17,460546,2,,,,1520
31835148b24c272dd2f952d8034f22bdec925bd3,0,Anthony F. Molinaro,2012-03-22 06:23:36+00:00,['9c6773aeef8ae25444bf9b4830edfe80b2e9aa7e'],8,51,59,460605,3,0.9375,0.0625,0.9375,1521
3bba214c1358b634187cb7a43a5a6b2156013c55,0,Anthony F. Molinaro,2012-03-22 06:48:33+00:00,['31835148b24c272dd2f952d8034f22bdec925bd3'],5,21,26,460631,2,0,0,1,1521
e2378f69efa8c795470bf4ff2f96c85dd7642800,0,Anthony F. Molinaro,2012-03-22 07:02:15+00:00,['3bba214c1358b634187cb7a43a5a6b2156013c55'],4,1,5,460636,1,,,,1521
f485e2bdb39483e776b34dd70d1ab4c9e3a7f533,0,Anthony F. Molinaro,2012-03-22 07:04:37+00:00,['e2378f69efa8c795470bf4ff2f96c85dd7642800'],15,0,15,460651,2,,,,1521
b95b0ffa720ffdebd829861ed420d10deab6c852,1,Jake Farrell,2012-03-22 21:49:10+00:00,['f485e2bdb39483e776b34dd70d1ab4c9e3a7f533'],1,23339,23340,483991,80,0.092691622,0.338680927,0.900178253,1595
5c80802332cca08b0fa4def67610100faf6ef84e,0,Roger Meier,2012-04-08 12:30:00+00:00,['b95b0ffa720ffdebd829861ed420d10deab6c852'],9,8,17,484008,2,0.714285714,0.714285714,0.714285714,1595
7699b402325a874c562f0ef4c204130a674464bd,0,Roger Meier,2012-04-08 18:18:44+00:00,['5c80802332cca08b0fa4def67610100faf6ef84e'],0,78,78,484086,4,1,1,1,1595
c64d6f099295da233cf0d87896a9d994e50da06f,0,Roger Meier,2012-04-08 18:18:56+00:00,['7699b402325a874c562f0ef4c204130a674464bd'],14,13,27,484113,1,1,1,0,1595
380e919a13b9adbecebeb4e03c6f44d803cb13c6,0,Roger Meier,2012-04-09 16:25:47+00:00,['c64d6f099295da233cf0d87896a9d994e50da06f'],16,31,47,484160,1,0,0,1,1595
5c854619950879aefdb14451357a1dee65bb08e7,0,Roger Meier,2012-04-09 16:31:42+00:00,['380e919a13b9adbecebeb4e03c6f44d803cb13c6'],0,572,572,484732,5,,,,1600
b1ec4ccca167a7ee21689fb5dd7238310ac91758,1,Roger Meier,2012-04-11 21:21:41+00:00,['5c854619950879aefdb14451357a1dee65bb08e7'],88,208,296,485028,10,0.86746988,1,0.963855422,1600
d1bf5d0336b8b1ca1de71a50edafa65694eff8b7,0,Roger Meier,2012-04-11 21:38:56+00:00,['b1ec4ccca167a7ee21689fb5dd7238310ac91758'],3,723,726,485754,8,0.545977011,0.770114943,0.962643678,1604
ec8027ffada1674af6803edb5a16fa9a42891a7a,0,Roger Meier,2012-04-11 21:43:25+00:00,['d1bf5d0336b8b1ca1de71a50edafa65694eff8b7'],0,9,9,485763,1,1,1,1,1604
d8f50f3ffedf020db94de9a915481effd9ae5162,1,Roger Meier,2012-04-11 21:48:56+00:00,['ec8027ffada1674af6803edb5a16fa9a42891a7a'],29,13,42,485805,5,1,1,0,1604
02c827bcfe18c1ddb7450741a88bcb753eb1a063,1,Roger Meier,2012-04-11 21:59:57+00:00,['d8f50f3ffedf020db94de9a915481effd9ae5162'],4,59,63,485868,3,0.214285714,1,1,1604
fa392e91adae6c03adcfd1f7c03c0729dbd15b25,0,Roger Meier,2012-04-11 22:15:15+00:00,['02c827bcfe18c1ddb7450741a88bcb753eb1a063'],0,9,9,485877,1,0,0.833333333,0.833333333,1604
49ef6587b4cb830cbe35a8e14ac4ad5a2c457923,0,Roger Meier,2012-04-11 22:28:26+00:00,['fa392e91adae6c03adcfd1f7c03c0729dbd15b25'],38,220,258,486135,7,0.25,0,0.5,1607
49ff8b123a0b79aa0ec5a4a1baa288e7cbfdcede,1,Roger Meier,2012-04-13 09:12:31+00:00,['49ef6587b4cb830cbe35a8e14ac4ad5a2c457923'],1496,800,2296,488431,223,0.454022989,0.229885057,0.037356322,1607
33eaa0f10038d427d6f62d72235af314bc27b930,0,Roger Meier,2012-04-13 09:13:13+00:00,['49ff8b123a0b79aa0ec5a4a1baa288e7cbfdcede'],8,8,16,488447,7,,,,1607
a3410db0c8af2331e14c2bb8b7632720ff96a254,0,Roger Meier,2012-04-13 10:30:11+00:00,['33eaa0f10038d427d6f62d72235af314bc27b930'],2,9,11,488458,2,1,1,1,1607
3f5a264cd9cfafa478272d5d5d41928dc69ee39b,0,Roger Meier,2012-04-13 14:20:08+00:00,['a3410db0c8af2331e14c2bb8b7632720ff96a254'],0,10,10,488468,1,0,0,1,1607
cfff8569bb03a544f8896b5ba8611ccc4dfbb639,0,Roger Meier,2012-04-13 14:24:55+00:00,['3f5a264cd9cfafa478272d5d5d41928dc69ee39b'],2,24,26,488494,1,0,1,0.857142857,1607
629d5a9bcf49ee6e38049b7849cd4db24ef86632,0,Roger Meier,2012-04-13 14:33:56+00:00,['cfff8569bb03a544f8896b5ba8611ccc4dfbb639'],3,1,4,488498,1,1,1,1,1607
5346e7200a5919ed4239b5c7bb8bc098bad1a307,0,Roger Meier,2012-04-13 14:38:19+00:00,['629d5a9bcf49ee6e38049b7849cd4db24ef86632'],4,7,11,488509,1,0,0,1,1607
92a90ff8cf2716cd06e8696c24746635544d2685,0,Roger Meier,2012-04-13 14:50:32+00:00,['5346e7200a5919ed4239b5c7bb8bc098bad1a307'],2,2,4,488513,1,,,,1607
1516be04e0262762c63d3205a8a136dff269177a,1,Roger Meier,2012-04-14 11:03:21+00:00,['92a90ff8cf2716cd06e8696c24746635544d2685'],239,927,1166,489679,17,0.545977011,0.770114943,0.962643678,1611
2badac7bd2e72efb54bf16f3870416e6ca892098,1,Roger Meier,2012-04-14 11:03:43+00:00,['1516be04e0262762c63d3205a8a136dff269177a'],19,19,38,489717,7,,,,1611
b661e83fab3bfa7a5240f254e8a948830ffeabdf,1,Roger Meier,2012-04-15 15:58:43+00:00,['2badac7bd2e72efb54bf16f3870416e6ca892098'],43,43,86,489803,2,,,,1611
7c7679198f783638b6bec6c0b2de4da6e6127b94,0,Roger Meier,2012-04-17 16:03:21+00:00,['b661e83fab3bfa7a5240f254e8a948830ffeabdf'],1,1,2,489805,1,,,,1611
c75797d9060e049692c5db1617aa9560aec939c8,1,Roger Meier,2012-04-28 11:33:58+00:00,['7c7679198f783638b6bec6c0b2de4da6e6127b94'],128,359,487,490292,10,0.127358491,0.283018868,0.674528302,1611
710c11162d8ccb406f271b6fff294dbe039587aa,1,Roger Meier,2012-04-28 19:20:08+00:00,['c75797d9060e049692c5db1617aa9560aec939c8'],77,45,122,490414,1,,,,1611
b70e04cab0f8bf5723861dc28c163e25d7964392,0,Roger Meier,2012-04-28 19:20:23+00:00,['710c11162d8ccb406f271b6fff294dbe039587aa'],23,20,43,490457,2,,,,1611
321772340bee4fd76d7415aa37d2ee9b361e63c1,0,Roger Meier,2012-05-01 11:19:53+00:00,['b70e04cab0f8bf5723861dc28c163e25d7964392'],1,1,2,490459,1,,,,1611
f666d07289b2d51db3a320101d531b31371b4340,1,Roger Meier,2012-05-01 11:20:12+00:00,['321772340bee4fd76d7415aa37d2ee9b361e63c1'],34,14,48,490507,4,0.828571429,0,1,1611
23c16b7df7ba3d5f6efa52287b71d6941107c742,0,Roger Meier,2012-05-01 12:12:17+00:00,['f666d07289b2d51db3a320101d531b31371b4340'],0,1,1,490508,1,,,,1611
95b1bd71e36da01e3173eefe7ed4bfc31f01abcf,1,Roger Meier,2012-05-01 20:43:26+00:00,['23c16b7df7ba3d5f6efa52287b71d6941107c742'],2,3,5,490513,2,0,1,1,1611
6ad473ff6441fbe4624ef1aaa9c7cc36582c16b9,0,Roger Meier,2012-05-01 21:03:41+00:00,['95b1bd71e36da01e3173eefe7ed4bfc31f01abcf'],1,1,2,490515,1,,,,1611
860b8c9cfbe99c5d3ba07fffbcb5c44894312953,1,Christopher Piro,2012-05-02 19:33:47+00:00,['6ad473ff6441fbe4624ef1aaa9c7cc36582c16b9'],1,1,2,490517,1,,,,1611
b2f3bcdd08811e0a138d0debf51f31b34bf6a443,1,Bryan Duxbury,2012-05-02 21:39:01+00:00,['860b8c9cfbe99c5d3ba07fffbcb5c44894312953'],57,104,161,490678,2,0.35,0,0,1611
f50df7f2ba60e26e72a084381aa96344e7ec01f8,1,Roger Meier,2012-05-02 22:49:55+00:00,['b2f3bcdd08811e0a138d0debf51f31b34bf6a443'],1,71,72,490750,2,0,0,1,1611
1f8b48f5bdfc49dc1992684c56b0e0c22335ceb0,0,Roger Meier,2012-05-02 22:56:47+00:00,['f50df7f2ba60e26e72a084381aa96344e7ec01f8'],8,135,143,490893,2,,,,1611
7abda07738bfde35bc941d8187179656c1e4a0a4,0,Roger Meier,2012-05-03 10:23:15+00:00,['1f8b48f5bdfc49dc1992684c56b0e0c22335ceb0'],0,176,176,491069,1,,,,1612
99b3672530b4b6da939e17bbb37b2a041a5575c6,1,Roger Meier,2012-05-03 21:21:43+00:00,['7abda07738bfde35bc941d8187179656c1e4a0a4'],14,22,36,491105,3,0,0,1,1612
4fce960b7fa9e100cc67933b8cae663469748b9b,0,Roger Meier,2012-05-04 06:22:09+00:00,['99b3672530b4b6da939e17bbb37b2a041a5575c6'],3,50,53,491158,1,0,0,1,1612
45320175c5f2266f063315108fd5b4f986e10a0d,1,Roger Meier,2012-05-04 21:55:55+00:00,['4fce960b7fa9e100cc67933b8cae663469748b9b'],0,77,77,491235,1,,,,1613
bb6de7aab09e4feb1377bd2486d420855495a11b,1,Roger Meier,2012-05-04 23:35:45+00:00,['45320175c5f2266f063315108fd5b4f986e10a0d'],29,108,137,491372,3,,,,1613
ea7b21d17564bca57b9a69ed7d663b2fa8eb6cd7,0,Christopher Piro,2012-05-08 01:45:21+00:00,['bb6de7aab09e4feb1377bd2486d420855495a11b'],1,1,2,491374,1,,,,1613
0b922740035d9c88f961dc0cd73b54350c68ea1c,0,Roger Meier,2012-05-08 19:42:33+00:00,['ea7b21d17564bca57b9a69ed7d663b2fa8eb6cd7'],1,2,3,491377,1,,,,1613
2be7f2410294a809f6803b8e6e3067e51f997679,1,Roger Meier,2012-05-10 09:01:45+00:00,['0b922740035d9c88f961dc0cd73b54350c68ea1c'],1,1855,1856,493233,8,0.55006502,1,0.784135241,1620
67377e7f3b05c0d2569316c65f9ee5a3456cce30,0,Roger Meier,2012-05-10 21:17:53+00:00,['2be7f2410294a809f6803b8e6e3067e51f997679'],8,6,14,493247,2,,,,1620
b87e5667a467a6628698c8f33982066095cd4178,0,Jake Farrell,2012-05-11 02:23:00+00:00,['67377e7f3b05c0d2569316c65f9ee5a3456cce30'],220,38,258,493505,7,0.75,1,0.5,1620
4a48300564aea53dbdf91fc11181073cf14e6024,0,Roger Meier,2012-05-11 08:26:48+00:00,['b87e5667a467a6628698c8f33982066095cd4178'],0,0,0,493505,0,,,,1620
96efc26a3cc14e5b3a8a3f7c08cc2082ed42d197,0,Roger Meier,2012-05-11 09:03:41+00:00,['4a48300564aea53dbdf91fc11181073cf14e6024'],2,37,39,493544,1,,,,1620
2b1a5289a7aa61377f2d20ee8dfffd72310cc886,1,Roger Meier,2012-05-11 10:12:39+00:00,['96efc26a3cc14e5b3a8a3f7c08cc2082ed42d197'],64,55,119,493663,13,,,,1620
41f4708d2fd03bc39a7f51960980e419ed7f11db,0,Roger Meier,2012-05-11 10:15:51+00:00,['2b1a5289a7aa61377f2d20ee8dfffd72310cc886'],0,4,4,493667,1,,,,1620
6bb0a7a34a38484132e044bb8d09830198135473,0,Roger Meier,2012-05-11 10:44:32+00:00,['41f4708d2fd03bc39a7f51960980e419ed7f11db'],1,1,2,493669,1,,,,1620
4f260f7a5f65971b407947398bbc2fed79064919,0,Roger Meier,2012-05-11 13:50:11+00:00,['6bb0a7a34a38484132e044bb8d09830198135473'],2,3,5,493674,1,,,,1620
dd16f0538b14109a8ecc710bccd5c02cfa18b313,0,Roger Meier,2012-05-11 14:19:48+00:00,['4f260f7a5f65971b407947398bbc2fed79064919'],2,2,4,493678,1,,,,1620
a30930f67708892316bdd6946b13862be4769b2c,0,Roger Meier,2012-05-11 18:08:58+00:00,['dd16f0538b14109a8ecc710bccd5c02cfa18b313'],3,12,15,493693,2,0,1,1,1620
e8c259a08a229b082db75eec8b7ebaceae4c557d,0,Jake Farrell,2012-05-16 03:49:57+00:00,['a30930f67708892316bdd6946b13862be4769b2c'],1,3,4,493697,1,0,1,1,1620
94bb7f26f6d9b5bf1106b1aeb4b983e453f50047,1,Jake Farrell,2012-05-17 04:32:10+00:00,['e8c259a08a229b082db75eec8b7ebaceae4c557d'],14,13,27,493724,1,,,,1620
970c86a5f2e6612fc7fbf9623655f91040cab81a,0,Jake Farrell,2012-05-17 05:41:09+00:00,['94bb7f26f6d9b5bf1106b1aeb4b983e453f50047'],0,0,0,493724,32,,,,1620
5e022aa6865918d56616b9ef026337bd766ce04a,1,Jake Farrell,2012-05-18 00:33:54+00:00,['970c86a5f2e6612fc7fbf9623655f91040cab81a'],3,19,22,493746,1,1,1,1,1620
6c5ee6ad2067e245ab5364f9a6019d8b63d7ed52,1,Jake Farrell,2012-05-18 01:00:39+00:00,['5e022aa6865918d56616b9ef026337bd766ce04a'],18,18,36,493782,5,,,,1620
eccbe4d08d6220567aefdc222332e1b74f30d0db,0,Jake Farrell,2012-05-18 03:57:07+00:00,['6c5ee6ad2067e245ab5364f9a6019d8b63d7ed52'],8,30,38,493820,1,,,,1620
f5bae90076fa1cf3235c0425cb8e1809bc6c67ea,0,Jake Farrell,2012-05-18 04:14:45+00:00,['eccbe4d08d6220567aefdc222332e1b74f30d0db'],0,4,4,493824,1,,,,1620
6849f2014d21ca1c49220039453c699eab11fb68,1,Roger Meier,2012-05-18 07:35:19+00:00,['f5bae90076fa1cf3235c0425cb8e1809bc6c67ea'],52,129,181,494005,8,0.055555556,0,0.5,1621
da74ff4a3be2bf3709549852d3c9f30737b3e93d,0,Roger Meier,2012-05-18 09:25:02+00:00,['6849f2014d21ca1c49220039453c699eab11fb68'],7,13,20,494025,3,,,,1621
3f972b1cf146463a672a47d025502fd5b6f7c4bf,0,Roger Meier,2012-05-18 11:35:51+00:00,['da74ff4a3be2bf3709549852d3c9f30737b3e93d'],16,38,54,494079,2,,,,1621
86d2a4ada8712b8802c12bbe218f3a9d41fa2db6,0,Jake Farrell,2012-05-19 14:29:15+00:00,['3f972b1cf146463a672a47d025502fd5b6f7c4bf'],3,7,10,494089,1,,,,1621
d11c8bc4bef1d70a044110b82ac7c6a01de7059e,1,Jake Farrell,2012-05-21 00:07:14+00:00,['86d2a4ada8712b8802c12bbe218f3a9d41fa2db6'],5,101,106,494195,1,0.343283582,0.656716418,1,1621
b6617836d4bd1ff4788bd63eea4cec1378d14c3b,0,Roger Meier,2012-05-23 19:17:20+00:00,['d11c8bc4bef1d70a044110b82ac7c6a01de7059e'],3,3,6,494201,1,,,,1621
2d59b9e2ad05113410a7e505b052512004090261,1,Roger Meier,2012-05-23 19:40:40+00:00,['b6617836d4bd1ff4788bd63eea4cec1378d14c3b'],3,3,6,494207,1,,,,1621
d1f6782466dcb6412544932d8ae5ce8636f567ff,0,Roger Meier,2012-05-25 05:36:46+00:00,['2d59b9e2ad05113410a7e505b052512004090261'],0,0,0,494207,0,,,,1621
83042b9078311d9bd166f8690a1feed4949b1c31,0,Roger Meier,2012-05-27 10:54:17+00:00,['d1f6782466dcb6412544932d8ae5ce8636f567ff'],0,93,93,494300,1,0,1,1,1621
4cb8e40d8abbb480065461ac3fd27280cb9a53f6,0,Roger Meier,2012-05-27 18:05:16+00:00,['83042b9078311d9bd166f8690a1feed4949b1c31'],25,101,126,494426,7,0.8125,1,0.71875,1622
e25db162a5918a1c4ff373e0f0c82065751972e0,0,Bryan Duxbury,2012-05-29 18:13:39+00:00,['4cb8e40d8abbb480065461ac3fd27280cb9a53f6'],93,0,93,494519,1,1,0,0,1622
7d0a0401534e0a02206d7ddb734e6a7dfa41bb42,1,Roger Meier,2012-06-05 19:57:10+00:00,['e25db162a5918a1c4ff373e0f0c82065751972e0'],102,239,341,494860,5,0.6,0.975,0.95,1622
cefdca6f49ebfdc31e2a6f87f446a29a0891bf0a,1,Roger Meier,2012-06-05 20:14:14+00:00,['7d0a0401534e0a02206d7ddb734e6a7dfa41bb42'],3,206,209,495069,7,0.5,0.513513514,0.891891892,1624
febe845f05a1e30fb16516eb934724f34ac2bd8f,1,Roger Meier,2012-06-06 10:32:24+00:00,['cefdca6f49ebfdc31e2a6f87f446a29a0891bf0a'],14,17,31,495100,2,0,0,1,1624
87b704fd91d9d895460cd24405187d45f40b7c18,0,Roger Meier,2012-06-07 13:24:22+00:00,['febe845f05a1e30fb16516eb934724f34ac2bd8f'],1,1,2,495102,1,,,,1624
9212e79b3dd9ad1da3600d397dbfa18c4a7b2ee3,1,Roger Meier,2012-06-12 21:01:06+00:00,['87b704fd91d9d895460cd24405187d45f40b7c18'],1,15,16,495118,5,,,,1624
6edb27a5af3e60c7363394a7d277dd63e32c4571,0,Bryan Duxbury,2012-06-14 14:36:18+00:00,['9212e79b3dd9ad1da3600d397dbfa18c4a7b2ee3'],6,6,12,495130,1,,,,1624
89cc4303aac22b4505934fa965ee7981c83f171c,0,Roger Meier,2012-06-18 20:02:36+00:00,['6edb27a5af3e60c7363394a7d277dd63e32c4571'],5,5,10,495140,3,,,,1624
122803bade37e82451785ec53dddafd98774b92e,1,Roger Meier,2012-06-18 20:23:58+00:00,['89cc4303aac22b4505934fa965ee7981c83f171c'],0,1348,1348,496488,25,0.365131579,0.490131579,0.766447368,1649
f9f841d76953b13153ca32b4c7e34c00776d16a8,1,Roger Meier,2012-06-19 20:42:33+00:00,['122803bade37e82451785ec53dddafd98774b92e'],21,38,59,496547,4,0,0,1,1649
e64b12999de8de220551dd78ae3bf2d7289f0ec3,0,Roger Meier,2012-06-19 20:54:51+00:00,['f9f841d76953b13153ca32b4c7e34c00776d16a8'],0,152,152,496699,1,0.344262295,1,1,1650
f42ae012aa57d476a3ca44542ccfd7801cac3587,0,Jake Farrell,2012-06-22 03:22:53+00:00,['e64b12999de8de220551dd78ae3bf2d7289f0ec3'],13,42,55,496754,3,0,0.153846154,0.538461538,1650
16b764196fcd3d01831c4c5bee75c899b4c25c6c,1,Jake Farrell,2012-06-22 03:51:38+00:00,['f42ae012aa57d476a3ca44542ccfd7801cac3587'],2,3,5,496759,3,,,,1650
5be8e9e4f39b3df4a5497a0d9372879f8218bb47,0,Jake Farrell,2012-06-22 04:18:22+00:00,['16b764196fcd3d01831c4c5bee75c899b4c25c6c'],0,0,0,496759,0,,,,1650
ee22939d1ae7e74d61d8697c45a7301e00092c11,0,Roger Meier,2012-06-24 19:07:12+00:00,['5be8e9e4f39b3df4a5497a0d9372879f8218bb47'],0,19,19,496778,1,,,,1650
bd057f6a5e50cd7c4899b34790e6f0864a880ee6,1,Roger Meier,2012-06-24 19:18:00+00:00,['ee22939d1ae7e74d61d8697c45a7301e00092c11'],1,384,385,497163,4,,,,1650
40633a6316112d56f66b0e4b6cd6f9ec405b41bd,1,Roger Meier,2012-06-24 19:20:58+00:00,['bd057f6a5e50cd7c4899b34790e6f0864a880ee6'],3,37,40,497203,1,,,,1650
d62032850caf9c76f5069e5c53d34e433b05da58,0,Bryan Duxbury,2012-06-26 00:32:57+00:00,['40633a6316112d56f66b0e4b6cd6f9ec405b41bd'],0,2,2,497205,1,1,1,1,1650
27647d5b18e1a494c9e12c35a8701932c4767c02,0,Roger Meier,2012-06-27 10:17:57+00:00,['d62032850caf9c76f5069e5c53d34e433b05da58'],26,0,26,497231,1,,,,1650
6530f1dc88377c3d1a9811267c76fd80d5f419c4,0,Bryan Duxbury,2012-06-29 00:21:19+00:00,['27647d5b18e1a494c9e12c35a8701932c4767c02'],7,8,15,497246,1,,,,1650
3fcdb09267f280c041dc1e613cb4bf42ac880516,0,Jake Farrell,2012-07-14 23:56:20+00:00,['6530f1dc88377c3d1a9811267c76fd80d5f419c4'],0,1,1,497247,1,0,0,1,1650
ae44abc6f93165968d82b7b7e50b4c5b99f5c332,0,Roger Meier,2012-07-18 05:42:51+00:00,['3fcdb09267f280c041dc1e613cb4bf42ac880516'],0,4,4,497251,1,0,0,1,1650
908d2f78394a609dc2b015d5519689d1f88951b4,0,Roger Meier,2012-07-18 12:03:20+00:00,['ae44abc6f93165968d82b7b7e50b4c5b99f5c332'],0,6,6,497257,3,,,,1650
c9c972b3ee216c09331ee5c83b059983d79a2b90,0,Jake Farrell,2012-07-24 17:28:24+00:00,['908d2f78394a609dc2b015d5519689d1f88951b4'],2,1,3,497260,1,,,,1650
6f3a526025704ff1ee5b5ace761abe67e58d3725,0,Jake Farrell,2012-07-27 15:48:37+00:00,['c9c972b3ee216c09331ee5c83b059983d79a2b90'],1,1,2,497262,1,,,,1650
d6d3e371034a05f8bc65b97ef8e7ee9035cd5a64,0,Jake Farrell,2012-07-27 16:01:33+00:00,['6f3a526025704ff1ee5b5ace761abe67e58d3725'],1,5,6,497268,1,,,,1650
e06e8b7e992dd543f32d04550125cbd4a9b558c6,0,Jake Farrell,2012-08-08 17:38:39+00:00,['d6d3e371034a05f8bc65b97ef8e7ee9035cd5a64'],13,21,34,497302,1,0,0,1,1650
b4e9aacfb01a798636dde2727612f5fa080120e9,0,Jake Farrell,2012-08-09 16:03:14+00:00,['e06e8b7e992dd543f32d04550125cbd4a9b558c6'],1,1,2,497304,1,,,,1650
ffd7685c09007d1057a17309ad9dbb49a9f71d48,0,Jake Farrell,2012-08-13 04:03:44+00:00,['b4e9aacfb01a798636dde2727612f5fa080120e9'],1,1,2,497306,1,,,,1650
c02efe21c11cc8196ccf2429c90ba286c049d852,1,Jake Farrell,2012-08-18 03:31:28+00:00,['ffd7685c09007d1057a17309ad9dbb49a9f71d48'],11,19,30,497336,9,,,,1650
2853cc0adffae223e0861524eb8e23af03b7a19b,1,Jake Farrell,2012-08-22 02:27:06+00:00,['c02efe21c11cc8196ccf2429c90ba286c049d852'],1,19,20,497356,1,0,1,0,1650
afd3ab2714fd3a5736dd86a193b800bb0a9a5f37,0,Jake Farrell,2012-08-22 02:57:07+00:00,['2853cc0adffae223e0861524eb8e23af03b7a19b'],0,1,1,497357,1,0,1,1,1650
6cd63ecf5bf2d0ad639250f5b5d094e849ede7e3,1,Jake Farrell,2012-08-29 02:04:35+00:00,['afd3ab2714fd3a5736dd86a193b800bb0a9a5f37'],2,837,839,498196,8,,,,1657
f88f9c231ebcd8f19bb040f78bc03e6b33a2982c,0,Jake Farrell,2012-09-02 03:26:50+00:00,['6cd63ecf5bf2d0ad639250f5b5d094e849ede7e3'],4,4,8,498204,1,,,,1657
21c0a85079e3e1b5ee475bd6654512079fe5df68,1,Roger Meier,2012-09-05 19:47:14+00:00,['f88f9c231ebcd8f19bb040f78bc03e6b33a2982c'],4675,7064,11739,509943,71,0.463081862,0.529695024,0.527287319,1700
814818e779e0db6d8e1ffe24920e856755990738,0,Roger Meier,2012-09-05 20:07:52+00:00,['21c0a85079e3e1b5ee475bd6654512079fe5df68'],0,0,0,509943,20,,,,1700
5cac98c659b2fa14ff08f9acd6907786644e250a,0,Roger Meier,2012-09-06 17:59:55+00:00,['814818e779e0db6d8e1ffe24920e856755990738'],1,1,2,509945,1,,,,1700
630ce09ae6f8bca0ac456cbdc9984de73e08512c,1,Bryan Duxbury,2012-09-11 18:33:07+00:00,['5cac98c659b2fa14ff08f9acd6907786644e250a'],2,2,4,509949,1,,,,1700
2b2c0b2eba61aa3ae0d7071e2002d13ad2f77d4f,1,Roger Meier,2012-09-12 20:09:02+00:00,['630ce09ae6f8bca0ac456cbdc9984de73e08512c'],0,782,782,510731,3,,,,1703
e2ef3179b6fd55b4ab3a68a985eb8cdc0ffa1432,0,Jake Farrell,2012-09-13 01:43:10+00:00,['2b2c0b2eba61aa3ae0d7071e2002d13ad2f77d4f'],1,1,2,510733,1,,,,1703
3087738f284efdc49aac28d68b50b26f0842b714,1,Roger Meier,2012-09-17 21:18:05+00:00,['e2ef3179b6fd55b4ab3a68a985eb8cdc0ffa1432'],9,104,113,510846,5,,,,1704
3d37fba2063f87accb8cc22b5c78d00d85ecc49e,1,Roger Meier,2012-09-19 19:30:36+00:00,['3087738f284efdc49aac28d68b50b26f0842b714'],10,34,44,510890,2,0,0,0,1704
962b35309d33af60db65cac928f0a8411c6dc06d,0,Henrique Mendonca,2012-09-20 13:19:55+00:00,['3d37fba2063f87accb8cc22b5c78d00d85ecc49e'],1,1,2,510892,1,,,,1704
ffb031d74ea3dbcfe271bd098fbe8642f57f7e69,0,Henrique Mendonca,2012-09-24 18:36:16+00:00,['962b35309d33af60db65cac928f0a8411c6dc06d'],7,8,15,510907,1,0,0,1,1704
41dfe6fd5eee6716ef31e65509d6f30a34189c7b,0,Henrique Mendonca,2012-09-24 19:11:19+00:00,['ffb031d74ea3dbcfe271bd098fbe8642f57f7e69'],2,2,4,510911,1,,,,1704
78a54a17f148c17e5c0e9717f2e869066a45130a,0,Jake Farrell,2012-09-25 18:58:27+00:00,['41dfe6fd5eee6716ef31e65509d6f30a34189c7b'],2,4,6,510917,1,0,1,1,1704
6e283a0e6df7a64f88a82bd9031dcf22a8399377,0,Henrique Mendonca,2012-09-27 12:58:40+00:00,['78a54a17f148c17e5c0e9717f2e869066a45130a'],20,20,40,510957,1,,,,1704
6af2ec09b3ce3a9b440b79fb918e0c0378a703d5,0,Henrique Mendonca,2012-09-27 13:14:36+00:00,['6e283a0e6df7a64f88a82bd9031dcf22a8399377'],2,11,13,510970,1,1,1,0.888888889,1704
a87810ff4b4fb75ccb83e4720169422a77939527,1,Jake Farrell,2012-09-28 01:59:04+00:00,['6af2ec09b3ce3a9b440b79fb918e0c0378a703d5'],902,865,1767,512737,26,0,0,0,1704
c34d7d75fb4f383182f1fab70cb18c6da9b662e3,1,Jake Farrell,2012-09-28 11:25:42+00:00,['a87810ff4b4fb75ccb83e4720169422a77939527'],2,4,6,512743,2,0,1,1,1704
373a26b0c63b0cab8195563aa8911fd5eb70013f,0,Jake Farrell,2012-09-28 12:08:01+00:00,['c34d7d75fb4f383182f1fab70cb18c6da9b662e3'],1,3,4,512747,1,,,,1704
2fd8a15fc4e458aee13dd3be7fcba96bb5019c38,1,Jake Farrell,2012-09-29 00:26:36+00:00,['373a26b0c63b0cab8195563aa8911fd5eb70013f'],91,26,117,512864,3,1,1,0,1704
5d6bd5a606b4cd1f77c65d75888e8424ed22d912,0,Jake Farrell,2012-10-01 18:42:23+00:00,['2fd8a15fc4e458aee13dd3be7fcba96bb5019c38'],17,20,37,512901,5,,,,1704
ecad39224c5b03a316c0953322de235ebce088f7,0,Henrique Mendonca,2012-10-03 09:25:52+00:00,['5d6bd5a606b4cd1f77c65d75888e8424ed22d912'],0,5,5,512906,1,1,1,1,1704
bd5db3aa702952615f26516a4c9d6e9e16e63a0b,1,Henrique Mendonca,2012-10-03 09:26:32+00:00,['ecad39224c5b03a316c0953322de235ebce088f7'],0,850,850,513756,1,0.711711712,0.925675676,0.963963964,1705
b69d24dbf71176bff8b8ad6cf4f59605c9cdd322,1,Roger Meier,2012-10-04 18:02:15+00:00,['bd5db3aa702952615f26516a4c9d6e9e16e63a0b'],370,351,721,514477,35,0,0,0,1705
093f5cef5304ffa02c90aa21c30c8faa88587000,0,Roger Meier,2012-10-04 18:09:05+00:00,['b69d24dbf71176bff8b8ad6cf4f59605c9cdd322'],0,0,0,514477,0,,,,1705
14c217d490066527fba2b8eda8e4020abbe31739,0,Jake Farrell,2012-10-05 00:38:11+00:00,['093f5cef5304ffa02c90aa21c30c8faa88587000'],3,10,13,514490,1,1,1,1,1705
f6e8b0d3fffc5ce31c228012a01ca6a1a10bff7c,0,Jake Farrell,2012-10-05 00:41:59+00:00,['14c217d490066527fba2b8eda8e4020abbe31739'],257,24,281,514771,6,,,,1705
bd6e2b198d97bfc5aca66f25dc1f954dc2875f9b,0,Roger Meier,2012-10-05 13:11:57+00:00,['f6e8b0d3fffc5ce31c228012a01ca6a1a10bff7c'],0,0,0,514771,0,,,,1705
96be0071c62999befcd7ce018198b2219b7597b2,0,Jake Farrell,2012-10-06 00:26:28+00:00,['bd6e2b198d97bfc5aca66f25dc1f954dc2875f9b'],26,26,52,514823,2,0.2,1,1,1705
be7493ee3275b6737c6f183a8b90e289820a51cd,0,Jake Farrell,2012-10-06 02:51:45+00:00,['96be0071c62999befcd7ce018198b2219b7597b2'],1,1,2,514825,1,,,,1705
1f4be7e857d24863a808e9ec8ad52d08e5e90cab,0,Roger Meier,2012-10-06 06:00:47+00:00,['be7493ee3275b6737c6f183a8b90e289820a51cd'],2,2,4,514829,2,,,,1705
dfb8298b28560f0e23b16b10e53c0be24183834b,0,Roger Meier,2012-10-06 06:10:57+00:00,['1f4be7e857d24863a808e9ec8ad52d08e5e90cab'],1,0,1,514830,1,1,0,0,1705
3bef8c221a14a07dfd7c200e8bb3dbb4c09bc390,1,Roger Meier,2012-10-06 06:58:00+00:00,['dfb8298b28560f0e23b16b10e53c0be24183834b'],1067,1908,2975,517805,6,,,,1706
ca0d2f995ee4bbe3384920b207c32635e5c2e048,0,Roger Meier,2012-10-06 10:35:29+00:00,['3bef8c221a14a07dfd7c200e8bb3dbb4c09bc390'],2,2,4,517809,1,,,,1706
061d4a2cb460cc7afebea3c5f1d20382b8454090,0,Roger Meier,2012-10-07 11:51:00+00:00,['ca0d2f995ee4bbe3384920b207c32635e5c2e048'],54,71,125,517934,5,0,0,0.6,1706
819ad6ed3fe2fe945f3146a6f7f2658d980eb42f,0,Roger Meier,2012-10-07 14:56:05+00:00,['061d4a2cb460cc7afebea3c5f1d20382b8454090'],743,0,743,518677,2,0.112676056,0,0,1706
e983cf51f3ca515757b55a46ccacc0cbeaf9182c,1,Roger Meier,2012-10-07 19:15:04+00:00,['819ad6ed3fe2fe945f3146a6f7f2658d980eb42f'],289,363,652,519329,4,,,,1706
fc35612d1dba14b47dadfed1c354f4d20be63e03,1,Jake Farrell,2012-10-09 00:30:03+00:00,['e983cf51f3ca515757b55a46ccacc0cbeaf9182c'],1,3,4,519333,1,,,,1706
b5a18a150ee73003ab760f85023e5fcb3625c8e5,0,Jake Farrell,2012-10-09 01:10:43+00:00,['fc35612d1dba14b47dadfed1c354f4d20be63e03'],88,583,671,520004,24,0.977578475,0.995515695,0.99103139,1710
9429a1246215c37043febc8d35215cbbab99f9fa,0,Jake Farrell,2012-10-09 01:21:45+00:00,['b5a18a150ee73003ab760f85023e5fcb3625c8e5'],1,1,2,520006,1,,,,1710
f1ede7921130c48d79ec4071ff70575b2552979f,1,Roger Meier,2012-10-09 18:42:16+00:00,['9429a1246215c37043febc8d35215cbbab99f9fa'],3,38,41,520047,1,0.8,0,1,1710
271e47a74debf3e504f3ee317c135e0453e3841b,1,Roger Meier,2012-10-09 18:46:55+00:00,['f1ede7921130c48d79ec4071ff70575b2552979f'],3,3,6,520053,1,,,,1710
a32ac7a010cf2f01b0f81299af42fb777e73e81e,1,Jake Farrell,2012-10-09 19:59:35+00:00,['271e47a74debf3e504f3ee317c135e0453e3841b'],1,1,2,520055,1,,,,1710
510ecae94668b689dcea2061c49a66a34fb66e1e,1,Jake Farrell,2012-10-11 00:20:00+00:00,['a32ac7a010cf2f01b0f81299af42fb777e73e81e'],2,4,6,520061,1,,,,1710
7c7a5e05ba5dd7ddb30b2787da7ec52f3b9e8f6f,1,Jake Farrell,2012-10-11 00:29:11+00:00,['510ecae94668b689dcea2061c49a66a34fb66e1e'],2,16,18,520079,7,,,,1710
dddc5df81f3bb7fa41bc40f78dff969e858db90c,0,Jake Farrell,2012-10-11 00:39:23+00:00,['7c7a5e05ba5dd7ddb30b2787da7ec52f3b9e8f6f'],0,0,0,520079,0,,,,1710
c6c01f26dbf8c8fdb218d67354ac68b1703e2e08,0,Jake Farrell,2012-10-11 20:22:24+00:00,['dddc5df81f3bb7fa41bc40f78dff969e858db90c'],21,307,328,520407,16,,,,1710
6fcecd45a715c02452af6674f44e8edb6b0a2f42,1,Jake Farrell,2012-10-11 20:34:25+00:00,['7c7a5e05ba5dd7ddb30b2787da7ec52f3b9e8f6f'],24,310,334,520741,16,,,,1710
435e1c4f70bd5216676a7cded0448fb8bc564989,0,Jake Farrell,2012-10-12 00:43:13+00:00,['6fcecd45a715c02452af6674f44e8edb6b0a2f42'],8,47,55,520796,3,1,1,1,1710
1a15f7ceda9e0ed137a1a9808ed2a1b997ee78aa,0,Jake Farrell,2012-10-12 00:45:34+00:00,['c6c01f26dbf8c8fdb218d67354ac68b1703e2e08'],8,47,55,520851,3,1,1,1,1710
a0bd52367087d8c844b81f5d88087978a3d23822,1,Jake Farrell,2012-10-12 14:44:14+00:00,['435e1c4f70bd5216676a7cded0448fb8bc564989'],5,12,17,520868,2,,,,1710
4cc119c9545be81aeb41d07d2fbcc060229a9208,0,Jake Farrell,2012-10-12 14:55:57+00:00,['a0bd52367087d8c844b81f5d88087978a3d23822'],0,0,0,520868,0,,,,1710
9bb65ae29d9e674740cb8fa4fcc18d14fd734f68,0,Roger Meier,2012-10-17 22:02:01+00:00,['4cc119c9545be81aeb41d07d2fbcc060229a9208'],0,1,1,520869,1,,,,1710
771ca3cdf187e108444ace60444e611b1cbe2222,1,Roger Meier,2012-10-17 22:05:44+00:00,['9bb65ae29d9e674740cb8fa4fcc18d14fd734f68'],3,3,6,520875,2,,,,1710
98f93778e1ea5b8b3dbed7bb946cddf6208fbe42,0,Jake Farrell,2012-10-20 16:47:51+00:00,['771ca3cdf187e108444ace60444e611b1cbe2222'],9,11,20,520895,1,1,1,1,1710
79655fbe0b9bf0ca310ce35bafcfb47f76642e6d,1,Roger Meier,2012-10-20 20:59:41+00:00,['98f93778e1ea5b8b3dbed7bb946cddf6208fbe42'],333,382,715,521610,4,,,,1710
cc6ea425b74a5ee8e8d508b10aa0f78d1ccc0807,0,Roger Meier,2012-10-20 21:18:43+00:00,['79655fbe0b9bf0ca310ce35bafcfb47f76642e6d'],2,8,10,521620,1,,0,,1710
e854206180658f3e840518d46def3572cc79178e,0,Roger Meier,2012-10-20 21:29:02+00:00,['cc6ea425b74a5ee8e8d508b10aa0f78d1ccc0807'],0,2,2,521622,1,0,0,1,1710
708f64d4dee53ec6ab95b427711eb3d4cdca3ed2,0,Roger Meier,2012-10-20 21:33:49+00:00,['e854206180658f3e840518d46def3572cc79178e'],0,5,5,521627,1,,,,1710
8d410de0a057e301505c870a9a67e0e73510d0a0,1,Henrique Mendonca,2012-10-22 18:35:30+00:00,['708f64d4dee53ec6ab95b427711eb3d4cdca3ed2'],0,36,36,521663,2,1,1,1,1711
fa89932a49f80ddea079c783232f6d304c59352e,0,Roger Meier,2012-10-22 19:27:38+00:00,['8d410de0a057e301505c870a9a67e0e73510d0a0'],47,175,222,521885,9,,,,1712
4268dad23d1057b030a102828d4db55f90bba104,0,Roger Meier,2012-10-22 19:52:40+00:00,['fa89932a49f80ddea079c783232f6d304c59352e'],1,1,2,521887,1,,,,1712
d407b2d1caa3cf47858912525bff0325759a4ddc,1,Henrique Mendonca,2012-10-22 21:06:14+00:00,['4268dad23d1057b030a102828d4db55f90bba104'],51,156,207,522094,9,0.988636364,1,1,1712
ee4aaaee621650f1474de596d860e755fc98b695,0,Jake Farrell,2012-10-23 00:48:17+00:00,['d407b2d1caa3cf47858912525bff0325759a4ddc'],2,56,58,522152,3,,,,1712
18a90d16259971d8d076e98463327b7492f728b6,1,Roger Meier,2012-10-24 18:40:06+00:00,['ee4aaaee621650f1474de596d860e755fc98b695'],37,93,130,522282,8,,,,1713
d836afcb94e708559b258eb8d7110fcc04a7a59e,0,Roger Meier,2012-10-24 18:59:43+00:00,['18a90d16259971d8d076e98463327b7492f728b6'],0,0,0,522282,0,,,,1713
585b7b804498e207280a378c52eb7056174bf846,0,Roger Meier,2012-10-24 21:12:47+00:00,['d836afcb94e708559b258eb8d7110fcc04a7a59e'],1,1,2,522284,1,,,,1713
f168e0ad46d2c162223f7fcf38bbcea626134e06,0,Roger Meier,2012-10-24 21:38:21+00:00,['585b7b804498e207280a378c52eb7056174bf846'],0,6,6,522290,1,,,,1713
995976bef31d9f16ff020862319a110e88d26f5e,0,Roger Meier,2012-10-24 21:39:54+00:00,['f168e0ad46d2c162223f7fcf38bbcea626134e06'],0,0,0,522290,0,,,,1713
50fb50176f25fe9367c0e2a08cb5536f1bb16f08,1,Henrique Mendonca,2012-10-26 07:29:47+00:00,['995976bef31d9f16ff020862319a110e88d26f5e'],274,278,552,522842,3,0.482142857,0,1,1715
ccfedcb64396a630c6233a521b2719c7b4a032f7,0,Roger Meier,2012-10-26 20:19:44+00:00,['50fb50176f25fe9367c0e2a08cb5536f1bb16f08'],1,1,2,522844,1,,,,1715
1d66d061b7c513d3e50ad1f3ed346437d213f6d1,0,Roger Meier,2012-10-26 21:46:18+00:00,['ccfedcb64396a630c6233a521b2719c7b4a032f7'],12,89,101,522945,9,,,,1717
36ae65cf2e2c05b6998f1609f5ee9b2da8dbdcfd,0,Henrique Mendonca,2012-10-29 21:55:46+00:00,['1d66d061b7c513d3e50ad1f3ed346437d213f6d1'],0,4,4,522949,1,,,,1717
f4cd5ba4348f851334ead5b5c696b8e85baf8917,0,Roger Meier,2012-11-01 22:59:09+00:00,['36ae65cf2e2c05b6998f1609f5ee9b2da8dbdcfd'],0,3,3,522952,1,,,,1717
c9ce87fb02004b1864bc7e880b79fd411a2a2b9e,0,Roger Meier,2012-11-01 23:02:07+00:00,['f4cd5ba4348f851334ead5b5c696b8e85baf8917'],0,3,3,522955,1,,,,1717
85fb6de7f4c1ea6260f98bc24401593e8c974bc7,1,Roger Meier,2012-11-02 00:05:42+00:00,['c9ce87fb02004b1864bc7e880b79fd411a2a2b9e'],13,510,523,523478,6,0.848275862,0.848275862,0.913793103,1718
691ec0021338c143dd4444d00b87925c5ec3c10b,0,Roger Meier,2012-11-02 07:50:24+00:00,['85fb6de7f4c1ea6260f98bc24401593e8c974bc7'],2,5,7,523485,2,,,,1718
05ab89a1286049567e8d6ada1833a7d75179a365,0,Roger Meier,2012-11-02 10:36:59+00:00,['691ec0021338c143dd4444d00b87925c5ec3c10b'],1,1,2,523487,1,,,,1718
0069a4464012172f07b5f56064ed9ae6b79f9c52,0,Roger Meier,2012-11-07 20:26:03+00:00,['05ab89a1286049567e8d6ada1833a7d75179a365'],9,0,9,523496,1,,,,1718
52820d09195729416e9b5b4894107bf332afc62e,1,Roger Meier,2012-11-08 23:11:14+00:00,['0069a4464012172f07b5f56064ed9ae6b79f9c52'],2,3,5,523501,1,0,0,1,1718
3806a743c8237255f292d889902a4fed0d094842,0,Roger Meier,2012-11-15 21:46:01+00:00,['52820d09195729416e9b5b4894107bf332afc62e'],1,1,2,523503,1,,,,1718
32104d71bd841056ac3bc63beee26022ada471e5,0,Roger Meier,2012-11-15 22:20:44+00:00,['3806a743c8237255f292d889902a4fed0d094842'],4,4,8,523511,1,,,,1718
e242a96ae3582aaca8a5407211f05a6a6ea78ceb,1,Roger Meier,2012-11-15 22:23:27+00:00,['32104d71bd841056ac3bc63beee26022ada471e5'],4,7,11,523522,1,,,,1718
8252577ec9da25f027b9edfa6876f9d9a0094566,1,Roger Meier,2012-11-16 00:38:27+00:00,['e242a96ae3582aaca8a5407211f05a6a6ea78ceb'],84,203,287,523809,22,0.25,0.25,1,1719
3e5e9d09016dfbbda7a7a46828faf9cab4235fb8,0,Roger Meier,2012-11-16 00:51:59+00:00,['8252577ec9da25f027b9edfa6876f9d9a0094566'],2,11,13,523822,1,0,0.142857143,1,1719
a2123693838410c1e78170419e9bb91cb01151b4,0,Roger Meier,2012-11-16 01:22:47+00:00,['3e5e9d09016dfbbda7a7a46828faf9cab4235fb8'],1,0,1,523823,1,1,1,0,1719
0d866d7de28b51d5eabceae16cbbfb4f8f5cfb9b,1,jfarrell,2012-12-10 15:46:04-05:00,['a2123693838410c1e78170419e9bb91cb01151b4'],0,3,3,523826,1,,,,1719
2b2560e836fcd07493bee15374f499b3eb77fe47,0,Todd Lipcon,2012-12-10 14:29:59-08:00,['0d866d7de28b51d5eabceae16cbbfb4f8f5cfb9b'],18,18,36,523862,5,,,,1719
741e715e816da102c1206ed71db13a9a4e638045,1,Roger Meier,2012-12-11 21:21:00+01:00,['2b2560e836fcd07493bee15374f499b3eb77fe47'],0,1,1,523863,1,,,,1719
7740739b79d0e694d6a15fa000c30bae028d8785,1,Jens Geyer,2012-12-11 23:38:12+01:00,['741e715e816da102c1206ed71db13a9a4e638045'],2,2,4,523867,1,,,,1719
a9e33bf0f699cd35ce2a1442a705c468b3e4ca45,0,Jens Geyer,2012-12-12 23:11:04+01:00,['7740739b79d0e694d6a15fa000c30bae028d8785'],4,13,17,523884,2,1,1,1,1719
ad4467e9dbce19aa96967599dcec1d6885a9c0a3,1,Jens Geyer,2012-12-14 00:08:24+01:00,['7740739b79d0e694d6a15fa000c30bae028d8785'],77,167,244,524128,1,0.034090909,0,0.125,1719
0ab273abdf0fe6438181586b5d2fe6b587c9e013,1,Jens Geyer,2012-12-14 00:09:15+01:00,['7740739b79d0e694d6a15fa000c30bae028d8785'],36,56,92,524220,1,0,0.111111111,0.888888889,1719
ce52ae7f8ecde8a9b7064ff2144a05cfe637097f,0,Jens Geyer,2012-12-15 03:16:34+01:00,"['ad4467e9dbce19aa96967599dcec1d6885a9c0a3', 'a9e33bf0f699cd35ce2a1442a705c468b3e4ca45']",4,13,17,524237,2,,,,1719
aa4d3aea4e8c309a0991a3b133a11cbdb6f4c19c,0,Jens Geyer,2012-12-15 03:16:46+01:00,"['0ab273abdf0fe6438181586b5d2fe6b587c9e013', 'a9e33bf0f699cd35ce2a1442a705c468b3e4ca45']",4,13,17,524254,2,,,,1719
b03039208092ff96f69f49f5ea939855129e504f,0,Jens Geyer,2012-12-15 03:18:26+01:00,"['aa4d3aea4e8c309a0991a3b133a11cbdb6f4c19c', 'ce52ae7f8ecde8a9b7064ff2144a05cfe637097f']",77,167,244,524498,1,,,,1719
e7b0b692461735366d77b73a497863cc86c22d91,1,Roger Meier,2012-12-16 15:44:48+01:00,['b03039208092ff96f69f49f5ea939855129e504f'],6,50,56,524554,2,0,0.428571429,0.333333333,1719
8538edfee709db3eac7b9f85afce899299a23965,1,Roger Meier,2012-12-16 15:55:45+01:00,['e7b0b692461735366d77b73a497863cc86c22d91'],0,155,155,524709,2,0.276315789,1,1,1721
65d83ecf3e5350e6194a38de2a201f4ea8665ff3,1,Jens Geyer,2012-12-16 19:00:27+01:00,['b03039208092ff96f69f49f5ea939855129e504f'],88,132,220,524929,1,0.088235294,0,0.294117647,1721
716454e36ef0b80821673c6f09da08e4bc342897,0,Jens Geyer,2012-12-16 19:04:52+01:00,"['65d83ecf3e5350e6194a38de2a201f4ea8665ff3', '8538edfee709db3eac7b9f85afce899299a23965']",6,205,211,525140,4,,,,1721
59a884b739f87e6a94a71a532e3dc073141385eb,0,Jens Geyer,2012-12-16 20:04:19+01:00,['716454e36ef0b80821673c6f09da08e4bc342897'],1,7,8,525148,1,0,0.75,0.25,1721
04f70976ac1cb43d178dd5878ee858519a452421,1,Jens Geyer,2012-12-17 22:41:21+01:00,['59a884b739f87e6a94a71a532e3dc073141385eb'],0,38,38,525186,1,1,0.551724138,1,1721
a58a9cb99f932f8e5a646255a6f539c4ba594da2,0,Jens Geyer,2012-12-17 23:24:13+01:00,['04f70976ac1cb43d178dd5878ee858519a452421'],3,43,46,525232,1,0.333333333,0.424242424,0,1721
ad8154a7a82cfdd25e55d8488496ab8a7fce257f,1,Roger Meier,2012-12-18 21:02:16+01:00,['a58a9cb99f932f8e5a646255a6f539c4ba594da2'],33,39,72,525304,3,1,1,1,1721
5bcf32bfa8ea52b0783a52e773b6e2546bb9f406,0,Jens Geyer,2012-12-18 22:35:04+01:00,['ad8154a7a82cfdd25e55d8488496ab8a7fce257f'],5,10,15,525319,1,0,0,0,1721
38f955ef7ea4764c19fca185725a8f84f414abba,0,Roger Meier,2012-12-21 22:47:40+01:00,['5bcf32bfa8ea52b0783a52e773b6e2546bb9f406'],87,0,87,525406,2,,,,1721
c880b44c5d81ade7ceb897fd55af94c0a8e5b31a,0,Jens Geyer,2012-12-21 23:07:29+01:00,['5bcf32bfa8ea52b0783a52e773b6e2546bb9f406'],29,75,104,525510,1,0.818181818,0.954545455,0.863636364,1721
d0c3586e499fad2e7a30ffb08d3de901a5bb008c,0,Jens Geyer,2012-12-21 23:08:22+01:00,"['c880b44c5d81ade7ceb897fd55af94c0a8e5b31a', '38f955ef7ea4764c19fca185725a8f84f414abba']",87,0,87,525597,2,,,,1721
8fa8aeac9a0f2ff4f11ac0ef73fc677bebd7a75f,0,Roger Meier,2012-12-22 19:46:28+01:00,['d0c3586e499fad2e7a30ffb08d3de901a5bb008c'],2,18,20,525617,1,1,1,1,1721
0193149842924b65c5d3761d60055d298470d3ab,0,Roger Meier,2012-12-22 21:31:03+01:00,['8fa8aeac9a0f2ff4f11ac0ef73fc677bebd7a75f'],26,132,158,525775,20,0,0,1,1721
5d06db63cf7077cffff52f46f44317f48fd01c65,0,Roger Meier,2012-12-23 17:20:20+01:00,['0193149842924b65c5d3761d60055d298470d3ab'],7,8,15,525790,4,0.666666667,0.333333333,0,1721
b2f29d84025d9dc2472632cc9bff6c8b5f9bc5b1,1,Roger Meier,2012-12-23 20:23:39+01:00,['5d06db63cf7077cffff52f46f44317f48fd01c65'],0,28,28,525818,1,0,0,1,1721
63e3c6307806f58a0325a1fe895e7c7f6b73d6f3,1,Jens Geyer,2012-12-24 10:32:58+01:00,['d0c3586e499fad2e7a30ffb08d3de901a5bb008c'],10,146,156,525974,1,0.101010101,0.111111111,0.98989899,1721
b911b6a27c1dc9fa71e8bee8c54fde8ebfd847f7,0,Jens Geyer,2012-12-24 10:33:55+01:00,"['63e3c6307806f58a0325a1fe895e7c7f6b73d6f3', 'b2f29d84025d9dc2472632cc9bff6c8b5f9bc5b1']",35,186,221,526195,26,,,,1721
0895dfe6c0f74f77cea1ed5c4e28ac0c0b27d525,1,Roger Meier,2012-12-26 22:09:55+01:00,['b911b6a27c1dc9fa71e8bee8c54fde8ebfd847f7'],13,235,248,526443,4,0.714285714,0.982142857,0.8125,1722
f089f8ee5f9ec70fdf8eb401d6844d05d7927cd5,0,Roger Meier,2012-12-27 00:17:39+01:00,['0895dfe6c0f74f77cea1ed5c4e28ac0c0b27d525'],10,0,10,526453,1,,,,1722
19dbbefcc183abce5f502aadc83fc86b7edb90c7,1,Roger Meier,2012-12-27 01:24:20+01:00,['f089f8ee5f9ec70fdf8eb401d6844d05d7927cd5'],45,253,298,526751,10,0.433566434,0.902097902,1,1722
6df4f3bbc7d6b955d403ea1523b74f10047aa6ff,0,Roger Meier,2012-12-27 02:32:44+01:00,['19dbbefcc183abce5f502aadc83fc86b7edb90c7'],13,15,28,526779,1,0,0,1,1722
d94399a8f9620c13f5ed3e515cec172838a77f6b,1,Roger Meier,2012-12-27 22:21:32+01:00,['6df4f3bbc7d6b955d403ea1523b74f10047aa6ff'],0,111,111,526890,1,,,,1723
d996739bffab35b2b5cccc816609e8ad07f703ac,0,Roger Meier,2012-12-28 00:20:21+01:00,['d94399a8f9620c13f5ed3e515cec172838a77f6b'],1,0,1,526891,1,,,,1723
47a6e47081970a50c904d7c67854d0903b2598c7,1,Jens Geyer,2013-01-04 18:55:50+01:00,['d996739bffab35b2b5cccc816609e8ad07f703ac'],0,14,14,526905,1,,,,1723
945537c1fc88ae27ac8231d423927fb7b40d10a6,0,Jens Geyer,2013-01-04 19:33:29+01:00,['47a6e47081970a50c904d7c67854d0903b2598c7'],28,174,202,527107,21,,,,1723
1f554e1a9c643a717f8687f62596ae9ae3479234,0,Roger Meier,2013-01-05 20:38:35+01:00,['945537c1fc88ae27ac8231d423927fb7b40d10a6'],13,29,42,527149,2,1,1,0,1723
e3f671034cf48710bca775a58900988c0986e6d0,0,Roger Meier,2013-01-05 20:46:43+01:00,['1f554e1a9c643a717f8687f62596ae9ae3479234'],4,4,8,527157,3,,,,1723
8ebe0d917cbd64dcd341a5f5412a2872122a44df,1,Roger Meier,2013-01-06 14:33:39+01:00,['e3f671034cf48710bca775a58900988c0986e6d0'],81,179,260,527417,4,0,0,1,1723
87afaacb957e39f2100271180329dd7d718516e8,0,Roger Meier,2013-01-06 20:10:42+01:00,['8ebe0d917cbd64dcd341a5f5412a2872122a44df'],12,19,31,527448,2,0,1,1,1723
6a9df6e085cde94a38a3c3c0af55c8356267dd23,0,Roger Meier,2013-01-06 20:11:28+01:00,['87afaacb957e39f2100271180329dd7d718516e8'],1,17,18,527466,1,,,,1723
a17265d61588dd53083d34bb1e3621c571a1e562,1,Roger Meier,2013-01-08 23:12:28+01:00,['6a9df6e085cde94a38a3c3c0af55c8356267dd23'],14,11,25,527491,15,,,,1724
f5305b0b6a923ee324249aa8ca8ecdf1ea6506d9,0,Roger Meier,2013-01-10 23:18:14+01:00,['a17265d61588dd53083d34bb1e3621c571a1e562'],0,19,19,527510,1,,,,1725
e3da768367d0a3e013a00a5a365e58aed3bffa32,1,Roger Meier,2013-01-11 11:41:53+01:00,['f5305b0b6a923ee324249aa8ca8ecdf1ea6506d9'],142,142,284,527794,49,,,,1725
c095919087adc9508300ec6e9cdcd58cf147a207,1,Roger Meier,2013-01-15 23:20:19+01:00,['e3da768367d0a3e013a00a5a365e58aed3bffa32'],5,7,12,527806,7,,,,1725
f42ce2a8f49cf09e695974e6cd3c434b8dda61ab,1,Roger Meier,2013-01-16 22:12:14+01:00,['c095919087adc9508300ec6e9cdcd58cf147a207'],81,343,424,528230,4,0,0,1,1725
d5364246335f33c75d1c18fad5c5fbd974b8f929,1,Roger Meier,2013-01-16 22:46:10+01:00,['f42ce2a8f49cf09e695974e6cd3c434b8dda61ab'],1,1,2,528232,1,,,,1725
a1e36f6ee59e0502c1a5f759e4d43c2dbc4c6542,1,Jens Geyer,2013-01-17 22:46:57+01:00,['d5364246335f33c75d1c18fad5c5fbd974b8f929'],32,31,63,528295,1,1,1,0,1725
772b2b1804252c76142be5a025a0f48e19c0c792,0,Roger Meier,2013-01-19 21:04:12+01:00,['a1e36f6ee59e0502c1a5f759e4d43c2dbc4c6542'],2,3,5,528300,2,1,1,1,1725
d34bea0c04321a8cdd4df210f1ca06e1c728da9f,0,Roger Meier,2013-01-22 21:36:42+01:00,['772b2b1804252c76142be5a025a0f48e19c0c792'],2,3,5,528305,2,,,,1725
7b96b2249a43ae75b48e0aba7e8beffc67b32d93,0,Roger Meier,2013-01-23 20:18:58+01:00,['d34bea0c04321a8cdd4df210f1ca06e1c728da9f'],2,2,4,528309,1,,,,1725
b64a774b2fbfab034c0b7fff1641a46d8123d19f,1,Jens Geyer,2013-01-23 20:58:47+01:00,['d34bea0c04321a8cdd4df210f1ca06e1c728da9f'],68,77,145,528454,3,,,,1725
1bb903225a15ce0565edf7a274ada63c891d5079,0,Jens Geyer,2013-01-23 20:59:13+01:00,"['b64a774b2fbfab034c0b7fff1641a46d8123d19f', '7b96b2249a43ae75b48e0aba7e8beffc67b32d93']",2,2,4,528458,1,,,,1725
814d4c7fb94e5dcafadf7188da3bd3f8bd132190,0,Roger Meier,2013-01-24 23:16:54+01:00,['1bb903225a15ce0565edf7a274ada63c891d5079'],20,25,45,528503,1,1,1,1,1725
3a67c2f834119b8a1148ab071443c8d12ce207a1,0,Jens Geyer,2013-02-03 22:30:41+01:00,['814d4c7fb94e5dcafadf7188da3bd3f8bd132190'],3,6,9,528512,2,0,1,1,1725
1af57289f299f9f03c9ed0e5826f8e464171bbf9,0,Jake Farrell,2013-02-17 14:44:46-05:00,['3a67c2f834119b8a1148ab071443c8d12ce207a1'],8,10,18,528530,1,0,0,0,1725
5b0c590968a8864f93273cc0957a59774717519e,0,Jake Farrell,2013-02-17 19:31:04-05:00,['1af57289f299f9f03c9ed0e5826f8e464171bbf9'],1,2,3,528533,1,0,0,0,1725
04f83112f6a84d5f572921990adf4b122e15d377,0,Jake Farrell,2013-03-02 22:51:55-05:00,['5b0c590968a8864f93273cc0957a59774717519e'],2,23,25,528558,1,1,1,1,1725
073f9eb9b920bda948b306ee16e78743e42b7cd1,1,Jake Farrell,2013-03-04 20:59:38-05:00,['04f83112f6a84d5f572921990adf4b122e15d377'],116,239,355,528913,6,0.433333333,0.733333333,0.2,1727
92e3860cfbaab5132439b9bac2e18dba06494bcc,1,Chris Piro,2013-03-07 11:24:51-05:00,['073f9eb9b920bda948b306ee16e78743e42b7cd1'],12,18,30,528943,8,,,,1727
20c81ad74c53c102692adec0e3c68d413899cabd,1,Chris Piro,2013-03-07 11:32:48-05:00,['92e3860cfbaab5132439b9bac2e18dba06494bcc'],52,968,1020,529963,11,0.403100775,0.48255814,0.67248062,1733
6a7463a725db0ff228cc9048f9f1bfb8319c0f96,1,Jens Geyer,2013-03-07 20:40:59+01:00,['20c81ad74c53c102692adec0e3c68d413899cabd'],26,37,63,530026,1,,,,1733
5cb0d22a03c709ec9f581a615b9274ab765cea26,0,Jens Geyer,2013-03-07 20:44:22+01:00,['6a7463a725db0ff228cc9048f9f1bfb8319c0f96'],1,1,2,530028,1,,,,1733
0b20cc8a587ecbb556c1fe7e7afb55b9fe449c30,1,Jens Geyer,2013-03-07 20:47:01+01:00,['5cb0d22a03c709ec9f581a615b9274ab765cea26'],12,30,42,530070,5,,,,1733
b19c3394607eb49c3a5e6927cc98fd4010f06a9b,0,Jens Geyer,2013-03-08 09:03:01+01:00,['0b20cc8a587ecbb556c1fe7e7afb55b9fe449c30'],5,1,6,530076,1,1,1,1,1733
b3fb3e60925089b6d4c672d7d2cff76a94303b6a,0,Jens Geyer,2013-03-10 19:07:52+02:00,['b19c3394607eb49c3a5e6927cc98fd4010f06a9b'],10,14,24,530100,1,0,0,0,1733
19251ad24a1f886ca7d2eb9fc0653bdc2567cf7a,0,Jens Geyer,2013-03-10 22:51:14+02:00,['b3fb3e60925089b6d4c672d7d2cff76a94303b6a'],2,2,4,530104,1,,,,1733
9357636f65165129ad3f541317597dd961f77265,0,Roger Meier,2013-03-15 19:49:23+01:00,['19251ad24a1f886ca7d2eb9fc0653bdc2567cf7a'],0,1,1,530105,1,,,,1733
552440e6e522499d974800c98c5f4dd869dc29c7,1,Jens Geyer,2013-03-21 19:55:27+02:00,['9357636f65165129ad3f541317597dd961f77265'],29,101,130,530235,2,0.081967213,0.37704918,0.950819672,1733
7af5868e57b35d5d5e9427484f884cc6af002bbd,0,Jens Geyer,2013-03-21 19:59:05+02:00,['9357636f65165129ad3f541317597dd961f77265'],0,1,1,530236,1,0,1,1,1733
4dd54b6d4ab6603175226810de853a2499ae97a3,0,Jens Geyer,2013-03-21 19:59:45+02:00,"['7af5868e57b35d5d5e9427484f884cc6af002bbd', '552440e6e522499d974800c98c5f4dd869dc29c7']",29,101,130,530366,2,,,,1733
9b2524415c06d627e0cf6cfd5e038271a9bea9e0,0,Roger Meier,2013-03-22 17:05:53+01:00,['4dd54b6d4ab6603175226810de853a2499ae97a3'],0,1,1,530367,1,,,,1733
a51186b7f2bd388d95485404017f05eb3b861074,0,Roger Meier,2013-03-22 17:12:03+01:00,['9b2524415c06d627e0cf6cfd5e038271a9bea9e0'],32,64,96,530463,16,,,,1733
948a2d4fb8d37793974206e4c766df2b26520aba,0,Roger Meier,2013-03-22 19:01:25+01:00,['a51186b7f2bd388d95485404017f05eb3b861074'],1,22,23,530486,1,0,0,0,1733
0c04fccf3a32a334cb449b5b7990e9d116639ce0,0,Roger Meier,2013-03-22 19:52:08+01:00,['948a2d4fb8d37793974206e4c766df2b26520aba'],9,26,35,530521,2,0.9,1,0.9,1733
8cdb9e983ca2dc489e840ac003aaff8c7c7819ac,1,Roger Meier,2013-03-22 21:07:21+01:00,['0c04fccf3a32a334cb449b5b7990e9d116639ce0'],6,19,25,530546,1,,,,1733
565517a16c0760f78f3d6183fa88cc77e3b31842,1,Roger Meier,2013-03-22 21:08:39+01:00,['8cdb9e983ca2dc489e840ac003aaff8c7c7819ac'],22,22,44,530590,9,,,,1733
5505465ffa6476a4e64f01d0d27c540d86fe48fe,0,Roger Meier,2013-03-22 22:11:01+01:00,['565517a16c0760f78f3d6183fa88cc77e3b31842'],0,51,51,530641,1,0,0.8125,0.875,1733
ff951bd5675a1ba72b39abeff8aafb770d3c43cf,0,Roger Meier,2013-03-22 22:12:19+01:00,['5505465ffa6476a4e64f01d0d27c540d86fe48fe'],1,1,2,530643,1,,,,1733
e491d298f09b0a3541a86fec0b9b5499bc3b7baf,0,Roger Meier,2013-03-22 22:18:45+01:00,['ff951bd5675a1ba72b39abeff8aafb770d3c43cf'],1,43,44,530687,2,0,1,1,1734
a7ab94d414ee949bb38dad3e62cd771d6cc8781e,0,Roger Meier,2013-03-22 22:34:16+01:00,['e491d298f09b0a3541a86fec0b9b5499bc3b7baf'],1,1,2,530689,1,,,,1734
1f9717d192137d06927846cc2f2f7e380e5da834,0,Roger Meier,2013-03-23 16:03:38+01:00,['a7ab94d414ee949bb38dad3e62cd771d6cc8781e'],5,21,26,530715,1,1,1,0.8,1734
d1fb1807fe63732d2e5e27fb22f29321676be1c0,0,Jake Farrell,2013-03-23 21:35:03-04:00,['1f9717d192137d06927846cc2f2f7e380e5da834'],6,8,14,530729,2,1,0,1,1734
775862547b132bf26e6cb250caaa46618eb99f4f,1,Jake Farrell,2013-03-23 21:57:17-04:00,['d1fb1807fe63732d2e5e27fb22f29321676be1c0'],0,26,26,530755,1,,,,1735
60723b88ff62f90e031911be5d903f6da99d3c42,1,Jake Farrell,2013-03-23 22:38:48-04:00,['775862547b132bf26e6cb250caaa46618eb99f4f'],4,212,216,530971,4,,,,1737
a87cc5e7708ff7c3fcec1e05a0d70e1f7923e17f,0,Jake Farrell,2013-03-23 22:56:13-04:00,['60723b88ff62f90e031911be5d903f6da99d3c42'],1,1,2,530973,1,,,,1737
3c434ab87dcb44352e71b80cd5a9ef7e24d77427,0,Jake Farrell,2013-03-23 23:27:43-04:00,['a87cc5e7708ff7c3fcec1e05a0d70e1f7923e17f'],1,1,2,530975,1,,,,1737
3661867febfa3a303ae8f5df2ed1a29e882821c3,1,Jens Geyer,2013-03-24 11:53:31+02:00,['3c434ab87dcb44352e71b80cd5a9ef7e24d77427'],0,388,388,531363,3,0.868571429,1,1,1740
ce6d1d709aaaf33d2cdfc7415a6e95b10faac2e5,1,Roger Meier,2013-03-24 21:26:17+01:00,['3661867febfa3a303ae8f5df2ed1a29e882821c3'],1,19,20,531383,1,0,0,1,1740
9cda78844de5097554414e3ef30e62d482679b81,0,Roger Meier,2013-03-24 21:42:35+01:00,['ce6d1d709aaaf33d2cdfc7415a6e95b10faac2e5'],31,49,80,531463,3,0,1,0,1740
cac2c5761e2ebe8b14a3c03dd2ee756c1e14441b,0,Jens Geyer,2013-03-25 01:22:09+02:00,['9cda78844de5097554414e3ef30e62d482679b81'],3,62,65,531528,3,,,,1740
8a70196d00b667b5e890cb0974373d2a2af4f82c,0,Jens Geyer,2013-03-25 01:32:57+02:00,['cac2c5761e2ebe8b14a3c03dd2ee756c1e14441b'],0,1118,1118,532646,8,,,,1747
2ff542859813ca95c80b67878db4aa4726a6f296,1,Jake Farrell,2013-03-25 22:06:36-04:00,['8a70196d00b667b5e890cb0974373d2a2af4f82c'],0,19,19,532665,1,,,,1748
2d26f18a12d20e2bc5063a34ff347558fa91517f,0,Jake Farrell,2013-03-25 23:49:37-04:00,['2ff542859813ca95c80b67878db4aa4726a6f296'],1,1,2,532667,1,,,,1748
3a931b50d906db8099d3819a4c8c89328bb92a61,0,Roger Meier,2013-03-26 22:14:03+01:00,['2d26f18a12d20e2bc5063a34ff347558fa91517f'],1,506,507,533174,5,0.628205128,1,0.333333333,1752
06045cf8d962b83ea53a6ea4a6e3cabe3547e666,1,Jens Geyer,2013-03-27 20:26:25+02:00,['3a931b50d906db8099d3819a4c8c89328bb92a61'],127,349,476,533650,6,,,,1752
45766049e0ed4e7fbef11e79ef417a6f970ba696,1,Jens Geyer,2013-03-27 20:32:41+02:00,['06045cf8d962b83ea53a6ea4a6e3cabe3547e666'],2,17,19,533669,1,0,0,1,1752
352a50eb36b851bfb3f69469db580e6edfd6250f,0,jfarrell,2013-03-29 10:51:58-05:00,['1a15f7ceda9e0ed137a1a9808ed2a1b997ee78aa'],0,31,31,533700,1,,,,1753
8f9b4d86acfeb81f9418d38e0f3718e5526b1f70,0,Roger Meier,2013-03-30 11:47:23+01:00,['45766049e0ed4e7fbef11e79ef417a6f970ba696'],162,0,162,533862,3,,,,1753
c613cd2d9bc01ee4eb43a3d40a8691c736f7a316,0,Jake Farrell,2013-04-01 21:39:03-04:00,['8f9b4d86acfeb81f9418d38e0f3718e5526b1f70'],3,3,6,533868,2,,,,1753
93220328d937df63f2a670fed8d4f8da3375c255,1,Jens Geyer,2013-04-09 22:42:31+02:00,['c613cd2d9bc01ee4eb43a3d40a8691c736f7a316'],0,2,2,533870,1,0,0,0,1753
1bd9424b475685b257aec7f075dee27d4b350b03,0,Jens Geyer,2013-04-19 20:15:05+02:00,['93220328d937df63f2a670fed8d4f8da3375c255'],14,18,32,533902,2,0,1,0,1753
de262dc77ee06ab40859230dd57f383ac4f32c61,0,Jake Farrell,2013-04-19 21:58:33-04:00,['1bd9424b475685b257aec7f075dee27d4b350b03'],10,5,15,533917,2,1,1,1,1753
bdb19a467ae9b7dd1d0ec1a104117e56f34b4198,0,jfarrell,2013-04-22 14:41:13-05:00,['de262dc77ee06ab40859230dd57f383ac4f32c61'],16,227,243,534160,4,0.140740741,1,0.762962963,1754
146e5116a2d9de0f9929b3287f9608807283f1f4,0,Jake Farrell,2013-04-22 22:28:56-04:00,['bdb19a467ae9b7dd1d0ec1a104117e56f34b4198'],0,1,1,534161,1,,,,1754
6bdb10b592853fa036ff656032adb03d4b1a3ef4,1,jfarrell,2013-04-23 15:42:04-05:00,['146e5116a2d9de0f9929b3287f9608807283f1f4'],2,2,4,534165,1,,,,1754
0f8acc5697d2ad251fccf469cad5141887626b2d,0,Jens Geyer,2013-04-24 21:53:39+02:00,['6bdb10b592853fa036ff656032adb03d4b1a3ef4'],0,3,3,534168,1,0,0,0,1754
f509df9c969f71d360e7c1394d0d73cb6ab9955c,0,Jens Geyer,2013-04-25 20:38:55+02:00,['0f8acc5697d2ad251fccf469cad5141887626b2d'],711,712,1423,535591,6,,,,1754
938e640702a49a34463bed63bb07fa9256d52584,1,Jake Luciani,2013-04-25 17:53:08-04:00,['f509df9c969f71d360e7c1394d0d73cb6ab9955c'],0,94,94,535685,3,1,1,0.853658537,1755
47af9f170344d04c6896476422cd20c246a676af,0,Jens Geyer,2013-04-26 22:34:53+02:00,['938e640702a49a34463bed63bb07fa9256d52584'],1,3,4,535689,1,0,1,1,1755
1b4c9b9691b856283f13f6ffb5979acc0d2c1738,1,Jens Geyer,2013-04-26 23:38:58+02:00,['47af9f170344d04c6896476422cd20c246a676af'],8,8,16,535705,2,,,,1755
1c9563642973a2b0af91e150383745c540c5765a,0,Roger Meier,2013-04-27 21:13:34+02:00,['1b4c9b9691b856283f13f6ffb5979acc0d2c1738'],2,0,2,535707,1,,,,1755
9a3a5642b867498470f4c722738f1b12c10b970b,1,Roger Meier,2013-04-27 23:09:40+02:00,['1c9563642973a2b0af91e150383745c540c5765a'],0,210,210,535917,4,,,,1759
b706b1a905ce5eb8b195300c585caf53a8272c11,1,Jens Geyer,2013-04-29 22:10:10+02:00,['1b4c9b9691b856283f13f6ffb5979acc0d2c1738'],2,199,201,536118,5,0,0.401459854,0.95620438,1760
1077ed678d532850c5bff866124934197bbd0979,0,Jens Geyer,2013-04-29 22:10:35+02:00,"['b706b1a905ce5eb8b195300c585caf53a8272c11', '9a3a5642b867498470f4c722738f1b12c10b970b']",2,210,212,536330,5,,,,1760
d708ebb6890c58111f05db781927d07a5ce0e9f3,0,Jens Geyer,2013-05-02 19:29:42+02:00,['1077ed678d532850c5bff866124934197bbd0979'],0,3,3,536333,1,0,1,0,1760
7f8b870357ae2a28ba1b6438f8dfb2b23681be12,1,Jens Geyer,2013-05-02 19:52:30+02:00,['d708ebb6890c58111f05db781927d07a5ce0e9f3'],0,2,2,536335,1,,,,1760
0fd47dab1ba4bcb13c2a871ec4e0527c2c6c06bb,0,Jake Farrell,2013-05-02 22:51:52-04:00,['7f8b870357ae2a28ba1b6438f8dfb2b23681be12'],12,10,22,536357,6,,,,1760
967600ef4f09445d9dbb6654dca8d235d9d65f5b,0,Roger Meier,2013-05-03 22:39:53+02:00,['0fd47dab1ba4bcb13c2a871ec4e0527c2c6c06bb'],3,11,14,536371,1,0.125,0.125,0.125,1760
68f8bd77303e71cc9db63842a9d2fab18e87ec02,0,Jake Farrell,2013-05-03 18:52:08-04:00,['967600ef4f09445d9dbb6654dca8d235d9d65f5b'],1,1,2,536373,1,,,,1760
a0836f6c45c9b87523215b158e3311c15b408406,1,Roger Meier,2013-05-05 00:19:38+02:00,['68f8bd77303e71cc9db63842a9d2fab18e87ec02'],0,69,69,536442,1,,,,1761
dcfc7e6b19ce67b97ba448607f45636ce606fd91,0,Roger Meier,2013-05-05 00:59:08+02:00,['a0836f6c45c9b87523215b158e3311c15b408406'],1,1,2,536444,1,,,,1761
1beeaaadd4775a680b8b7940a579071c1cad3be7,1,Roger Meier,2013-05-05 01:42:27+02:00,['dcfc7e6b19ce67b97ba448607f45636ce606fd91'],1,1,2,536446,1,,,,1761
7f1df992479fdcad208889e53b8b982e2428d250,0,Roger Meier,2013-05-05 23:29:34+02:00,['1beeaaadd4775a680b8b7940a579071c1cad3be7'],3,9,12,536458,2,1,1,1,1761
4f623260b5c22c7719f5730c94f999f3d53eb425,0,Roger Meier,2013-05-05 23:59:25+02:00,['7f1df992479fdcad208889e53b8b982e2428d250'],221,2,223,536681,4,0.616,0.424,0,1761
5ed5e8b3f0bff13cbc551ce82d9960b188bb8175,1,Roger Meier,2013-05-06 00:21:04+02:00,['4f623260b5c22c7719f5730c94f999f3d53eb425'],5,23,28,536709,2,0,1,0.6,1761
6d7473d0f1c5a4357d841456df7e07ee336883c9,0,Roger Meier,2013-05-06 01:08:36+02:00,['5ed5e8b3f0bff13cbc551ce82d9960b188bb8175'],84,1,85,536794,1,1,1,0,1761
c28e04a1cb3254efec43e97bac5c9b226eb06f04,0,Jake Farrell,2013-05-05 21:25:52-04:00,['6d7473d0f1c5a4357d841456df7e07ee336883c9'],1,1,2,536796,1,,,,1761
f670181a3da5efa5f08993a472ae8d3be8908dff,1,Jens Geyer,2013-05-06 23:48:00+02:00,['c28e04a1cb3254efec43e97bac5c9b226eb06f04'],36,36,72,536868,6,,,,1761
7203424e96146e03e770bae7809d9e03cbecdcfc,1,Jens Geyer,2013-05-08 18:46:57+02:00,['f670181a3da5efa5f08993a472ae8d3be8908dff'],1,1244,1245,538113,14,0.686956522,1,0.973913043,1772
379c2776e2d1a17dcebab149d49addccc416c7f1,1,Jens Geyer,2013-05-09 15:23:48+02:00,['7203424e96146e03e770bae7809d9e03cbecdcfc'],2,7,9,538122,2,,,,1772
f680e95f19f54fa287c56668d215448489352921,0,Henrique,2013-05-10 23:43:12+02:00,['379c2776e2d1a17dcebab149d49addccc416c7f1'],119,130,249,538371,5,0,0,0,1772
99be0275e128d2ec239cc43d96280d1fdf0cd816,1,Henrique,2013-05-11 01:21:52+02:00,['379c2776e2d1a17dcebab149d49addccc416c7f1'],119,130,249,538620,5,0,0,0,1772
5b080ede3216e56790f73708feea7dd83a96f7a3,0,Henrique,2013-05-11 01:23:07+02:00,"['99be0275e128d2ec239cc43d96280d1fdf0cd816', 'f680e95f19f54fa287c56668d215448489352921']",0,0,0,538620,0,,,,1772
2a592b2d2aed4465c1e4eab4aa8ac259bccac2fb,0,Henrique,2013-05-11 01:24:17+02:00,"['99be0275e128d2ec239cc43d96280d1fdf0cd816', 'f680e95f19f54fa287c56668d215448489352921']",0,0,0,538620,0,,,,1772
4e1ef5becef44951333bd63871673fc52afd81a2,1,Henrique,2013-05-11 01:24:59+02:00,['2a592b2d2aed4465c1e4eab4aa8ac259bccac2fb'],5,6,11,538631,1,,,,1772
4a35d4c4d3655791e5b49cf43bb336e865c37deb,0,Henrique,2013-05-11 12:08:35+02:00,['4e1ef5becef44951333bd63871673fc52afd81a2'],3,47,50,538681,1,1,0.592592593,1,1772
08c34eae979c7a1246bc1b598724d56b147dd2f2,1,Henrique,2013-05-11 20:41:22+02:00,['4a35d4c4d3655791e5b49cf43bb336e865c37deb'],36,126,162,538843,6,0.958333333,1,1,1772
979aafd9f44fd0e4b0df8086454376f2790b8380,0,Henrique,2013-05-11 20:42:38+02:00,"['08c34eae979c7a1246bc1b598724d56b147dd2f2', '5b080ede3216e56790f73708feea7dd83a96f7a3']",0,0,0,538843,0,,,,1772
15522724f623b98f5e97b442baa47fa28975881e,1,Roger Meier,2013-05-12 20:45:13+02:00,['979aafd9f44fd0e4b0df8086454376f2790b8380'],0,476,476,539319,2,0.358267717,0.358267717,0.960629921,1774
2d2b3b2be861434a06a15c414b935fe7531b9752,0,Jens Geyer,2013-05-13 22:03:08+02:00,['15522724f623b98f5e97b442baa47fa28975881e'],9,43,52,539371,1,,,,1774
d7b4579272a86d49adcc8805d2624ce1c757b263,1,Jens Geyer,2013-05-13 22:11:46+02:00,['2d2b3b2be861434a06a15c414b935fe7531b9752'],0,320,320,539691,2,0.317708333,0.619791667,0.947916667,1775
744e45f3b64ca27e46e30be4735b014ae0c6b512,1,Jens Geyer,2013-05-14 21:56:24+02:00,['d7b4579272a86d49adcc8805d2624ce1c757b263'],35,38,73,539764,1,,,,1775
36af4d3b406569123b7e488b688bfc1d1fcb92f9,1,Jake Luciani,2013-05-16 12:59:50-04:00,['744e45f3b64ca27e46e30be4735b014ae0c6b512'],31,579,610,540374,9,0.334437086,0.625827815,0.963576159,1778
d28d4d578470233e384ae6012d0ecfa5a8f3deba,0,Henrique Mendonça,2013-05-16 21:22:46+02:00,['744e45f3b64ca27e46e30be4735b014ae0c6b512'],2,9,11,540385,2,0,0,1,1778
f837f301819d1f1661a185d1e64566e170933357,1,Henrique Mendonça,2013-05-16 21:25:18+02:00,['d28d4d578470233e384ae6012d0ecfa5a8f3deba'],9,2,11,540396,2,1,1,0,1778
8ad13a38e895bffdcb78f65e53e7d1f7f999b13e,0,Henrique Mendonça,2013-05-16 21:26:20+02:00,['f837f301819d1f1661a185d1e64566e170933357'],2,9,11,540407,2,0,0,1,1778
cbb979b804009374499462fd948a13537877fb59,0,Henrique Mendonça,2013-05-16 21:37:32+02:00,"['8ad13a38e895bffdcb78f65e53e7d1f7f999b13e', '36af4d3b406569123b7e488b688bfc1d1fcb92f9']",31,579,610,541017,9,,,,1778
691a16ac0443bc62797cd300824f6753b42a39fb,0,Jens Geyer,2013-05-18 11:16:28+02:00,['cbb979b804009374499462fd948a13537877fb59'],14,33,47,541064,1,0.333333333,0,0.75,1778
a5cce17a8d77673f9fc339899cf0e040238d20cc,0,Jens Geyer,2013-05-27 23:55:56+02:00,['691a16ac0443bc62797cd300824f6753b42a39fb'],2,3,5,541069,1,0,0,1,1778
d3c71827f87cc25a6469af5fd8f30e38454832e1,0,Jens Geyer,2013-05-28 03:09:04+02:00,['a5cce17a8d77673f9fc339899cf0e040238d20cc'],3,3,6,541075,1,,,,1778
fbb78a65897ff40a7a40daa1b90aef5e23789827,0,Jake Farrell,2013-05-27 22:01:36-04:00,['d3c71827f87cc25a6469af5fd8f30e38454832e1'],1,53,54,541129,2,0.051282051,1,1,1778
64924b8781eff5a175f46c84f690ffcdb46c9490,0,Jake Farrell,2013-05-29 23:15:37-04:00,['fbb78a65897ff40a7a40daa1b90aef5e23789827'],1,1,2,541131,1,,,,1778
16ee0d17a66c0bb67979507991f56ae8e898bfc4,1,Roger Meier,2013-05-30 09:57:00+02:00,['64924b8781eff5a175f46c84f690ffcdb46c9490'],5,5,10,541141,5,,,,1778
74c2cc829400ac8bb3de3c4faaa77190ca703ea7,0,Roger Meier,2013-05-30 13:28:17+02:00,['16ee0d17a66c0bb67979507991f56ae8e898bfc4'],0,1,1,541142,1,,,,1778
1e3c884636e4d6b1e93aa9f941d1d48b52a1da7a,0,Roger Meier,2013-05-30 14:04:11+02:00,['74c2cc829400ac8bb3de3c4faaa77190ca703ea7'],0,18,18,541160,1,,,,1778
14ff9c8a6a283b20f0c88ebcb9ff257cf861922c,1,Roger Meier,2013-05-30 14:11:45+02:00,['1e3c884636e4d6b1e93aa9f941d1d48b52a1da7a'],0,42,42,541202,2,,,,1779
0236434bdc06b8480d5f46a228d9f4dfa84b69dc,1,Roger Meier,2013-05-30 21:57:34+02:00,['14ff9c8a6a283b20f0c88ebcb9ff257cf861922c'],2,7,9,541211,2,,,,1779
175a694109d20dc8aeeefbd41cdd2c0b41196d83,0,Jake Farrell,2013-05-30 22:56:11-04:00,['0236434bdc06b8480d5f46a228d9f4dfa84b69dc'],1,0,1,541212,1,,,,1779
0049ec72ed81499a4c287a8aa28faa19efad3c3a,0,Jake Farrell,2013-05-30 23:42:56-04:00,['175a694109d20dc8aeeefbd41cdd2c0b41196d83'],1,2,3,541215,1,0,1,1,1779
da7982edeaff5d47485909662ebd489d67a4085a,1,Henrique Mendonça,2013-05-31 18:20:42+02:00,['14ff9c8a6a283b20f0c88ebcb9ff257cf861922c'],77,82,159,541374,7,1,1,1,1779
f57ec91e53b914c674812131bb261411b8b85c2b,0,Henrique Mendonça,2013-06-01 11:31:51+02:00,"['da7982edeaff5d47485909662ebd489d67a4085a', '0049ec72ed81499a4c287a8aa28faa19efad3c3a']",4,9,13,541387,4,,,,1779
5a61438a5e61505d226d9aef1d131659109e5781,0,Henrique Mendonça,2013-06-01 11:33:25+02:00,['f57ec91e53b914c674812131bb261411b8b85c2b'],80,46,126,541513,5,0,0,0,1779
8d22c10a47767f37eae8be3778dc40baa89713db,1,Henrique Mendonça,2013-06-01 16:53:32+02:00,['f57ec91e53b914c674812131bb261411b8b85c2b'],80,75,155,541668,6,0,0,0,1780
350860fca3820a672f88c0e7b9b74417e64cd496,0,Carl Yeksigian,2013-06-01 22:48:52-04:00,['5a61438a5e61505d226d9aef1d131659109e5781'],0,3,3,541671,3,,,,1780
111d8f2615486cb2ce4c5809c63602bc4b672d1a,0,Jens Geyer,2013-06-03 16:49:55+02:00,['350860fca3820a672f88c0e7b9b74417e64cd496'],0,3,3,541674,3,,,,1780
3e937114643fb32f0f8dc96359f11f9df008e782,0,Carl Yeksigian,2013-06-03 14:23:55-04:00,['111d8f2615486cb2ce4c5809c63602bc4b672d1a'],6,7,13,541687,1,,,,1780
d65def0159ce785488d9e8316d56a1d595bc1408,1,Jens Geyer,2013-06-04 01:19:53+02:00,['3e937114643fb32f0f8dc96359f11f9df008e782'],2,35,37,541724,1,0,0,1,1780
1ed799156dbaa8f313b413d28a6dacc7775ce88f,1,Carl Yeksigian,2013-06-04 04:56:00-04:00,['d65def0159ce785488d9e8316d56a1d595bc1408'],6,23,29,541753,3,,,,1780
64a799d28e60073e29ecebeed06d86e91e65b6cf,1,Roger Meier,2013-06-04 20:59:01+02:00,['1ed799156dbaa8f313b413d28a6dacc7775ce88f'],15,21,36,541789,2,,,,1780
cde23dfd2dfdd1271dd409dc9454e30249a9ecc5,1,Roger Meier,2013-06-04 21:28:06+02:00,['64a799d28e60073e29ecebeed06d86e91e65b6cf'],2,2,4,541793,1,,,,1780
0ca234f3b667079aad3c6e7ff5d5b54bb30c572c,0,Jens Geyer,2013-06-04 22:01:47+02:00,['cde23dfd2dfdd1271dd409dc9454e30249a9ecc5'],1,4,5,541798,1,,,,1780
c2c4d72b90f322e46a8cbb4e196c598bbcb3f615,1,Jens Geyer,2013-06-04 22:06:30+02:00,['0ca234f3b667079aad3c6e7ff5d5b54bb30c572c'],13,271,284,542082,4,0.138461538,0.753846154,0.461538462,1782
f2b094f1f1a331c9bd92c6106683fbaa7191dc66,1,Roger Meier,2013-06-04 22:09:37+02:00,['c2c4d72b90f322e46a8cbb4e196c598bbcb3f615'],3,5,8,542090,1,0,0,1,1782
d65216df190b0ff1522098c8a552594ce29feb3d,0,Roger Meier,2013-06-04 22:25:06+02:00,['f2b094f1f1a331c9bd92c6106683fbaa7191dc66'],0,19,19,542109,1,0,0,1,1782
1b0bc0f42106700e45ce2e76049eefa6f57c1293,0,Jake Farrell,2013-06-04 22:46:38-04:00,['d65216df190b0ff1522098c8a552594ce29feb3d'],4,4,8,542117,2,,,,1782
37e655c71bdce1b1bc20a06eeb00458f205ada8b,0,Jake Farrell,2013-06-04 23:04:16-04:00,['1b0bc0f42106700e45ce2e76049eefa6f57c1293'],3,10,13,542130,2,1,1,1,1782
89be18365e24af84754ecdb8104e5151aea20b7f,0,Jake Farrell,2013-06-04 23:22:04-04:00,['37e655c71bdce1b1bc20a06eeb00458f205ada8b'],3,0,3,542133,1,,,,1782
240df17f85c8086bc5f9f17c28ce9e0936f65316,0,Jake Farrell,2013-06-04 23:59:34-04:00,['89be18365e24af84754ecdb8104e5151aea20b7f'],0,9,9,542142,1,,,,1782
729768807290feb4677305beebc799ec50e0e17a,0,Henrique Mendonça,2013-06-05 12:51:02+02:00,"['8d22c10a47767f37eae8be3778dc40baa89713db', '240df17f85c8086bc5f9f17c28ce9e0936f65316']",58,416,474,542616,21,,,,1782
b6dfc9036b478219c0427d2a9a7686bf1f415b1c,0,Henrique Mendonça,2013-06-05 14:46:06+02:00,['729768807290feb4677305beebc799ec50e0e17a'],2,2,4,542620,1,,,,1782
548244f0495898492616f520fec7b08c267574d9,0,Carl Yeksigian,2013-06-06 07:52:42-04:00,['b6dfc9036b478219c0427d2a9a7686bf1f415b1c'],7,14,21,542641,1,0,0,0,1782
e2c5b2d433a2572a4af65fbc80fec1bfe2ff6fea,1,Carl Yeksigian,2013-06-06 19:30:59-04:00,['548244f0495898492616f520fec7b08c267574d9'],1,21,22,542663,1,,,,1782
0928eda77155301a1160bf4ae50faccefa5bd6e6,0,Carl Yeksigian,2013-06-06 20:53:32-04:00,['e2c5b2d433a2572a4af65fbc80fec1bfe2ff6fea'],2,2,4,542667,1,,,,1782
7cb7fc8a7342e714afbf517086d8a62622758148,1,Carl Yeksigian,2013-06-07 07:33:01-04:00,['0928eda77155301a1160bf4ae50faccefa5bd6e6'],1023,1281,2304,544971,49,1,1,0.86,1787
c317852eedbb84e275db841bd2428d5b571fdd41,0,Carl Yeksigian,2013-06-07 12:31:13-04:00,['7cb7fc8a7342e714afbf517086d8a62622758148'],1,4,5,544976,1,,,,1787
877125c5cd3c98e46affaa382ffceef7f9403acb,0,Jake Farrell,2013-06-07 23:47:22-04:00,['c317852eedbb84e275db841bd2428d5b571fdd41'],1,12,13,544989,1,0,0.666666667,0.333333333,1787
0e07ec816208e9ea402582f68f73101bc1ed1b89,0,Henrique Mendonça,2013-06-08 09:40:21+02:00,['877125c5cd3c98e46affaa382ffceef7f9403acb'],7,7,14,545003,1,,,,1787
765bbfb551e72aa0207871ef1b8cfc7769d3578c,1,Jake Farrell,2013-06-08 21:25:48-04:00,['0e07ec816208e9ea402582f68f73101bc1ed1b89'],54,30,84,545087,1,,,,1787
d522421d7f8260fa180a607ab7db5af02b7a16a2,0,Jens Geyer,2013-06-09 13:47:37+02:00,['765bbfb551e72aa0207871ef1b8cfc7769d3578c'],3,17,20,545107,1,0,0,1,1787
c08926ae73d360afd6af5a6d8bff62f6b191f5e2,0,Jens Geyer,2013-06-09 14:10:57+02:00,['d522421d7f8260fa180a607ab7db5af02b7a16a2'],0,1,1,545108,1,0,1,1,1787
de07408e43ac50c2b9f71ab26cf71ee517573763,1,Carl Yeksigian,2013-06-09 05:28:47-07:00,['c08926ae73d360afd6af5a6d8bff62f6b191f5e2'],2,26,28,545136,2,,,,1788
27db434fd93b8ebd4235f2e2cbbecb5b8be76ce4,0,Henrique Mendonça,2013-06-09 22:20:25+02:00,['de07408e43ac50c2b9f71ab26cf71ee517573763'],33,29,62,545198,4,,,,1788
6afe0535e1cd07bb799897dd2232db845d35662a,0,Henrique Mendonça,2013-06-09 22:54:51+02:00,['27db434fd93b8ebd4235f2e2cbbecb5b8be76ce4'],5,8,13,545211,3,,,,1788
ed817d0102164b9dc35f5a4781f40587ed1b714f,1,Roger Meier,2013-06-09 23:10:06+02:00,['6afe0535e1cd07bb799897dd2232db845d35662a'],3,44,47,545258,6,,,,1789
4285ba29f239edba628e9a025bacf1e73e6e8f1e,0,Roger Meier,2013-06-10 21:17:23+02:00,['ed817d0102164b9dc35f5a4781f40587ed1b714f'],114,116,230,545488,67,,,,1789
03aaf93c5381e8a5b63c2fd6d15c18b57cf13d20,0,Roger Meier,2013-06-10 21:24:54+02:00,['4285ba29f239edba628e9a025bacf1e73e6e8f1e'],6,17,23,545511,1,0,0,1,1789
b310ae78160bf95f6c49ed1cb13aea609878f6ee,1,Jens Geyer,2013-06-12 21:10:35+02:00,['03aaf93c5381e8a5b63c2fd6d15c18b57cf13d20'],5,47,52,545563,7,1,1,1,1790
70a5762736eaa3511ca5e4f02461bf1ca22453a4,0,Jens Geyer,2013-06-15 03:05:03+02:00,['b310ae78160bf95f6c49ed1cb13aea609878f6ee'],0,6,6,545569,1,0,1,0,1790
0e87c46c18a3a62d17d7e45a5bddde989d31351c,1,Jens Geyer,2013-06-18 22:25:07+02:00,['70a5762736eaa3511ca5e4f02461bf1ca22453a4'],15970,10026,25996,571565,101,0.581177937,0.493923341,0.074478031,1820
f713a75a08c455d72364c6bfa5909419e575bc91,0,Jens Geyer,2013-05-07 11:37:41+02:00,['0e87c46c18a3a62d17d7e45a5bddde989d31351c'],2,2,4,571569,1,1,1,1,1820
470cae3340b5712b92e87677b2d76bc07158a9d2,0,Jens Geyer,2013-06-19 23:30:50+02:00,['f713a75a08c455d72364c6bfa5909419e575bc91'],3,4,7,571576,1,,,,1820
bb98ed44d7a7be7f467a5b5112b116d5d0ebd1a7,0,Roger Meier,2013-06-20 01:06:22+02:00,['470cae3340b5712b92e87677b2d76bc07158a9d2'],20,25,45,571621,2,0,0,1,1820
e549a80e4ee5f825cfbc064f9c143b67cd974edb,0,Jens Geyer,2013-06-20 21:48:21+02:00,['bb98ed44d7a7be7f467a5b5112b116d5d0ebd1a7'],0,1,1,571622,1,,,,1820
69b02aa85b0bf3cdba4f7da26959cfee7e0c5629,1,jfarrell,2013-06-20 15:40:48-05:00,['e549a80e4ee5f825cfbc064f9c143b67cd974edb'],1,1,2,571624,1,,,,1820
cc25c52de4fc1d9d856a759b283ff96a6c251c29,0,Roger Meier,2013-06-20 23:44:46+02:00,['69b02aa85b0bf3cdba4f7da26959cfee7e0c5629'],1,1,2,571626,1,,,,1820
6ce16d95a4e543f5c930d5518d5f1db1263b0333,0,Jens Geyer,2013-06-21 00:04:45+02:00,['cc25c52de4fc1d9d856a759b283ff96a6c251c29'],5,3,8,571634,1,1,1,0,1820
b6f23e89cd5803395280e312fa4ee04751edc0e1,0,jfarrell,2013-06-21 13:36:18-05:00,['6ce16d95a4e543f5c930d5518d5f1db1263b0333'],0,5,5,571639,1,,,,1820
0f0558ab1f6a5e240094cc4fee6f2c2689711f55,1,jfarrell,2013-06-21 14:50:31-05:00,['b6f23e89cd5803395280e312fa4ee04751edc0e1'],2,2,4,571643,1,,,,1820
9753cde10d4b30ad45912842c374d0b7b4747a7e,0,jfarrell,2013-06-21 14:53:39-05:00,['0f0558ab1f6a5e240094cc4fee6f2c2689711f55'],1,11,12,571655,1,,,,1820
9be4e687c49dad1f5d90e93e3b7247be16d50287,0,Roger Meier,2013-06-22 22:03:31+02:00,['9753cde10d4b30ad45912842c374d0b7b4747a7e'],74,40,114,571769,25,,,,1820
58fe5368328b99c94323c76a05cb9eb51f7730b0,0,Roger Meier,2013-06-22 22:05:22+02:00,['9be4e687c49dad1f5d90e93e3b7247be16d50287'],0,1,1,571770,1,,,,1820
a1b5728ee6791d2c75d7e0c33315e88b23fd712a,0,Roger Meier,2013-06-22 22:10:23+02:00,['58fe5368328b99c94323c76a05cb9eb51f7730b0'],0,24,24,571794,1,,,,1821
809544747834a3a28e7cc9c6b93300306e4d605e,0,Jens Geyer,2013-06-25 21:36:29+02:00,['a1b5728ee6791d2c75d7e0c33315e88b23fd712a'],0,2,2,571796,1,,,,1821
102bca47f754d9c9ed6ce341c7f8f106bd2719d7,1,Jens Geyer,2013-06-25 22:21:29+02:00,['809544747834a3a28e7cc9c6b93300306e4d605e'],71,130,201,571997,4,0.307692308,0.423076923,1,1821
b3495ffd20cb4fa9b746eb7929c0b1a1b3c7615b,0,Jens Geyer,2013-06-26 20:20:13+02:00,['102bca47f754d9c9ed6ce341c7f8f106bd2719d7'],6,58,64,572061,1,0.125,0.125,1,1821
e5bfd4c285c24c06525b9266a3d3acf8bdb42648,0,Jens Geyer,2013-06-28 21:48:02+02:00,['b3495ffd20cb4fa9b746eb7929c0b1a1b3c7615b'],0,2,2,572063,1,0.5,1,1,1821
ff77d075ec1d4a7862e7a759c1e701605c6d4d0d,0,Roger Meier,2013-06-28 22:26:43+02:00,['e5bfd4c285c24c06525b9266a3d3acf8bdb42648'],4,4,8,572071,4,,,,1821
f1ac28429f9eaf62da5f0b682da0e8de79d73473,0,Roger Meier,2013-06-28 22:33:04+02:00,['ff77d075ec1d4a7862e7a759c1e701605c6d4d0d'],0,3,3,572074,1,,,,1821
42cb873ea9984b08346a6e3f0713578f0ed4efe8,0,Roger Meier,2013-06-28 22:49:14+02:00,['f1ac28429f9eaf62da5f0b682da0e8de79d73473'],1,1,2,572076,1,,,,1821
7295745b1762255af50dadd0e480e8393a25f9ff,1,Roger Meier,2013-06-29 00:28:50+02:00,['42cb873ea9984b08346a6e3f0713578f0ed4efe8'],53,53,106,572182,8,,,,1821
7158d3306c8ed582ace1f3bee3b7007ba5cb06fc,0,Roger Meier,2013-06-29 12:48:05+02:00,['7295745b1762255af50dadd0e480e8393a25f9ff'],7,9,16,572198,1,,,,1821
c36b56d3d714a440bc14055c0180632a0c4a6bca,0,Roger Meier,2013-06-29 13:08:32+02:00,['7158d3306c8ed582ace1f3bee3b7007ba5cb06fc'],1,1,2,572200,1,,,,1821
ffbfd03cc2a943a41b28e82dafd3d4c7438cf04c,1,Roger Meier,2013-06-29 14:51:30+02:00,['c36b56d3d714a440bc14055c0180632a0c4a6bca'],1,1,2,572202,1,,,,1821
866c23b5d134f9d782114cb66638d71661937532,1,Jens Geyer,2013-07-05 19:20:27+02:00,['ffbfd03cc2a943a41b28e82dafd3d4c7438cf04c'],1,68,69,572271,1,0.075471698,0.094339623,1,1821
049f5f3375e442865d790460596caeb5e942fa13,1,Carl Yeksigian,2013-07-05 13:49:15-04:00,['866c23b5d134f9d782114cb66638d71661937532'],2,2,4,572275,2,,,,1821
ee353e6c98f8c8712d43d626c483217a45a4089d,0,Jens Geyer,2013-07-06 09:30:30+02:00,['049f5f3375e442865d790460596caeb5e942fa13'],7,11,18,572293,1,,,,1821
6b9e1c6a87d745c224f6737b07b3ed7d72fcd6e0,0,Jens Geyer,2013-07-06 09:30:31+02:00,['ee353e6c98f8c8712d43d626c483217a45a4089d'],34,45,79,572372,1,0,0,1,1821
6f2a5037105ccad05eb84ec0a60da3389c85eb3f,1,Roger Meier,2013-07-08 23:35:25+02:00,['6b9e1c6a87d745c224f6737b07b3ed7d72fcd6e0'],34,76,110,572482,2,0.666666667,0.733333333,0.933333333,1821
67065d7bf8405ccc38d911b928c88a64d79902c6,0,Jens Geyer,2013-07-13 13:24:10+02:00,['6f2a5037105ccad05eb84ec0a60da3389c85eb3f'],3,14,17,572499,1,,,,1821
1075a6f67b63b96be455496f50624433ff73c449,0,Jens Geyer,2013-07-14 13:54:10+02:00,['67065d7bf8405ccc38d911b928c88a64d79902c6'],2,3,5,572504,1,,,,1821
ba406d3a022967e6189249bd8e805f0eb9ac2921,1,Roger Meier,2013-07-15 22:41:34+02:00,['1075a6f67b63b96be455496f50624433ff73c449'],5,109,114,572618,5,0.396551724,0.396551724,0.879310345,1821
4f7ad2d98b22b367c7a4a25991cdf9a81647d3be,0,Jens Geyer,2013-07-16 20:58:38+02:00,['ba406d3a022967e6189249bd8e805f0eb9ac2921'],6,0,6,572624,1,,,,1821
a7da48805c9fdcc4ad507272abd997ed1961d296,1,Jens Geyer,2013-07-18 00:33:05+02:00,['4f7ad2d98b22b367c7a4a25991cdf9a81647d3be'],32,94,126,572750,5,1,0.714285714,1,1822
7757ce7aeb774294018e5515e5f5e93261e6dd3d,1,Jens Geyer,2013-07-18 22:48:40+02:00,['a7da48805c9fdcc4ad507272abd997ed1961d296'],2,66,68,572818,2,,,,1823
0be9ffacb782ee3cf4f7681f83e1796cb2be0efa,1,Roger Meier,2013-07-19 21:10:01+02:00,['7757ce7aeb774294018e5515e5f5e93261e6dd3d'],50,50,100,572918,6,0,0,1,1823
e802aa40af6629d3038e979b5582ea735deb7c37,0,Roger Meier,2013-07-19 21:10:54+02:00,['0be9ffacb782ee3cf4f7681f83e1796cb2be0efa'],1,1,2,572920,1,,,,1823
56a648d0ffc370123c4f1047b72d0d80080a1d9b,0,Roger Meier,2013-07-19 23:28:22+02:00,['e802aa40af6629d3038e979b5582ea735deb7c37'],39,11,50,572970,2,0,1,0,1823
11430df7ae96d184a5778f5f6eb3c93e65389eba,1,Jens Geyer,2013-07-26 00:23:00+02:00,['56a648d0ffc370123c4f1047b72d0d80080a1d9b'],1,7,8,572978,3,0,0,1,1823
7d95246f16234deba11f82c830d1970f6ab14286,1,Jens Geyer,2013-07-26 01:01:11+02:00,['11430df7ae96d184a5778f5f6eb3c93e65389eba'],38,107,145,573123,3,1,1,1,1824
44b19df535fa83855f91d11c2ecf2e73360a5444,0,Jens Geyer,2013-07-26 23:05:00+02:00,['7d95246f16234deba11f82c830d1970f6ab14286'],7,64,71,573194,5,0.363636364,0.363636364,0,1825
7b07fbcba0a8df16ff890830f399d9c82152f04a,1,Jens Geyer,2013-07-30 03:08:17+02:00,['44b19df535fa83855f91d11c2ecf2e73360a5444'],1,2,3,573197,2,,,,1825
d1257debcfd4e6622a6e12e6545dd01d7bec6a15,1,Jens Geyer,2013-07-31 13:03:26+02:00,['7b07fbcba0a8df16ff890830f399d9c82152f04a'],6,75,81,573278,4,0,1,1,1826
27a7ce9f122a7c5818c854114ceae46ad5539233,0,Jens Geyer,2013-07-31 13:20:20+02:00,['d1257debcfd4e6622a6e12e6545dd01d7bec6a15'],5,5,10,573288,1,,,,1826
aa721610daa3f11df3451149d44dc614e9cffe18,0,jfarrell,2013-08-02 21:55:22-04:00,['27a7ce9f122a7c5818c854114ceae46ad5539233'],1,1,2,573290,1,,,,1826
656a17305093a1fda754b669f4cb9ce4e98ec2d1,1,Jens Geyer,2013-08-03 10:22:39+02:00,['aa721610daa3f11df3451149d44dc614e9cffe18'],5,14,19,573309,2,,,,1826
09b97c78de58fea61b5dc90bd56095515bdd4f02,0,Jens Geyer,2013-08-04 13:39:09+02:00,['656a17305093a1fda754b669f4cb9ce4e98ec2d1'],0,9,9,573318,1,1,1,1,1826
4c835951befbe5bd2fa89f9079368ed771807e6e,1,Jens Geyer,2013-08-13 21:34:17+02:00,['09b97c78de58fea61b5dc90bd56095515bdd4f02'],8,357,365,573683,8,0.639784946,0.822580645,0.774193548,1830
f02934543a6fc53b5a5b1dcc56a3333e8f7c2054,0,Carl Yeksigian,2013-08-13 18:09:59-04:00,['4c835951befbe5bd2fa89f9079368ed771807e6e'],1,1,2,573685,1,,,,1830
f8e8c599211fa0523b48fd0f5e8f0462c0e2b08a,0,Carl Yeksigian,2013-08-13 18:23:03-04:00,['f02934543a6fc53b5a5b1dcc56a3333e8f7c2054'],1,6,7,573692,1,0,0,0,1830
1bb0ed88f240641a090edb075592ef2ca9ee80c5,0,Jens Geyer,2013-08-14 21:33:51+02:00,['f8e8c599211fa0523b48fd0f5e8f0462c0e2b08a'],3,1,4,573696,1,1,0,1,1830
3bb141d3689f0778af3dcf3218cfe760c36803bc,0,Jens Geyer,2013-08-14 21:33:53+02:00,['1bb0ed88f240641a090edb075592ef2ca9ee80c5'],15,18,33,573729,1,,,,1830
e9248743a86e06378a447919fe584a199cd1ca7c,0,Roger Meier,2013-08-15 01:22:35+02:00,['3bb141d3689f0778af3dcf3218cfe760c36803bc'],2,2,4,573733,1,,,,1830
8c64dc103efc43d7dad488d3b7a389c80b3b08c5,1,Jens Geyer,2013-08-15 01:29:49+02:00,['e9248743a86e06378a447919fe584a199cd1ca7c'],0,3,3,573736,1,,,,1830
d051ca0b23eab53ede689ba319256e5f30feebf8,0,Roger Meier,2013-08-15 01:37:55+02:00,['8c64dc103efc43d7dad488d3b7a389c80b3b08c5'],0,7,7,573743,2,0,0,0.25,1830
2ca9c2028593782621c8876817d8772aa5f46ac7,0,Carl Yeksigian,2013-08-14 19:38:42-04:00,['d051ca0b23eab53ede689ba319256e5f30feebf8'],154,4,158,573901,6,0,0,0.097560976,1830
4dd351d4b404e52f32b61abe2184f21e65d87cfb,0,jfarrell,2013-08-15 19:14:14-04:00,['2ca9c2028593782621c8876817d8772aa5f46ac7'],0,1,1,573902,1,,,,1830
b59120374612ba7601e69207d7d29a5c2cb281a3,0,jfarrell,2013-08-15 19:21:43-04:00,['4dd351d4b404e52f32b61abe2184f21e65d87cfb'],0,4,4,573906,1,,,,1830
32d323e2c7df3ae2c083d8fe109a3dd6806c204d,1,jfarrell,2013-08-15 20:39:58-04:00,['b59120374612ba7601e69207d7d29a5c2cb281a3'],0,6,6,573912,2,,,,1830
102c600bbb64b23679a3b143cdf9815733bdcb55,1,jfarrell,2013-08-15 21:20:19-04:00,['32d323e2c7df3ae2c083d8fe109a3dd6806c204d'],61,53,114,574026,10,,,,1830
87577ef0015251c865a599f794a5ff1d5f9b35e9,0,jfarrell,2013-08-16 09:26:05-04:00,['102c600bbb64b23679a3b143cdf9815733bdcb55'],9,9,18,574044,1,,,,1830
16ff233a7340c3425b36a45c90d6bf28f8658477,1,jfarrell,2013-08-16 09:48:42-04:00,['87577ef0015251c865a599f794a5ff1d5f9b35e9'],5,8,13,574057,1,,,,1830
985a910b1b4bd9c546ef0857aed7f56ed21ea65c,0,jfarrell,2013-08-17 15:44:19-04:00,['16ff233a7340c3425b36a45c90d6bf28f8658477'],5,7,12,574069,1,,,,1830
92f24b2780fb7ca81063c3a0bb399500ee819d82,1,jfarrell,2013-08-17 15:47:13-04:00,['985a910b1b4bd9c546ef0857aed7f56ed21ea65c'],6,2,8,574077,4,,,,1830
a395655cf4eea332e3f16576363b420b9db31ea6,0,jfarrell,2013-08-17 15:52:42-04:00,['92f24b2780fb7ca81063c3a0bb399500ee819d82'],1,1,2,574079,1,,,,1830
9dbea36189a78d4dac1ca36c9eca3f9dd7164850,0,jfarrell,2013-08-17 18:35:13-04:00,['a395655cf4eea332e3f16576363b420b9db31ea6'],11,52,63,574142,1,,,,1830
5c1e599dd1519680c61b7f9b878b3db2695196e6,0,jfarrell,2013-08-17 21:38:31-04:00,['9dbea36189a78d4dac1ca36c9eca3f9dd7164850'],50,0,50,574192,1,0,0,0,1830
f7516e13d3f80ee0386e6ec647bc5c554e7f9cfb,1,jfarrell,2013-08-18 10:53:07-04:00,['5c1e599dd1519680c61b7f9b878b3db2695196e6'],0,4,4,574196,1,,,,1830
5a900eadc2163e3f92ca71fea23996b517def078,0,jfarrell,2013-08-18 10:54:52-04:00,['f7516e13d3f80ee0386e6ec647bc5c554e7f9cfb'],1,4,5,574201,1,,,,1830
2fa3df32cef7f8b490f3389ca43ce249bfb43bf0,1,jfarrell,2013-08-18 11:20:53-04:00,['5a900eadc2163e3f92ca71fea23996b517def078'],4,4,8,574209,2,,,,1830
b5948eb378db07906594813b3e170b64d4352487,0,jfarrell,2013-08-18 16:36:06-04:00,['2fa3df32cef7f8b490f3389ca43ce249bfb43bf0'],1,10,11,574220,2,,,,1831
ff980c1432936c6bc897c60469ab05b5e0c6cb5e,0,jfarrell,2013-08-18 19:54:39-04:00,['b5948eb378db07906594813b3e170b64d4352487'],22,225,247,574467,17,,,,1831
d4a0b27ad0e57f0cd681f3334847492decf35c2e,0,Jens Geyer,2013-08-21 23:55:29+02:00,['b5948eb378db07906594813b3e170b64d4352487'],2,2,4,574471,1,,,,1831
c9f4a35c30cfff8c98ee767dbba0f7afe62997cf,0,Carl Yeksigian,2013-08-21 18:44:48-04:00,['d4a0b27ad0e57f0cd681f3334847492decf35c2e'],2,6,8,574479,2,,,,1831
72498205b0931b8e4060599809639819c0b38fda,1,jfarrell,2013-08-24 09:18:30-04:00,['c9f4a35c30cfff8c98ee767dbba0f7afe62997cf'],0,196,196,574675,1,,,,1831
d9120c9fbdf9cde8da35dd2634987e7c07089652,0,jfarrell,2013-08-24 09:48:23-04:00,['72498205b0931b8e4060599809639819c0b38fda'],15,18,33,574708,1,,,,1831
12c09f44cb291b1ecc4074cb3a55775b375fa8b2,0,Jens Geyer,2013-08-25 14:17:32+02:00,['d9120c9fbdf9cde8da35dd2634987e7c07089652'],0,28,28,574736,3,1,1,1,1831
8ea5e2f25881ce6c4aac887113e615054b3a43a6,0,Roger Meier,2013-08-26 20:37:42+02:00,['12c09f44cb291b1ecc4074cb3a55775b375fa8b2'],1,6,7,574743,1,,,,1831
62fb17d3089d2e67b6d73c1aa1bc24409264f164,0,Roger Meier,2013-08-26 21:50:16+02:00,['8ea5e2f25881ce6c4aac887113e615054b3a43a6'],1,1,2,574745,1,,,,1831
cf1fe74b1392f74d8463d63612cd870fa1ea1bef,0,Carl Yeksigian,2013-08-26 17:29:11-04:00,['62fb17d3089d2e67b6d73c1aa1bc24409264f164'],36,49,85,574830,1,0,0.5,0,1831
5b8c9a9d4caaca36c6d79f2754fd3be254b2803d,1,henrique,2013-08-27 15:06:42+02:00,['12c09f44cb291b1ecc4074cb3a55775b375fa8b2'],1,81,82,574912,1,0.121212121,0.121212121,1,1831
570dcc4089f7f90af0a1bd01dba539036ead2eb9,0,henrique,2013-08-27 15:13:31+02:00,"['5b8c9a9d4caaca36c6d79f2754fd3be254b2803d', 'cf1fe74b1392f74d8463d63612cd870fa1ea1bef']",38,56,94,575006,3,,,,1831
452dd5b42b2074978a1cce76f4e98548b6021cc4,0,henrique,2013-08-28 11:10:09+02:00,['570dcc4089f7f90af0a1bd01dba539036ead2eb9'],14,579,593,575599,6,0.45631068,0.514563107,0.958737864,1832
2fdd916b8bd30a72a496b203e98a0daaadc1d626,1,henrique,2013-08-28 14:03:34+02:00,['452dd5b42b2074978a1cce76f4e98548b6021cc4'],12,723,735,576334,10,0.839793282,0.974160207,0.88630491,1836
9df014012e6fb2f831a49b6f7431380566483048,1,Ben Craig,2013-08-28 15:08:23-05:00,['452dd5b42b2074978a1cce76f4e98548b6021cc4'],1,1,2,576336,1,,,,1836
7570b84301097248d22a211f21527e2c2ffa8520,0,henrique,2013-08-29 09:45:55+02:00,"['2fdd916b8bd30a72a496b203e98a0daaadc1d626', '9df014012e6fb2f831a49b6f7431380566483048']",1,1,2,576338,1,,,,1836
91058ef4ba3366169be1a10f708c9acbd4b4bc16,0,Ben Craig,2013-08-29 10:38:25-05:00,['9df014012e6fb2f831a49b6f7431380566483048'],1,1,2,576340,1,,,,1836
cd54ec62492aa3f01c68910e5c942388d21c7379,0,Ben Craig,2013-08-29 10:45:21-05:00,['91058ef4ba3366169be1a10f708c9acbd4b4bc16'],2,4,6,576346,1,1,1,1,1836
5d9a72a28c4c082a4c155d539a20cf27d7440562,0,henrique,2013-08-29 18:06:45+02:00,"['7570b84301097248d22a211f21527e2c2ffa8520', 'cd54ec62492aa3f01c68910e5c942388d21c7379']",3,5,8,576354,2,,,,1836
d5f617f6a338fb61608f7a3f6659e05e980b3374,0,Ben Craig,2013-08-30 08:18:06-05:00,['cd54ec62492aa3f01c68910e5c942388d21c7379'],0,0,0,576354,5,,,,1836
fb89bb5fca694b79ae006551b90d30f491d7ad07,0,Ben Craig,2013-08-30 13:46:05-05:00,['d5f617f6a338fb61608f7a3f6659e05e980b3374'],0,4,4,576358,1,,,,1836
17d42799eb5f20dfde5e86a8b877b64b7d6447e3,0,henrique,2013-08-30 22:04:52+02:00,"['5d9a72a28c4c082a4c155d539a20cf27d7440562', 'fb89bb5fca694b79ae006551b90d30f491d7ad07']",0,4,4,576362,6,,,,1836
acf15dc30429d609735efc7686f197607d8923d1,0,Roger Meier,2013-09-02 20:16:49+02:00,['17d42799eb5f20dfde5e86a8b877b64b7d6447e3'],0,1,1,576363,1,1,1,1,1836
657b933f28ffdaedb49c5a93dc3e0c2ceeae1807,1,Roger Meier,2013-09-02 20:43:57+02:00,['acf15dc30429d609735efc7686f197607d8923d1'],12,12,24,576387,2,,,,1836
03d4944e851ace50ba89a721b1e2eb5f563bb111,0,Jens Geyer,2013-09-04 22:34:41+02:00,['657b933f28ffdaedb49c5a93dc3e0c2ceeae1807'],1,28,29,576416,1,0.733333333,0.733333333,1,1836
2897d4825c5350e295605155f7a619d71973e3bc,0,jfarrell,2013-09-05 09:11:15-04:00,['03d4944e851ace50ba89a721b1e2eb5f563bb111'],0,290,290,576706,2,0.5859375,1,0.6796875,1838
ba6825583432194e20851824e03d06f4953874af,1,Jens Geyer,2013-09-05 22:23:28+02:00,['2897d4825c5350e295605155f7a619d71973e3bc'],0,8,8,576714,1,,,,1838
a6a32a56fb565d155fd9ae3826b6bbdede6688be,0,jfarrell,2013-09-06 13:07:56-04:00,['ba6825583432194e20851824e03d06f4953874af'],56,52,108,576822,1,0,1,1,1838
718f6eefb6791128a5290b3c7cf47f025ed60c66,1,Jens Geyer,2013-09-06 21:02:57+02:00,['a6a32a56fb565d155fd9ae3826b6bbdede6688be'],11,45,56,576878,10,0,0,1,1838
d21fa6e50248f07679f426b38d20cbdbf370ef75,0,Jens Geyer,2013-09-06 21:05:46+02:00,['718f6eefb6791128a5290b3c7cf47f025ed60c66'],2,2,4,576882,1,,,,1838
ec8744c4dd84f8077a590cdcbb58a921cec1d14c,0,Jens Geyer,2013-09-06 21:09:08+02:00,['d21fa6e50248f07679f426b38d20cbdbf370ef75'],10,62,72,576954,1,0.21875,0.28125,0.9375,1838
c949514e41f9e2b31b061f1d81fd5305d0861a46,0,Jens Geyer,2013-09-08 00:31:59+02:00,['ec8744c4dd84f8077a590cdcbb58a921cec1d14c'],2,2,4,576958,2,,,,1838
7a09483993be2b42b60224829534d5c976e5f9e2,1,Jens Geyer,2013-09-08 00:36:22+02:00,['c949514e41f9e2b31b061f1d81fd5305d0861a46'],0,841,841,577799,4,0.408748115,0.615384615,1,1842
aff2f78b27566145c6bbcb827d4ae472f3ee215b,1,henrique,2013-09-09 12:38:25+02:00,['7a09483993be2b42b60224829534d5c976e5f9e2'],14,16,30,577829,3,,,,1842
b0d3c3f9a8a98d62cda4a7b5250bf27423d8fdcb,0,Jens Geyer,2013-09-09 21:10:45+02:00,['aff2f78b27566145c6bbcb827d4ae472f3ee215b'],0,57,57,577886,3,,,,1842
7096942cfa638333358bfe962fa5cbd31b894827,0,jfarrell,2013-09-09 20:33:38-04:00,['b0d3c3f9a8a98d62cda4a7b5250bf27423d8fdcb'],1,1,2,577888,1,,,,1842
4fb2706ecf74f533f71fa4ceab15db984fd13244,0,jfarrell,2013-09-10 00:42:39-04:00,['7096942cfa638333358bfe962fa5cbd31b894827'],1,0,1,577889,1,,,,1842
38ddc8f757ace6eb543d5a999b70847ad95005a9,0,jfarrell,2013-09-10 12:12:41-04:00,['4fb2706ecf74f533f71fa4ceab15db984fd13244'],4,18,22,577911,1,,,,1842
8a0f8d1a2021394c552497324c9a4d3d0ed7f61c,0,Jens Geyer,2013-09-10 21:34:42+02:00,['38ddc8f757ace6eb543d5a999b70847ad95005a9'],81,83,164,578075,2,0,0,0,1842
901d5552963224ed48c2c53da685771456f7fb98,1,Jens Geyer,2013-09-10 21:34:43+02:00,['8a0f8d1a2021394c552497324c9a4d3d0ed7f61c'],2,3,5,578080,2,1,1,0,1842
4ba1160c41805ac6bc3548baadf0a700af8925ae,0,Jens Geyer,2013-09-10 21:34:45+02:00,['901d5552963224ed48c2c53da685771456f7fb98'],1,4,5,578085,2,,,,1842
b2501a71a79304fa27dfd6d2e55b75d8eacf0cef,1,Ben Craig,2013-09-13 12:29:43-05:00,['4ba1160c41805ac6bc3548baadf0a700af8925ae'],325,970,1295,579380,7,0.850980392,1,0.68627451,1845
8cd3efe50a42975375e8ff3bc03306d9e4174314,1,Jens Geyer,2013-09-16 22:17:52+02:00,['b2501a71a79304fa27dfd6d2e55b75d8eacf0cef'],3,11,14,579394,2,0,0,1,1845
fd7ddef7295d9d3459ff0f46829a479ea3a7f724,1,Ben Craig,2013-09-16 15:41:39-05:00,['8cd3efe50a42975375e8ff3bc03306d9e4174314'],0,28,28,579422,2,0.125,0.125,1,1845
d73aa078d021f8a0aea0c3a6725618127d698ff3,0,Jens Geyer,2013-09-18 23:30:42+02:00,['fd7ddef7295d9d3459ff0f46829a479ea3a7f724'],1,1,2,579424,1,,,,1845
97cc95b24c8604b8666b2045bd6a0d096254331e,0,Jens Geyer,2013-09-18 23:53:14+02:00,['d73aa078d021f8a0aea0c3a6725618127d698ff3'],0,2,2,579426,1,,,,1845
f7be519e08d2c699e02aee691b3351441040df92,0,Henrique Mendonça,2013-09-19 12:30:05+02:00,['fd7ddef7295d9d3459ff0f46829a479ea3a7f724'],7,5,12,579438,1,0.5,0,0.5,1845
6b43fa37958c944d918f51794e77ef3b69abf55f,0,Henrique Mendonça,2013-09-20 13:24:02+02:00,"['f7be519e08d2c699e02aee691b3351441040df92', '97cc95b24c8604b8666b2045bd6a0d096254331e']",1,3,4,579442,2,,,,1845
7cf085e6c5bd1ca574cff0a1d209b13395d0d449,0,Henrique Mendonça,2013-09-20 16:47:02+02:00,['6b43fa37958c944d918f51794e77ef3b69abf55f'],5,319,324,579766,7,0.828282828,0.858585859,1,1849
a9e624811f07e23fc280932e6b05587ce69c1644,0,Henrique Mendonça,2013-09-20 17:09:50+02:00,['6b43fa37958c944d918f51794e77ef3b69abf55f'],5,319,324,580090,7,0.828282828,0.858585859,1,1853
e594dccc85740ecc1d61f236e9135c5b90301d31,0,Henrique Mendonça,2013-09-20 17:15:55+02:00,"['a9e624811f07e23fc280932e6b05587ce69c1644', '7cf085e6c5bd1ca574cff0a1d209b13395d0d449']",1,1,2,580092,1,,,,1853
095ddb7ff8c9e503c2186e8452f2de7f7451212a,1,Henrique Mendonça,2013-09-20 19:38:03+02:00,['e594dccc85740ecc1d61f236e9135c5b90301d31'],65,513,578,580670,8,0.016666667,0.933333333,0.916666667,1855
ea4600b6b8e7dfb81bfb52a7a4e9f7a2b848120c,0,Roger Meier,2013-09-21 08:47:21+02:00,['095ddb7ff8c9e503c2186e8452f2de7f7451212a'],1,1,2,580672,1,,,,1855
376d817abaa6f13deeddaaf9cb33f887fe9d5cf4,0,Jens Geyer,2013-09-21 12:22:24+02:00,['ea4600b6b8e7dfb81bfb52a7a4e9f7a2b848120c'],1,1,2,580674,1,,,,1855
836d95f9f00be73c6936d407977796181d1a506c,0,Ben Craig,2013-09-23 11:53:47-05:00,['376d817abaa6f13deeddaaf9cb33f887fe9d5cf4'],6,3,9,580683,2,1,1,0,1855
26ef743d2fb9da250bee385cac0bef09a5f09b77,0,Jens Geyer,2013-09-23 22:02:17+02:00,['836d95f9f00be73c6936d407977796181d1a506c'],2,9,11,580694,1,,,,1855
83767a72cd94c0bcc89d350bc551227f41669479,0,Jens Geyer,2013-09-23 22:09:49+02:00,['26ef743d2fb9da250bee385cac0bef09a5f09b77'],10,28,38,580732,5,0,1,0.785714286,1855
01640408045af154883bb420aa4e589195af7d12,1,Jens Geyer,2013-09-25 21:12:21+02:00,['83767a72cd94c0bcc89d350bc551227f41669479'],159,498,657,581389,10,0,0.035087719,0.964912281,1856
d430bbdc8148558cb30a2db4931dc3e19405a578,0,Jens Geyer,2013-09-26 23:37:54+02:00,['01640408045af154883bb420aa4e589195af7d12'],1,1,2,581391,1,,,,1856
38b453be5a015b7aaefcd91b4e261e53e0e211c2,1,jfarrell,2013-09-27 10:11:12-04:00,['d430bbdc8148558cb30a2db4931dc3e19405a578'],7,142,149,581540,2,1,1,1,1857
aea8bfe0f0c0544fd59819d9696747ecaeacb4f7,0,Ben Craig,2013-09-27 10:44:54-05:00,['38b453be5a015b7aaefcd91b4e261e53e0e211c2'],0,16,16,581556,4,,,,1857
27148dee980b396afee80bc7e5ce704443de4408,1,Jens Geyer,2013-10-04 19:10:16+02:00,['aea8bfe0f0c0544fd59819d9696747ecaeacb4f7'],15,29,44,581600,2,0,0,1,1857
380a45d0f7354486195d4938d204671e1b2cefcb,0,jfarrell,2013-10-04 22:50:21-04:00,['27148dee980b396afee80bc7e5ce704443de4408'],1,1,2,581602,1,,,,1857
282e440c6de219b7b8f32b01cc7eb599f534f33f,0,Ben Craig,2013-10-08 16:02:06-05:00,['380a45d0f7354486195d4938d204671e1b2cefcb'],32,62,94,581696,10,0,0,0,1857
9f9cd10e813ef574dd5578d78ca26a9088383d3a,1,Ben Craig,2013-10-09 09:47:48-05:00,['282e440c6de219b7b8f32b01cc7eb599f534f33f'],62,32,94,581790,10,1,1,1,1857
19244ed87f7e6e8e997391e5ab7cb862c73449b2,1,Ben Craig,2013-10-09 15:18:55-05:00,['9f9cd10e813ef574dd5578d78ca26a9088383d3a'],3,47,50,581840,4,0,0.793103448,0.931034483,1857
6493523e96df96069c94647c5e9b841b0be491a6,0,Ben Craig,2013-10-09 15:21:38-05:00,['19244ed87f7e6e8e997391e5ab7cb862c73449b2'],4,4,8,581848,3,,,,1857
96ea9daf806a0de09fdd0c6948c0bbb7eab82004,0,Ben Craig,2013-10-09 15:23:49-05:00,['6493523e96df96069c94647c5e9b841b0be491a6'],1,4,5,581853,2,,,,1857
fd64c15c4fa5ab092ecdda713bae142c05aafd72,0,Ben Craig,2013-10-09 15:26:05-05:00,['96ea9daf806a0de09fdd0c6948c0bbb7eab82004'],11,2,13,581866,1,,,,1857
d856ac8c3016888da32a689896a7bd944310d0cf,0,Ben Craig,2013-10-09 15:27:38-05:00,['fd64c15c4fa5ab092ecdda713bae142c05aafd72'],0,13,13,581879,1,0,0.5,1,1857
71b5a10b613406765037ecd0e300769b34741c00,0,Ben Craig,2013-10-10 08:55:16-05:00,['d856ac8c3016888da32a689896a7bd944310d0cf'],41,21,62,581941,3,1,0,0,1857
49a7663c79ad064fed21bef18e87d929a73a2521,0,Ben Craig,2013-10-11 08:07:06-05:00,['71b5a10b613406765037ecd0e300769b34741c00'],6,6,12,581953,1,,,,1857
e957675647d3d7caafe842aa85cbd987e91b21f9,1,Ben Craig,2013-10-11 08:19:16-05:00,['49a7663c79ad064fed21bef18e87d929a73a2521'],33,62,95,582048,10,0,0,0,1857
22856f34250b5b6e6c5032df6d69777712932650,0,Ben Craig,2013-10-11 08:53:51-05:00,['e957675647d3d7caafe842aa85cbd987e91b21f9'],1,1,2,582050,1,,,,1857
7f10de7ee8114ad337043f7de734481e505a3407,0,Ben Craig,2013-10-14 20:27:18-05:00,['22856f34250b5b6e6c5032df6d69777712932650'],4,11,15,582065,1,,,,1857
0d671c091cf425d7001d3eafef558e5f39e8194d,0,Ben Craig,2013-10-14 20:32:29-05:00,['7f10de7ee8114ad337043f7de734481e505a3407'],0,21,21,582086,2,0.5,0.5,1,1857
8203a149eb5044a3fbf5fafbb41b4006e49b8b7c,0,Jens Geyer,2013-10-24 22:14:22+02:00,['0d671c091cf425d7001d3eafef558e5f39e8194d'],1,1,2,582088,1,,,,1857
53078be3ee94d557a81e162b727bfe643c3e9dd8,0,Jens Geyer,2013-11-02 20:05:40+02:00,['8203a149eb5044a3fbf5fafbb41b4006e49b8b7c'],0,2,2,582090,1,,,,1857
fca0b8c972c3ecdb065e428e92749e1c8777eaf3,0,Jens Geyer,2013-11-03 23:42:35+01:00,['53078be3ee94d557a81e162b727bfe643c3e9dd8'],1,6,7,582097,1,,,,1857
31aebbef19d5ac5125172c2081303f89c38fa991,0,Jens Geyer,2013-11-04 22:17:48+01:00,['fca0b8c972c3ecdb065e428e92749e1c8777eaf3'],2,1,3,582100,1,0,1,1,1857
9957d3022e69e8e9b8921e297171f8903017694d,0,Jens Geyer,2013-11-04 22:18:40+01:00,['31aebbef19d5ac5125172c2081303f89c38fa991'],3,2,5,582105,2,1,1,0,1857
088c26b40ccf747eaa5200727c9bacdc9288fb35,1,Jens Geyer,2013-11-04 22:40:38+01:00,['9957d3022e69e8e9b8921e297171f8903017694d'],118,183,301,582406,2,0,0,0.464285714,1857
0ec155e1608c2909183b7c5e0b08a4a80579b4bd,1,Jens Geyer,2013-11-05 00:49:10+01:00,['088c26b40ccf747eaa5200727c9bacdc9288fb35'],15,36,51,582457,2,0,0,0.368421053,1857
8c691fa004289d4cc484ce0b21063689e1489359,0,Roger Meier,2013-11-05 04:54:33+01:00,['0ec155e1608c2909183b7c5e0b08a4a80579b4bd'],2,2,4,582461,1,,,,1857
378663a3bb91bc7ee741ce34b0fac7565ab62d09,0,Roger Meier,2013-11-05 05:23:47+01:00,['8c691fa004289d4cc484ce0b21063689e1489359'],1,1,2,582463,1,,,,1857
73250ba96ccb7714397602a652e0b9de2b998efc,1,Jens Geyer,2013-11-05 09:16:11+01:00,['378663a3bb91bc7ee741ce34b0fac7565ab62d09'],11,21,32,582495,1,0.428571429,0,0.428571429,1857
dc66d9282856aad8440fb384c17361f986f84d85,1,henrique,2013-11-05 14:44:51+01:00,['fca0b8c972c3ecdb065e428e92749e1c8777eaf3'],0,985,985,583480,2,0.535022355,0.66318927,0.956780924,1859
3bd05b090c84a282d42872ecd412ae36e3697d98,0,henrique,2013-11-05 14:46:16+01:00,['dc66d9282856aad8440fb384c17361f986f84d85'],0,2,2,583482,1,,,,1859
5def2f87d808e4ae1270d22ee2a28034a84bf98d,0,henrique,2013-11-05 15:01:48+01:00,"['3bd05b090c84a282d42872ecd412ae36e3697d98', '73250ba96ccb7714397602a652e0b9de2b998efc']",136,230,366,583848,8,,,,1859
f4e6e62ea091b94322ecc99756269dbee1c06380,0,Ben Craig,2013-11-05 19:49:12-06:00,['5def2f87d808e4ae1270d22ee2a28034a84bf98d'],4,4,8,583856,1,,,,1859
3e25e5e62ae173ad8a629b1673fba8a1853feeca,0,henrique,2013-11-08 19:06:21+01:00,['f4e6e62ea091b94322ecc99756269dbee1c06380'],2,2,4,583860,1,,,,1859
1ee7bb645d1ca5b54198d77cdc9f0517e509cc39,0,Roger Meier,2013-11-09 19:41:46+01:00,['3e25e5e62ae173ad8a629b1673fba8a1853feeca'],1,23,24,583884,2,0.705882353,0.823529412,0.823529412,1859
d335acdc2e69f4f682f28dded96914240c1bdc1d,0,Jens Geyer,2013-11-11 21:34:40+01:00,['1ee7bb645d1ca5b54198d77cdc9f0517e509cc39'],3,9,12,583896,1,,,,1859
13848c6801868cdc23b3d588b279adbabb11a5f0,0,Jens Geyer,2013-11-11 22:06:05+01:00,['d335acdc2e69f4f682f28dded96914240c1bdc1d'],0,6,6,583902,1,0,0,0,1859
4ccc24f6214f3041af5e564322382df1d84bf935,1,Jens Geyer,2013-11-11 22:43:45+01:00,['13848c6801868cdc23b3d588b279adbabb11a5f0'],4,13,17,583919,1,0.571428571,1,1,1859
b54fbd32cf79bffa0e96409af55783f17abf5aa8,0,Jens Geyer,2013-11-11 23:17:17+01:00,['4ccc24f6214f3041af5e564322382df1d84bf935'],1,1,2,583921,1,,,,1859
5df24f7afb05fe25352f1fe5fff0206eb0103a3d,0,Roger Meier,2013-11-13 22:08:06+01:00,['b54fbd32cf79bffa0e96409af55783f17abf5aa8'],1,1,2,583923,1,,,,1859
3da1c9025b77f5ca3ba4c296b8ab3089235b9c3b,1,Roger Meier,2013-11-16 15:37:20+01:00,['5df24f7afb05fe25352f1fe5fff0206eb0103a3d'],19,13,32,583955,5,1,0,0,1859
5f2d34e5ab33651059a085525b3adbab6a877e6f,0,Roger Meier,2013-11-16 16:43:41+01:00,['3da1c9025b77f5ca3ba4c296b8ab3089235b9c3b'],13,13,26,583981,3,,,,1859
f35975b67fc57fbb7c3b1bb43c09b646558be454,0,Roger Meier,2013-11-17 18:30:23+01:00,['5f2d34e5ab33651059a085525b3adbab6a877e6f'],4,4,8,583989,1,,,,1859
cba92b308f894ef02b89c23ea6179faff6138772,1,jfarrell,2013-11-25 13:30:41-05:00,['f35975b67fc57fbb7c3b1bb43c09b646558be454'],2,2,4,583993,3,,,,1859
3979b869f3236b3a7e1c92b788eabced2a8345ed,1,jfarrell,2013-11-25 14:47:16-05:00,['cba92b308f894ef02b89c23ea6179faff6138772'],4,8,12,584005,1,0.666666667,0.666666667,0.333333333,1859
8bdff945b52ee090fd53540a4bc6f54e1c176d10,0,jfarrell,2013-11-25 21:20:28-05:00,['3979b869f3236b3a7e1c92b788eabced2a8345ed'],1,1,2,584007,1,,,,1859
4b4f42b45b85f20dacaea0a724070ad8b82b8988,1,jfarrell,2013-11-27 12:45:49-05:00,['8bdff945b52ee090fd53540a4bc6f54e1c176d10'],4,9,13,584020,1,,,,1859
f322d917fb1f1465049ed29853081ef47ca16800,0,Jens Geyer,2013-11-28 21:15:17+01:00,['4b4f42b45b85f20dacaea0a724070ad8b82b8988'],0,1,1,584021,1,1,1,1,1859
7949447efdcb2b355d3140a0d1a765e98a9a9e68,0,Jens Geyer,2013-12-03 22:57:05+01:00,['f322d917fb1f1465049ed29853081ef47ca16800'],24,6,30,584051,1,1,0,0,1859
a5960383273432d5249c113f6413bbe39c13df50,0,Jens Geyer,2013-12-03 22:57:59+01:00,['7949447efdcb2b355d3140a0d1a765e98a9a9e68'],6,15,21,584072,2,0,1,1,1859
88103ca7f4c342d0e239b411f3321b0d25c0a150,0,Roger Meier,2013-12-06 20:47:39+01:00,['a5960383273432d5249c113f6413bbe39c13df50'],1,1,2,584074,1,,,,1859
ce8d518166a7ab8785d863a6e1bc644c20bdf570,0,Jens Geyer,2013-12-07 00:11:34+01:00,['88103ca7f4c342d0e239b411f3321b0d25c0a150'],1,5,6,584080,1,1,1,1,1859
739032ac4b3564056506262396ce6939907c28f7,1,Jens Geyer,2013-12-07 00:11:36+01:00,['ce8d518166a7ab8785d863a6e1bc644c20bdf570'],6,27,33,584113,1,0,0,1,1859
5b8e770864d0ebe85e7aee3cc29de04edf60a71d,0,Jens Geyer,2013-12-07 00:11:38+01:00,['739032ac4b3564056506262396ce6939907c28f7'],3,2,5,584118,1,1,0,0,1859
4f00134cf989aa09a255b550b7fca0e3ef3d22f9,0,Roger Meier,2013-12-08 20:59:51+01:00,['5b8e770864d0ebe85e7aee3cc29de04edf60a71d'],0,15,15,584133,2,0,0,1,1859
acdac816659c88e7b8b601b4ad42dc43bf7d48e2,0,Roger Meier,2013-12-08 22:10:36+01:00,['4f00134cf989aa09a255b550b7fca0e3ef3d22f9'],56,37,93,584226,1,1,0.25,0.125,1859
2c4f306b0a93454b7e18aa425e4e8f7f4f9ef4f5,0,Jens Geyer,2013-12-14 00:40:44+01:00,['acdac816659c88e7b8b601b4ad42dc43bf7d48e2'],0,1,1,584227,1,0,0,1,1859
0853ab67b4db1db15dc4b8f195764331174e5594,1,Jens Geyer,2013-12-17 21:38:44+01:00,['2c4f306b0a93454b7e18aa425e4e8f7f4f9ef4f5'],154,257,411,584638,4,1,1,1,1860
bf3a19dc7ee50be6959df5422642794f8c54383d,1,Jens Geyer,2013-12-17 21:39:30+01:00,['0853ab67b4db1db15dc4b8f195764331174e5594'],48,23,71,584709,2,1,1,0,1860
d960e6e9662d4a9128dc7a8378ab54ad030e24ec,0,Jens Geyer,2013-12-19 22:06:30+01:00,['bf3a19dc7ee50be6959df5422642794f8c54383d'],3,3,6,584715,1,,,,1860
5ba91f23bdf627bd869410c53a3d9181c8cfb526,0,henrique,2013-12-20 22:37:20+01:00,['d960e6e9662d4a9128dc7a8378ab54ad030e24ec'],0,51,51,584766,1,1,1,0.259259259,1860
4095d62cd795e5e8b1d9b0be3e8a9a2efe882f3c,1,Jens Geyer,2013-12-21 20:14:43+01:00,['5ba91f23bdf627bd869410c53a3d9181c8cfb526'],1,1,2,584768,1,,,,1860
d9c80e2dae01b1ccd78ad57eacde40b489a943f4,1,Jens Geyer,2013-12-21 20:14:45+01:00,['4095d62cd795e5e8b1d9b0be3e8a9a2efe882f3c'],56,54,110,584878,1,0,0,,1860
1406c9adaf3bc7a43c9f594ad38fa90193a929cb,0,Jens Geyer,2013-12-24 17:20:20+01:00,['d9c80e2dae01b1ccd78ad57eacde40b489a943f4'],0,1,1,584879,1,0,0,1,1860
53db7cc486a9f1f0e000d977d853a6811238a9e6,1,Roger Meier,2013-12-26 15:38:32+01:00,['1406c9adaf3bc7a43c9f594ad38fa90193a929cb'],2,16,18,584897,1,0,0,1,1860
797595049274b9085385de5ef402075f6fc3de56,0,Jens Geyer,2013-12-26 18:59:15+01:00,['53db7cc486a9f1f0e000d977d853a6811238a9e6'],6,6,12,584909,3,,,,1860
4d1b0eac7ddea3d1de59477723958106b6d0209f,0,Jens Geyer,2013-12-26 19:00:28+01:00,['797595049274b9085385de5ef402075f6fc3de56'],2,2,4,584913,1,,,,1860
1fb6847473169e2abfdd4b241ad4f2341842e8b1,1,Jens Geyer,2013-12-26 19:01:20+01:00,['4d1b0eac7ddea3d1de59477723958106b6d0209f'],3,3,6,584919,1,,,,1860
bcca1d9d2bc9c7c26ed53210ab1aa5b5477a4a6e,0,Jens Geyer,2013-12-26 19:24:30+01:00,['1fb6847473169e2abfdd4b241ad4f2341842e8b1'],3,4,7,584926,1,,,,1860
ad0141aea57f7a5881a9c899a74445f8825fc267,1,Jens Geyer,2013-12-30 22:01:53+01:00,['bcca1d9d2bc9c7c26ed53210ab1aa5b5477a4a6e'],5,15,20,584946,1,,,,1860
2136694a2045120af80fb7064f600a75f793720c,0,Jens Geyer,2013-12-30 22:06:08+01:00,['ad0141aea57f7a5881a9c899a74445f8825fc267'],2,16,18,584964,2,,,,1860
f6acf44117ebc96dff9eded7a836674be9924d84,0,Jens Geyer,2014-01-02 22:58:43+01:00,['2136694a2045120af80fb7064f600a75f793720c'],9,18,27,584991,2,0.714285714,0.714285714,1,1860
cf8b6264348c5df232f7a81e6a5463b3763943ab,0,Roger Meier,2014-01-04 23:31:21+01:00,['f6acf44117ebc96dff9eded7a836674be9924d84'],12,34,46,585037,1,0,0,1,1860
2c7e89b30593b2288ee47ff56c614099bf238b29,0,Roger Meier,2014-01-05 00:18:32+01:00,['cf8b6264348c5df232f7a81e6a5463b3763943ab'],1,1,2,585039,1,,,,1860
6bac11f4fa3d96acdbd9e625be11f4f97aa053bc,0,Roger Meier,2014-01-05 02:10:33+01:00,['2c7e89b30593b2288ee47ff56c614099bf238b29'],3,3,6,585045,1,,,,1860
f1612825584e219ff02f601da6691eae67e0878f,0,Roger Meier,2014-01-06 07:19:09+01:00,['6bac11f4fa3d96acdbd9e625be11f4f97aa053bc'],2,2,4,585049,1,,,,1860
05f37f1917bfa89d5862e4e45896bc6e28d8fa51,0,jfarrell,2014-01-06 22:51:22-05:00,['f1612825584e219ff02f601da6691eae67e0878f'],3,7,10,585059,1,,,,1860
5d02b80e9cde00280cbac5c17cc3843806ec9436,0,Jake Farrell,2014-01-07 21:42:01-05:00,['05f37f1917bfa89d5862e4e45896bc6e28d8fa51'],352,343,695,585754,15,1,1,0,1860
06dbb8f011d2deccb66266ca45f8ea1a2f84ffb1,0,Jake Farrell,2014-01-07 22:29:50-05:00,['5d02b80e9cde00280cbac5c17cc3843806ec9436'],2,2,4,585758,1,,,,1860
f41d79d1448a495e27a84ffe6625de20ec69e642,0,Ben Craig,2014-01-08 15:15:48-06:00,['06dbb8f011d2deccb66266ca45f8ea1a2f84ffb1'],2,5,7,585765,1,,,,1860
11c813ea3c36b6211991c01e6c24055ea682f7bf,0,jfarrell,2014-01-10 13:12:46-05:00,['f41d79d1448a495e27a84ffe6625de20ec69e642'],0,50,50,585815,1,,,,1860
b9d55220ceb718b8fc32ef78874744072ef27893,1,Jens Geyer,2014-01-10 21:26:25+01:00,['11c813ea3c36b6211991c01e6c24055ea682f7bf'],537,1460,1997,587812,19,0.572429907,0.862149533,0.988317757,1871
b27012ca4ec4f920ea605a7ed109185d32ebcee7,0,Roger Meier,2014-01-11 11:15:37+01:00,['b9d55220ceb718b8fc32ef78874744072ef27893'],0,2,2,587814,1,,,,1871
c0c889b9dd460c8ca33a4d84eb2ac32c6a73bab7,1,Jens Geyer,2014-01-11 22:22:40+01:00,['b27012ca4ec4f920ea605a7ed109185d32ebcee7'],4,46,50,587864,1,0,0,0.305555556,1871
b2b4a5ca981639ce8ee02d1c6f463e6b5fea7adf,0,Roger Meier,2014-01-12 13:10:50+01:00,['c0c889b9dd460c8ca33a4d84eb2ac32c6a73bab7'],5,5,10,587874,1,,,,1871
38391a7a01d2ccb3510939118a7472dd9f91aba2,0,Roger Meier,2014-01-12 19:58:54+01:00,['b2b4a5ca981639ce8ee02d1c6f463e6b5fea7adf'],1,1,2,587876,1,,,,1871
623201412a36471f5bd92b16290028fc03a2b88d,0,Roger Meier,2014-01-12 20:00:31+01:00,['38391a7a01d2ccb3510939118a7472dd9f91aba2'],9,22,31,587907,3,,,,1871
090a5e4c690ad44f4fbcd6519070507434cb4c46,0,Roger Meier,2014-01-12 20:09:53+01:00,['623201412a36471f5bd92b16290028fc03a2b88d'],1,0,1,587908,1,,,,1871
3233fe80c99d0cf535215f1ee7e4f01024727d06,0,Roger Meier,2014-01-12 22:10:47+01:00,['090a5e4c690ad44f4fbcd6519070507434cb4c46'],0,4,4,587912,1,,,,1871
d45b7db328d46e2d7813b0e815750e5ba155a34e,0,Roger Meier,2014-01-12 22:11:04+01:00,['3233fe80c99d0cf535215f1ee7e4f01024727d06'],2,1,3,587915,2,,,,1871
a510d6b48b0346534d1e55eb3d3ef09765ec4a46,0,Roger Meier,2014-01-12 22:17:45+01:00,['d45b7db328d46e2d7813b0e815750e5ba155a34e'],1,1,2,587917,1,,,,1871
0240572c44c64c3ab1d498d32a9a1530ab91b0da,0,Roger Meier,2014-01-12 23:29:11+01:00,['a510d6b48b0346534d1e55eb3d3ef09765ec4a46'],3,3,6,587923,3,,,,1871
a16737a87f74d5642869d3315f6b44a6b0fc91d3,1,Jens Geyer,2014-01-13 19:55:44+01:00,['0240572c44c64c3ab1d498d32a9a1530ab91b0da'],2,5,7,587930,1,0,0,1,1871
216374ec4a72cbabf7c76dd9284362aba4d30f1c,1,henrique,2014-01-14 15:17:04+01:00,['a16737a87f74d5642869d3315f6b44a6b0fc91d3'],248,314,562,588492,5,1,1,1,1871
84cd2846881cfe0467bfab20809ee7ceac957fe9,1,jfarrell,2014-01-14 21:51:59-05:00,['216374ec4a72cbabf7c76dd9284362aba4d30f1c'],0,135,135,588627,2,,,,1872
6635058e8be97721447ec8e202306226fa8187ca,0,Roger Meier,2014-01-15 09:51:48+01:00,['84cd2846881cfe0467bfab20809ee7ceac957fe9'],12,15,27,588654,1,,,,1872
09cc5e7728cd4bc197e33a02e2fd263407d4a87b,0,Roger Meier,2014-01-15 10:13:18+01:00,['6635058e8be97721447ec8e202306226fa8187ca'],13,13,26,588680,1,,,,1872
aae8acb2db6210911f809e857eebfd4d1c765ac2,0,Roger Meier,2014-01-15 13:55:09+01:00,['09cc5e7728cd4bc197e33a02e2fd263407d4a87b'],3,7,10,588690,3,,,,1872
78dbd5c66266d310a7e96cf0271f9afdec05f631,0,Roger Meier,2014-01-15 13:57:34+01:00,['aae8acb2db6210911f809e857eebfd4d1c765ac2'],1,1,2,588692,1,,,,1872
dffc9fe8dd30f68cd6f23064da7905dd9e0afa02,0,Roger Meier,2014-01-15 21:10:59+01:00,['78dbd5c66266d310a7e96cf0271f9afdec05f631'],1,1,2,588694,1,,,,1872
169d6558186c7e8a600276f89d56ec000690171f,0,Roger Meier,2014-01-15 21:48:10+01:00,['dffc9fe8dd30f68cd6f23064da7905dd9e0afa02'],6,6,12,588706,1,,,,1872
77369a0ecd7045aec7be0226ca4843f893bbcda0,0,Jens Geyer,2014-01-16 21:36:08+01:00,['169d6558186c7e8a600276f89d56ec000690171f'],3,3,6,588712,1,,,,1872
0e8148024b4bd3f50331ad5fcc7334d4aa60949b,0,Roger Meier,2014-01-17 21:07:58+01:00,['77369a0ecd7045aec7be0226ca4843f893bbcda0'],18,18,36,588748,2,,,,1872
c95d5dfb76631af655f2d905e5e514d5db6078d5,0,Roger Meier,2014-01-19 21:53:02+01:00,['0e8148024b4bd3f50331ad5fcc7334d4aa60949b'],16,26,42,588790,7,,,,1872
9aa08a9f6849f5c71aa3e7d1ba493521a11d026c,0,Roger Meier,2014-01-20 18:41:48+01:00,['c95d5dfb76631af655f2d905e5e514d5db6078d5'],1,1,2,588792,1,,,,1872
194f0114c27f6a41c96be6d5702895bf5c1519e3,0,Roger Meier,2014-01-22 00:10:31+01:00,['9aa08a9f6849f5c71aa3e7d1ba493521a11d026c'],3,5,8,588800,1,1,1,0,1872
507740c93c795b9d1f927909456962ec64f67b65,0,jfarrell,2014-01-22 22:20:21-05:00,['194f0114c27f6a41c96be6d5702895bf5c1519e3'],7,6,13,588813,2,,,,1872
026d7fc0e1eaac1a36d964ec3b900e34c11c0c81,0,Jens Geyer,2014-01-23 19:03:37+01:00,['507740c93c795b9d1f927909456962ec64f67b65'],1,4,5,588818,1,0,0,0,1872
beb937740a19340431ffd99ecb14f8a5c05624c2,0,Jens Geyer,2014-01-23 19:16:52+01:00,['026d7fc0e1eaac1a36d964ec3b900e34c11c0c81'],0,2,2,588820,1,,,,1872
ad7f788824225ab2d0137e5595627d20c7d9540b,0,Roger Meier,2014-01-23 20:44:36+01:00,['beb937740a19340431ffd99ecb14f8a5c05624c2'],0,160,160,588980,1,0.1875,0.223214286,0.982142857,1872
e8379b538adbfdcd94c8d9a8702c10435cd38475,1,Jens Geyer,2014-01-25 00:59:45+01:00,['ad7f788824225ab2d0137e5595627d20c7d9540b'],5,85,90,589070,6,0.941176471,0.941176471,1,1872
aefd9c489987a943fce16b0b4661f1bbfdc6f30e,0,Roger Meier,2014-01-25 19:59:27+01:00,['e8379b538adbfdcd94c8d9a8702c10435cd38475'],2,2,4,589074,2,,,,1872
f9d16b1c3efe09f8cfcc3c608d6f1e9ef672bcfe,0,Roger Meier,2014-01-26 00:26:16+01:00,['aefd9c489987a943fce16b0b4661f1bbfdc6f30e'],0,1,1,589075,1,,,,1872
d0024544bc2f45b6c039387fe69df8cf77fde45d,0,Roger Meier,2014-01-26 10:46:10+01:00,['f9d16b1c3efe09f8cfcc3c608d6f1e9ef672bcfe'],1,1,2,589077,1,,,,1872
8909cbdf819a059874ffc22ca6c04a06211321f6,1,Roger Meier,2014-01-26 11:44:27+01:00,['d0024544bc2f45b6c039387fe69df8cf77fde45d'],610,351,961,590038,26,0.27173913,0,0.14673913,1875
c88d58195246069ea05106855aa567e2db32fe69,0,Roger Meier,2014-01-26 11:51:26+01:00,['8909cbdf819a059874ffc22ca6c04a06211321f6'],3,18,21,590059,2,,,,1875
0ef1e2eee30de5e1a041ba254c98743d256015b7,1,Roger Meier,2014-01-26 14:57:38+01:00,['c88d58195246069ea05106855aa567e2db32fe69'],1,1,2,590061,1,,,,1875
64998e2ac415d7085d7683e183535b43178cc0ca,1,Roger Meier,2014-01-27 21:15:56+01:00,['0ef1e2eee30de5e1a041ba254c98743d256015b7'],2,209,211,590272,5,0.563380282,0.563380282,0.507042254,1878
ee78e31c88de3578a787adf2d601186477fc7d8e,0,Roger Meier,2014-01-27 21:19:02+01:00,['64998e2ac415d7085d7683e183535b43178cc0ca'],0,2,2,590274,1,,,,1878
54a6636c4288c699f21a93a473a52139c368ffc1,0,Jens Geyer,2014-01-30 20:57:08+01:00,['ee78e31c88de3578a787adf2d601186477fc7d8e'],7,70,77,590351,2,0.444444444,0.444444444,1,1879
b3e784994a57d3acad4f807b9ebd89caa72889c8,1,Jens Geyer,2014-01-30 23:34:09+01:00,['54a6636c4288c699f21a93a473a52139c368ffc1'],0,370,370,590721,2,1,1,0.811428571,1881
813749dc50676c9d2ba778bf73bcb9bb872bd30c,1,Jens Geyer,2014-01-31 23:42:57+01:00,['b3e784994a57d3acad4f807b9ebd89caa72889c8'],22,58,80,590801,6,1,1,1,1882
483d791f64f0cddf765c2ea991cdbe8fda787e91,0,Jens Geyer,2014-02-01 03:58:40+01:00,['813749dc50676c9d2ba778bf73bcb9bb872bd30c'],1,1,2,590803,1,,,,1882
d95fc9b1eedf77a42f072308d191f583c3052028,1,Jens Geyer,2014-02-02 18:08:31+01:00,['483d791f64f0cddf765c2ea991cdbe8fda787e91'],6,140,146,590949,4,0.459183673,0.928571429,0.806122449,1882
301dfa94d6465244d5970e2abdc0650b386468d5,0,Roger Meier,2014-02-02 23:56:19+01:00,['d95fc9b1eedf77a42f072308d191f583c3052028'],0,1,1,590950,1,1,1,1,1882
0f60bd4f54cc120836415982a8cc457a4175ce08,1,Roger Meier,2014-02-03 00:29:23+01:00,['301dfa94d6465244d5970e2abdc0650b386468d5'],6,6,12,590962,4,,,,1882
4904ab81ff8f73b9a22872b5fb0ba2213597f2f2,1,Jens Geyer,2014-02-04 23:03:30+01:00,['0f60bd4f54cc120836415982a8cc457a4175ce08'],38,40,78,591040,1,0,1,1,1882
38b1a04b60f1122d94b8e83243f67a9c93182456,1,Jens Geyer,2014-02-04 23:56:39+01:00,['4904ab81ff8f73b9a22872b5fb0ba2213597f2f2'],24,35,59,591099,4,0,1,1,1882
56d41eb4a79148ff926f923426faddce6baaf3c4,0,Jens Geyer,2014-02-05 21:10:59+01:00,['38b1a04b60f1122d94b8e83243f67a9c93182456'],6,12,18,591117,1,0,0,1,1882
213ea258de6796e1302e57f4246434ca3c9a2ac6,0,Roger Meier,2014-02-06 23:41:37+01:00,['56d41eb4a79148ff926f923426faddce6baaf3c4'],1,12,13,591130,1,1,1,1,1882
2a816c28ae166f267e3a681ba335b298d542b1f1,0,Roger Meier,2014-02-07 01:15:23+01:00,['213ea258de6796e1302e57f4246434ca3c9a2ac6'],5,12,17,591147,1,0,0,1,1882
a2de4105317adeb5268e5e289a6226d6477cfbfe,1,henrique,2014-02-07 14:12:56+01:00,['2a816c28ae166f267e3a681ba335b298d542b1f1'],240,533,773,591920,12,0.443298969,0.680412371,0.969072165,1885
73938622ef9b3a53d45063aee70ad5155202605a,1,Jens Geyer,2014-02-07 22:22:36+01:00,['a2de4105317adeb5268e5e289a6226d6477cfbfe'],20,190,210,592130,5,0.842105263,0.842105263,1,1889
7bb44a33bf2225d6c2220e4c5166669f7975f561,1,Jens Geyer,2014-02-07 22:24:37+01:00,['73938622ef9b3a53d45063aee70ad5155202605a'],22,60,82,592212,2,,,,1889
2f51f327e3b6d22e578a84a037d1a9094c64dd9b,1,henrique,2014-02-09 11:21:33+01:00,['7bb44a33bf2225d6c2220e4c5166669f7975f561'],475,200,675,592887,4,0.084507042,0.077464789,0,1890
22888ce3a84f38c1478f38ad0d1ff3ed7fdf5f39,0,Roger Meier,2014-02-09 11:31:02+01:00,['2f51f327e3b6d22e578a84a037d1a9094c64dd9b'],5,5,10,592897,3,,,,1890
7fff60ff79398e32b5f4824cabd97d216aad35db,0,henrique,2014-02-09 11:36:44+01:00,['22888ce3a84f38c1478f38ad0d1ff3ed7fdf5f39'],111,8,119,593016,1,,,,1890
c92cda0d99820af884fb79c85ba9c738d0c7210f,0,Roger Meier,2014-02-09 21:13:53+01:00,['7fff60ff79398e32b5f4824cabd97d216aad35db'],0,24,24,593040,1,,,,1890
3bf62d1d89de63ed3d4b9d14eb62e61d3143cbfe,0,Roger Meier,2014-02-09 22:43:40+01:00,['c92cda0d99820af884fb79c85ba9c738d0c7210f'],12,1,13,593053,1,,,,1890
47b89b9584d224a7e0053768b6c7c954eb42bf33,0,Roger Meier,2014-02-11 21:28:56+01:00,['3bf62d1d89de63ed3d4b9d14eb62e61d3143cbfe'],2,2,4,593057,1,,,,1890
023192f7e1d3d7698becaf0bd06bff59e4684067,0,Roger Meier,2014-02-12 09:35:12+01:00,['47b89b9584d224a7e0053768b6c7c954eb42bf33'],4,12,16,593073,3,0,0,1,1890
06ad7218a9aeb05538d9ec09a6fed8e16b9aa1e1,0,Jens Geyer,2014-02-16 15:49:52+01:00,['023192f7e1d3d7698becaf0bd06bff59e4684067'],70,103,173,593246,2,0.04,1,1,1890
8c1779d6712f102f2844621508e9f445540be7d2,0,Jens Geyer,2014-02-18 21:55:43+01:00,['06ad7218a9aeb05538d9ec09a6fed8e16b9aa1e1'],1,6,7,593253,1,1,1,1,1890
9f4f5157a3f3a6e67be039528c4e0dbe6e716a41,0,Roger Meier,2014-02-19 16:28:35+01:00,['8c1779d6712f102f2844621508e9f445540be7d2'],13,6,19,593272,4,,,,1890
161cf42b0948859a9d4f6f5abd7cf0b3d0b73236,0,Roger Meier,2014-02-19 16:45:56+01:00,['9f4f5157a3f3a6e67be039528c4e0dbe6e716a41'],0,241,241,593513,8,,,,1898
58bbb709a4dad28b58e99a817be8ee3e7c9071ce,0,Roger Meier,2014-02-19 19:59:25+01:00,['161cf42b0948859a9d4f6f5abd7cf0b3d0b73236'],37,58,95,593608,5,,,,1899
01386c95a8f18d55cefc0ad0f33a1154e095f51a,0,Roger Meier,2014-02-19 23:07:25+01:00,['58bbb709a4dad28b58e99a817be8ee3e7c9071ce'],6,48,54,593662,2,0,0,1,1899
8b3ca02a2ad3a005685f66dc85a625a6731144b7,1,jfarrell,2014-02-21 12:11:14-05:00,['01386c95a8f18d55cefc0ad0f33a1154e095f51a'],2,216,218,593880,2,0.697674419,0.860465116,0.736434109,1899
db536cf6bb7a561ca83c7f4b8c1c7fd1fed00375,0,jfarrell,2014-02-21 13:50:10-05:00,['8b3ca02a2ad3a005685f66dc85a625a6731144b7'],48,6,54,593934,2,1,1,0,1899
57b354b8f7b509a69c76fb67a732a98112e72c01,1,Roger Meier,2014-02-22 01:01:58+01:00,['db536cf6bb7a561ca83c7f4b8c1c7fd1fed00375'],26,252,278,594212,12,0.693333333,0.986666667,0.773333333,1902
8dbff98aea43757b138e641d8e0d0cbbf9a68ffa,0,jfarrell,2014-02-21 19:31:46-05:00,['57b354b8f7b509a69c76fb67a732a98112e72c01'],1,1,2,594214,1,,,,1902
3fa14a3990e973f0354059191bec34dcc8184af8,0,jfarrell,2014-02-21 19:37:13-05:00,['8dbff98aea43757b138e641d8e0d0cbbf9a68ffa'],3,1,4,594218,1,0,0,0,1902
567df43e80b46bf8537875c1ac817c8f9af6277b,0,jfarrell,2014-02-21 20:15:16-05:00,['3fa14a3990e973f0354059191bec34dcc8184af8'],1,0,1,594219,1,,,,1902
199833807f8dabd0d6d1707a594b7d6cac82641e,0,Jens Geyer,2014-02-22 17:34:29+01:00,['567df43e80b46bf8537875c1ac817c8f9af6277b'],2,89,91,594310,4,0,1,1,1903
7e10329f7982f2602d6dbdcb2b45e843b85170c4,0,Roger Meier,2014-02-22 18:13:03+01:00,['199833807f8dabd0d6d1707a594b7d6cac82641e'],0,4,4,594314,1,,,,1903
48555c5d1fd202088f70a04084b73cab9ee41648,0,Roger Meier,2014-02-22 20:05:21+01:00,['7e10329f7982f2602d6dbdcb2b45e843b85170c4'],0,30,30,594344,4,,,,1904
c94b293dc7e30d64201e552f73ec0cf9f1a8f3df,1,Roger Meier,2014-02-22 20:07:33+01:00,['48555c5d1fd202088f70a04084b73cab9ee41648'],10,9,19,594363,2,1,1,0,1904
b080f68d5476a29f1d2eee5b73c660806cf3d7a4,0,Jens Geyer,2014-02-22 21:11:40+01:00,['c94b293dc7e30d64201e552f73ec0cf9f1a8f3df'],5,3,8,594371,1,0,0,0,1904
305e42ae3e2f9e294446487ae62a9422815f9ce5,0,Jens Geyer,2014-02-23 19:36:18+01:00,['b080f68d5476a29f1d2eee5b73c660806cf3d7a4'],47,108,155,594526,1,0,0,1,1904
98d9ef2bd675e16dde9304061f71b6435caa5cf8,0,jfarrell,2014-02-23 22:56:58-05:00,['305e42ae3e2f9e294446487ae62a9422815f9ce5'],0,1,1,594527,1,,,,1904
f36fda203565430086e23ab6a231fdc5ec3d4b48,1,Jens Geyer,2014-02-24 22:57:52+01:00,['98d9ef2bd675e16dde9304061f71b6435caa5cf8'],32,44,76,594603,3,1,1,1,1904
312362314c23ba199fca5c92868f6411afd2fc63,1,henrique,2014-02-25 22:11:10+01:00,['f36fda203565430086e23ab6a231fdc5ec3d4b48'],37,880,917,595520,11,0.652671756,0.713740458,0.982824427,1908
38eea034c330b8a929455a1f49a91c56480771fa,0,Jens Geyer,2014-02-26 21:00:05+01:00,['312362314c23ba199fca5c92868f6411afd2fc63'],17,0,17,595537,2,1,1,0.5,1908
111d13a1e7b6293f4ed7a3729be9abb54dc5b770,0,Jens Geyer,2014-02-28 19:34:40+01:00,['38eea034c330b8a929455a1f49a91c56480771fa'],1,1,2,595539,1,,,,1908
3e4c51f5cfc5466e40e536ffd02cac0730025c8e,0,Jens Geyer,2014-02-28 19:35:26+01:00,['111d13a1e7b6293f4ed7a3729be9abb54dc5b770'],4,9,13,595552,1,0,0,1,1908
f85fdd7a3af3255ea2464118930c10f582caf035,1,Roger Meier,2014-03-01 17:00:46+01:00,['3e4c51f5cfc5466e40e536ffd02cac0730025c8e'],0,52,52,595604,1,,,,1909
359036accfc16a9785d7801b99d99ec16211cc24,0,Roger Meier,2014-03-05 22:51:18+01:00,['f85fdd7a3af3255ea2464118930c10f582caf035'],1,1,2,595606,1,,,,1909
af26af6d25d480acea179a6d4831f3ea78351912,1,henrique,2014-03-06 15:06:22+01:00,['359036accfc16a9785d7801b99d99ec16211cc24'],12,13,25,595631,2,0,0,0,1909
c9e535ea76c6402eb392588b1c2fbabf83ebcd93,0,Carl Yeksigian,2014-03-06 12:04:26-05:00,['af26af6d25d480acea179a6d4831f3ea78351912'],0,189,189,595820,1,,,,1910
c975bbcc9c3c618a6ee8902ae47fed89a025b597,1,Jens Geyer,2014-03-06 21:11:46+01:00,['c9e535ea76c6402eb392588b1c2fbabf83ebcd93'],7,27,34,595854,2,0,0,0.833333333,1910
7bea35a4c2601b3227ba4062c401a4104e0fffb0,0,Jens Geyer,2014-03-07 19:41:48+01:00,['c975bbcc9c3c618a6ee8902ae47fed89a025b597'],0,218,218,596072,2,,,,1912
b39b5ea95d9b1851c437eaa80bc73d0acb643fa6,1,Jens Geyer,2014-03-07 19:42:28+01:00,['7bea35a4c2601b3227ba4062c401a4104e0fffb0'],0,668,668,596740,10,1,1,0.822485207,1922
2a7dccc8a06a2240f785255492d04a82c669ae9b,1,henrique,2014-03-07 22:16:51+01:00,['b39b5ea95d9b1851c437eaa80bc73d0acb643fa6'],224,1323,1547,598287,16,0.703049759,0.858747994,0.940609952,1927
7a66f75da882b54a8f49dd806ad5a66f7468ca7f,0,Roger Meier,2014-03-10 12:35:41+01:00,['2a7dccc8a06a2240f785255492d04a82c669ae9b'],1,1,2,598289,1,,,,1927
284101c7a0600ea7007478ca8a7e161266a27a51,0,Roger Meier,2014-03-11 21:20:35+01:00,['7a66f75da882b54a8f49dd806ad5a66f7468ca7f'],7,10,17,598306,3,0,0,1,1927
e3ab0bf507d1f3b6e898df702869331ee8ac8e12,0,Jens Geyer,2014-03-11 22:32:31+02:00,['284101c7a0600ea7007478ca8a7e161266a27a51'],22,146,168,598474,1,0.049019608,0.607843137,0.990196078,1927
d272f21ccab97fa870b7b844b77dd95a75356c3c,0,jfarrell,2014-03-11 21:56:15-04:00,['e3ab0bf507d1f3b6e898df702869331ee8ac8e12'],10,33,43,598517,1,0,0,1,1927
1f78987c49b2a44dd3b000c4e96d96244cf1cb9a,0,jfarrell,2014-03-11 22:21:07-04:00,['d272f21ccab97fa870b7b844b77dd95a75356c3c'],0,192,192,598709,2,,,,1929
52744eed7b8cc8b758825d2ba188933f907e07df,1,Roger Meier,2014-03-12 09:38:42+01:00,['1f78987c49b2a44dd3b000c4e96d96244cf1cb9a'],60,135,195,598904,4,0.285714286,0.564285714,0.9,1929
98bebac1520bcf1dd5392535e06a751d7b2af58e,0,Carl Yeksigian,2014-03-12 16:48:01-04:00,['52744eed7b8cc8b758825d2ba188933f907e07df'],5,5,10,598914,1,,,,1929
5b78958864475204dc15590742ae1bc7f4df33ca,0,henrique,2014-03-15 23:11:34+01:00,['98bebac1520bcf1dd5392535e06a751d7b2af58e'],22,22,44,598958,1,,,,1929
6fe77e8e660139dbe7ad2b52e5ca3d0e5a0de7ca,0,Jens Geyer,2014-03-17 22:51:21+02:00,['5b78958864475204dc15590742ae1bc7f4df33ca'],0,19,19,598977,3,1,1,1,1929
1c99e7079b45dde9dbb7197ceb337e42a550a84e,0,Jens Geyer,2014-03-17 22:51:23+02:00,['6fe77e8e660139dbe7ad2b52e5ca3d0e5a0de7ca'],784,784,1568,600545,10,,,,1929
55cd520edfc2f808da08cb22f2faf53bf04de47c,1,jfarrell,2014-03-18 09:24:34-04:00,['1c99e7079b45dde9dbb7197ceb337e42a550a84e'],1,5,6,600551,1,0,0,1,1929
a6b328f12a1f0962bf7841e496cf8494ed68e71f,0,Jens Geyer,2014-03-18 23:51:23+02:00,['55cd520edfc2f808da08cb22f2faf53bf04de47c'],19,29,48,600599,3,,,,1929
d26f6fde008c8336931b4a29577719646cad805d,1,Jens Geyer,2014-03-19 00:21:49+02:00,['a6b328f12a1f0962bf7841e496cf8494ed68e71f'],4,9,13,600612,1,0,0,1,1929
706cb4e4cb7426d25722b1166e0c8b102b20051e,1,Jens Geyer,2014-03-19 00:37:10+02:00,['d26f6fde008c8336931b4a29577719646cad805d'],10,144,154,600766,4,0.435643564,0.613861386,0.613861386,1929
16fcad0b25f1200db7ec0add08f827c76bf4dd43,1,Roger Meier,2014-03-19 06:47:47+01:00,['706cb4e4cb7426d25722b1166e0c8b102b20051e'],17,19,36,600802,45,,,,1929
ec8daae71004b3c2346bf12b2d74e52ed0815337,0,jfarrell,2014-03-19 09:50:10-04:00,['16fcad0b25f1200db7ec0add08f827c76bf4dd43'],1,3,4,600806,1,,,,1929
fd62df75fa17d5c2af12302de6cee78ad7405692,1,Jens Geyer,2014-03-20 00:52:55+02:00,['ec8daae71004b3c2346bf12b2d74e52ed0815337'],32,252,284,601090,6,0.710526316,0.815789474,0.789473684,1931
2bf90780d451ca9c6f7a0e2082009a5f409932af,0,Jake Luciani,2014-03-20 10:30:43-04:00,['fd62df75fa17d5c2af12302de6cee78ad7405692'],1,1,2,601092,1,,,,1931
e9651367c550a6dd72b5a67a3e5c487bd299eac8,1,Jens Geyer,2014-03-20 22:48:13+02:00,['2bf90780d451ca9c6f7a0e2082009a5f409932af'],93,304,397,601489,3,,,,1931
3c489f9e7fbef6d3a169fa585b7f244bca1a3be5,1,Jens Geyer,2014-03-20 23:03:48+02:00,['e9651367c550a6dd72b5a67a3e5c487bd299eac8'],1,1,2,601491,1,,,,1931
46f9c45084c3eb1d41103c69cf1f7f23f69bf74c,0,Jens Geyer,2014-03-21 00:42:58+02:00,['3c489f9e7fbef6d3a169fa585b7f244bca1a3be5'],12,12,24,601515,1,,,,1931
932cad8dcc9c7bad95d2100e2f527620a5dca9fd,0,Jens Geyer,2014-03-21 21:37:54+02:00,['46f9c45084c3eb1d41103c69cf1f7f23f69bf74c'],14,26,40,601555,1,0,0,0,1931
e8ca73f62f97fe1cf05425727a9831d14316e4d4,0,Jens Geyer,2014-03-24 21:41:12+02:00,['932cad8dcc9c7bad95d2100e2f527620a5dca9fd'],0,135,135,601690,1,0.424242424,1,0.666666667,1932
443ced0e3a68b3bf61c32466e0f75c5a41abbe47,0,Roger Meier,2014-03-26 23:23:37+01:00,['e8ca73f62f97fe1cf05425727a9831d14316e4d4'],1,1,2,601692,1,,,,1932
bf0b6291f8bc7192847a2da458fdd40ee7256066,1,Roger Meier,2014-03-26 23:32:34+01:00,['443ced0e3a68b3bf61c32466e0f75c5a41abbe47'],18,49,67,601759,9,0.47826087,0,0.652173913,1932
1823b59cedd1bd35e11831f08565b89994a8cbaf,1,jfarrell,2014-03-27 13:56:04-04:00,['bf0b6291f8bc7192847a2da458fdd40ee7256066'],8,9,17,601776,1,0,1,1,1932
d60f9789dbbe5e8fb05815eb01cc5213f811ea9b,1,Randy Abernethy,2014-03-28 10:36:38-07:00,['1823b59cedd1bd35e11831f08565b89994a8cbaf'],608,220,828,602604,11,0,0,0.132596685,1932
ea6076f1750fecf2f2bd0a9fa4747f916588427b,0,Jens Geyer,2014-03-28 22:45:27+02:00,['d60f9789dbbe5e8fb05815eb01cc5213f811ea9b'],17,20,37,602641,2,,,,1932
a2e4e565983d247fbcf634a52ddb85cec872e96f,0,ra,2014-03-29 01:14:48-07:00,['ea6076f1750fecf2f2bd0a9fa4747f916588427b'],505,497,1002,603643,7,,,,1932
8384351c9a6568ab8cd3614b6f9a46f1c43c1e9d,1,Roger Meier,2014-03-30 19:36:25+02:00,['a2e4e565983d247fbcf634a52ddb85cec872e96f'],1,1,2,603645,1,,,,1932
d7902bf19d0c323f38706c02338bbe2442f483c3,1,henrique,2014-03-31 16:21:37+02:00,['8384351c9a6568ab8cd3614b6f9a46f1c43c1e9d'],25,190,215,603860,4,0,0.94,0.34,1934
d21032ad409d54aea30a78be2e3eaa04e9bda231,0,Jens Geyer,2014-03-31 19:21:27+02:00,['d7902bf19d0c323f38706c02338bbe2442f483c3'],1,1,2,603862,1,,,,1934
86653cc388159ed1a83a7cb636c6dbc6a89ed9fe,0,Roger Meier,2014-03-31 19:49:53+02:00,['d21032ad409d54aea30a78be2e3eaa04e9bda231'],2,2,4,603866,1,,,,1934
d5cd81f46f3fa8d5e5eac747b146f57931eedb4e,0,jfarrell,2014-03-31 22:30:54-04:00,['86653cc388159ed1a83a7cb636c6dbc6a89ed9fe'],0,20,20,603886,1,,,,1935
7b021bb13b054fce3731bb340ded51bd9607c210,1,jfarrell,2014-03-31 23:34:46-04:00,['d5cd81f46f3fa8d5e5eac747b146f57931eedb4e'],9,9,18,603904,1,,,,1935
02c95c1c4008e72592251c85f8ce68b8b09ad77f,1,jfarrell,2014-03-31 23:58:32-04:00,['7b021bb13b054fce3731bb340ded51bd9607c210'],6,49,55,603959,2,0,0,1,1935
8001421b88f4322d11f32686a9ba770d2c99cd97,0,Jens Geyer,2014-04-01 21:24:27+02:00,['02c95c1c4008e72592251c85f8ce68b8b09ad77f'],0,1,1,603960,1,,,,1935
5d1521225bb2a484d1f8cb395dc7f779e63f8bb0,1,Jens Geyer,2014-04-01 21:27:58+02:00,['8001421b88f4322d11f32686a9ba770d2c99cd97'],13,35,48,604008,1,0,0,0.923076923,1935
a139c9175293040d75f78d5f589b283469644845,0,henrique,2014-04-02 14:45:39+02:00,['5d1521225bb2a484d1f8cb395dc7f779e63f8bb0'],7,8,15,604023,1,,,,1935
7f76e1d9f41c2b324573ada383eef00cb4b342a5,0,ra,2014-04-02 12:31:05-07:00,['a139c9175293040d75f78d5f589b283469644845'],3,10,13,604036,1,0,0,1,1935
d06957bf914a025fbf65d7625e1edc78c4bc11ef,1,Jens Geyer,2014-04-02 23:21:25+02:00,['7f76e1d9f41c2b324573ada383eef00cb4b342a5'],4,4,8,604044,1,,,,1935
1be80dce36a8dcefe6851428949409898f7415ff,0,ra,2014-04-03 09:02:30-07:00,['d06957bf914a025fbf65d7625e1edc78c4bc11ef'],0,3,3,604047,1,1,1,1,1935
161ffe708f4aef67a60a03dec9988c74693cf290,0,ra,2014-04-04 07:14:17-07:00,['1be80dce36a8dcefe6851428949409898f7415ff'],1,1,2,604049,1,,,,1935
6b1027183c95981c8834faf91ba3b161b29a6d76,1,jfarrell,2014-04-04 11:34:42-04:00,['161ffe708f4aef67a60a03dec9988c74693cf290'],73,128,201,604250,9,1,1,0.970588235,1935
9f154150b7c52ab2d63dc978782b363a21f4dadb,1,jfarrell,2014-04-04 11:41:15-04:00,['6b1027183c95981c8834faf91ba3b161b29a6d76'],9,385,394,604644,6,0.108910891,0.306930693,1,1939
607355e1deba2072c262f91e8e3554e2e552a20a,1,jfarrell,2014-04-04 12:07:25-04:00,['9f154150b7c52ab2d63dc978782b363a21f4dadb'],11,76,87,604731,3,0.545454545,0.545454545,1,1940
bdbf428365144dc8586276d42c071b44c389e4ff,1,jfarrell,2014-04-04 13:09:32-04:00,['607355e1deba2072c262f91e8e3554e2e552a20a'],1,3,4,604735,1,1,1,1,1940
6cf0ffcec969e4a983171a5f411506b2ed0fd2c1,1,Roger Meier,2014-04-05 00:50:35+02:00,['bdbf428365144dc8586276d42c071b44c389e4ff'],1,4258,4259,608994,24,0.46357362,0.675613497,0.75345092,1960
347a5ebb2d16c52e523e4b1b96ce804ef18585f2,0,jfarrell,2014-04-05 12:20:07-04:00,['6cf0ffcec969e4a983171a5f411506b2ed0fd2c1'],0,112,112,609106,7,,,,1962
bb2d2fbf63cac4d2eb46c73d1f3e5c8ceeba5d1e,0,jfarrell,2014-04-05 12:25:07-04:00,['347a5ebb2d16c52e523e4b1b96ce804ef18585f2'],0,0,0,609106,2,,,,1962
456879288f4915f53fa23b9a72148696da0c5d24,1,Jens Geyer,2014-04-07 21:22:01+02:00,['bb2d2fbf63cac4d2eb46c73d1f3e5c8ceeba5d1e'],8,44,52,609158,3,1,1,1,1964
a6415bc985ec66715048755b667000cacc1447c4,1,Roger Meier,2014-04-07 23:45:19+02:00,['456879288f4915f53fa23b9a72148696da0c5d24'],297,326,623,609781,16,,,,1964
5829a2c64a47bb122a4c7e6ddf93acd6b41dfd7d,0,Roger Meier,2014-04-08 00:28:17+02:00,['a6415bc985ec66715048755b667000cacc1447c4'],1,1,2,609783,1,,,,1964
bea3144a456a635c7a2e84c92277c5ad27f892d6,0,Roger Meier,2014-04-08 23:52:01+02:00,['5829a2c64a47bb122a4c7e6ddf93acd6b41dfd7d'],2,11,13,609796,2,0,0,1,1964
e0e831683897ea4b786eebabd0cea77659d77150,1,jfarrell,2014-04-08 22:45:01-04:00,['bea3144a456a635c7a2e84c92277c5ad27f892d6'],48,648,696,610492,13,0.114130435,0.755434783,0.885869565,1968
524b924f615c9227d1fe5ae8db24e7e0707c15ff,1,jfarrell,2014-04-09 14:55:54-04:00,['e0e831683897ea4b786eebabd0cea77659d77150'],272,34,306,610798,2,0,0.285714286,0,1968
bcc0f1aa732974aaf14a88b5ba1e180c66440949,0,henrique,2014-04-09 20:57:17+02:00,['524b924f615c9227d1fe5ae8db24e7e0707c15ff'],25,27,52,610850,2,,,,1968
c02618cabc993cedf367363dcd63798c1823a238,0,Jens Geyer,2014-04-10 01:17:56+02:00,['bcc0f1aa732974aaf14a88b5ba1e180c66440949'],2,2,4,610854,1,,,,1968
8b1799f3ae32f299cdff2f869aa6e568c95c6c40,0,jfarrell,2014-04-10 22:06:11-04:00,['c02618cabc993cedf367363dcd63798c1823a238'],1,1,2,610856,1,,,,1968
26c68ea149e33f77b1e3cbfba9921c8ccdb6a30b,1,jfarrell,2014-04-11 00:15:16-04:00,['8b1799f3ae32f299cdff2f869aa6e568c95c6c40'],63,11,74,610930,1,1,1,1,1968
645c420b64fac217694e616d0cce6ceed4620177,1,Roger Meier,2014-04-11 20:25:46+02:00,['26c68ea149e33f77b1e3cbfba9921c8ccdb6a30b'],0,30,30,610960,1,,,,1969
d000b241a43e50157938e056b9fa0f7d88f099df,0,Jens Geyer,2014-04-13 21:59:51+02:00,['645c420b64fac217694e616d0cce6ceed4620177'],13,50,63,611023,3,0.535714286,0.571428571,0.428571429,1969
c2ccca8e4b4fd1b421e2d30b754aee8c24e90b34,1,Jens Geyer,2014-04-14 22:36:50+02:00,['d000b241a43e50157938e056b9fa0f7d88f099df'],91,158,249,611272,4,0.698412698,0.698412698,1,1971
a6c63deb065a3fb211ab977252c69e872b129659,0,Jens Geyer,2014-04-14 22:42:01+02:00,['c2ccca8e4b4fd1b421e2d30b754aee8c24e90b34'],0,19,19,611291,1,,,,1971
2335b96039f22fdffa7575cf0e311a0dde416a7d,0,Jens Geyer,2014-04-14 22:42:25+02:00,['a6c63deb065a3fb211ab977252c69e872b129659'],0,19,19,611310,1,,,,1971
2f75e2daa3af5f2ee899a3e57166c54bbe0499e3,1,Jens Geyer,2014-04-15 21:14:04+02:00,['2335b96039f22fdffa7575cf0e311a0dde416a7d'],12,15,27,611337,3,,,,1971
703200c9d086f25e293269445d73e1bee8d067ee,0,Jens Geyer,2014-04-15 21:54:55+02:00,['2f75e2daa3af5f2ee899a3e57166c54bbe0499e3'],3,122,125,611462,6,,,,1971
20bcf38be4a3af261998a7c8e396918795eb564a,1,Jens Geyer,2014-04-16 00:27:31+02:00,['703200c9d086f25e293269445d73e1bee8d067ee'],1,42,43,611505,3,,,,1971
057be5a9bd32e3571577edeab1aa0ea7c50087d6,0,Jens Geyer,2014-04-16 22:43:08+02:00,['20bcf38be4a3af261998a7c8e396918795eb564a'],14,7,21,611526,1,1,0,0,1971
0608c6356d945d2e8acc9cf17081878373748599,1,jfarrell,2014-04-16 22:17:55-04:00,['057be5a9bd32e3571577edeab1aa0ea7c50087d6'],0,16,16,611542,1,,,,1972
188024e4b2a647d140d3861ca0b4f28c7d45ac1e,0,Roger Meier,2014-04-17 21:53:45+02:00,['0608c6356d945d2e8acc9cf17081878373748599'],4,4,8,611550,1,,,,1972
e8c51ed9c8d77a80dd5f2a65b733810b560ed90e,0,Jens Geyer,2014-04-18 02:27:57+02:00,['188024e4b2a647d140d3861ca0b4f28c7d45ac1e'],1,1,2,611552,1,,,,1972
a131b8f92c2b2386126353d08d2c285e0861e0da,0,Jens Geyer,2014-04-18 19:46:17+02:00,['e8c51ed9c8d77a80dd5f2a65b733810b560ed90e'],6,8,14,611566,3,1,1,1,1972
ab2793aa966d3a40a89fe4b392d3cc286721f36d,0,Roger Meier,2014-04-21 21:20:00+02:00,['a131b8f92c2b2386126353d08d2c285e0861e0da'],0,10,10,611576,2,0,0,1,1972
9b328531122ae241ed52622b9356014fd8aa8a6a,1,Roger Meier,2014-04-21 21:22:54+02:00,['ab2793aa966d3a40a89fe4b392d3cc286721f36d'],14,34,48,611624,1,0.352941176,0.352941176,0.352941176,1972
7201c0d38ffb1505fdddcc9b65b16621f7e493c3,1,ra,2014-04-22 06:37:37-07:00,['9b328531122ae241ed52622b9356014fd8aa8a6a'],47,75,122,611746,3,0.421052632,0,0.263157895,1972
c1d7943a7ed78fb434eaa90feb1a3a17b446fc97,1,Jens Geyer,2014-04-22 22:52:43+02:00,['7201c0d38ffb1505fdddcc9b65b16621f7e493c3'],18,569,587,612333,8,0.398268398,0.766233766,0.761904762,1974
751c97c2df228ab7d73f7add3a7b3f187aa5326a,1,Jens Geyer,2014-04-22 23:36:27+02:00,['c1d7943a7ed78fb434eaa90feb1a3a17b446fc97'],0,361,361,612694,4,0.647798742,0.855345912,0.937106918,1977
8f697cb6499997584c82cc03daeda667847e5bfe,1,ra,2014-04-23 02:23:18-07:00,['751c97c2df228ab7d73f7add3a7b3f187aa5326a'],6,326,332,613026,6,0.537735849,0.537735849,0.79245283,1980
779b9ac2eff8605836a7a08151b844601dffcf53,1,ra,2014-04-23 20:04:23-07:00,['8f697cb6499997584c82cc03daeda667847e5bfe'],49,215,264,613290,17,0.666666667,0.666666667,0.766666667,1983
3290336e33a257d77d731aa8f4c86af84bd8f9ad,0,Jens Geyer,2014-04-27 18:30:40+02:00,['779b9ac2eff8605836a7a08151b844601dffcf53'],1,1,2,613292,1,,,,1983
2bc4b130dead8fdd664be332e16b2b7eb3e809d7,1,henrique,2014-04-30 16:19:35+02:00,['3290336e33a257d77d731aa8f4c86af84bd8f9ad'],16,10,26,613318,1,,,,1983
d17f1c98e64e6392a981308516eca5f489c27c57,0,henrique,2014-04-30 16:36:31+02:00,['2bc4b130dead8fdd664be332e16b2b7eb3e809d7'],47,60,107,613425,3,,,,1983
d5aba4c13b808156b17959f955c194d938a61227,0,henrique,2014-04-30 18:11:11+02:00,['d17f1c98e64e6392a981308516eca5f489c27c57'],23,23,46,613471,1,,,,1983
4920a65a094f5b10cbed0f21e64cb448835d2023,0,henrique,2014-04-30 18:16:20+02:00,['d5aba4c13b808156b17959f955c194d938a61227'],0,0,0,613471,3,,,,1983
ce79d59144fb5eabba67a28db76580fdb4f6bb89,0,henrique,2014-05-01 15:22:38+02:00,['4920a65a094f5b10cbed0f21e64cb448835d2023'],1,1,2,613473,1,,,,1983
731975a645e47c931fbbc42ac51c12b0873a50c2,1,Jens Geyer,2014-05-02 00:24:24+02:00,['ce79d59144fb5eabba67a28db76580fdb4f6bb89'],187,1326,1513,614986,9,0.607344633,0.717514124,0.895480226,1989
0997250744112ec0519d5f67cda92b2b87fb0063,1,Jens Geyer,2014-05-02 01:35:24+02:00,['731975a645e47c931fbbc42ac51c12b0873a50c2'],205,758,963,615949,12,0.933333333,1,0.990123457,1992
4edac7ff085e4bd28096fef3cf8234e4991544ff,0,Roger Meier,2014-05-02 21:07:01+02:00,['0997250744112ec0519d5f67cda92b2b87fb0063'],11,17,28,615977,2,,,,1992
0a7c69cfe643fde10df27f6ddf24a67d36f8fb12,0,Roger Meier,2014-05-02 21:15:45+02:00,['4edac7ff085e4bd28096fef3cf8234e4991544ff'],23,58,81,616058,4,1,1,1,1993
885c6791235e011794a0b65c00f1d9fdf3d233e3,1,Jens Geyer,2014-05-02 21:31:55+02:00,['0a7c69cfe643fde10df27f6ddf24a67d36f8fb12'],73,109,182,616240,8,1,0.461538462,0.384615385,1993
2a9e6a491e2c6e97bd35f715f39788582eb8b027,0,Jens Geyer,2014-05-02 22:23:15+02:00,['885c6791235e011794a0b65c00f1d9fdf3d233e3'],65,50,115,616355,2,1,1,0,1993
e52c046cb62d1f910302148f7bc2091c014acd27,1,Jens Geyer,2014-05-02 23:37:39+02:00,['2a9e6a491e2c6e97bd35f715f39788582eb8b027'],42,49,91,616446,9,0,1,1,1993
89847dfaa014bb17bc68ca1167d3b295c5d3a357,0,Jens Geyer,2014-05-02 23:50:04+02:00,['e52c046cb62d1f910302148f7bc2091c014acd27'],3,17,20,616466,2,,,,1993
72e9c375175ff05a9b9cd61c9937db0bd48742ac,0,Roger Meier,2014-05-03 00:33:46+02:00,['89847dfaa014bb17bc68ca1167d3b295c5d3a357'],1,1,2,616468,1,,,,1993
6d1a83aa485ed9c3644d3200555700070547bf90,0,Jens Geyer,2014-05-03 00:49:05+02:00,['72e9c375175ff05a9b9cd61c9937db0bd48742ac'],8,31,39,616507,15,,,,1993
879cab2cea799625635d861f5beb89039da5f38c,1,Roger Meier,2014-05-03 17:51:21+02:00,['6d1a83aa485ed9c3644d3200555700070547bf90'],5,174,179,616686,5,0.652173913,0.637681159,0.405797101,1996
40f8ce2b4dd270d56ae39a4638f4a05bbdeb83d4,1,Roger Meier,2014-05-04 21:48:48+02:00,['879cab2cea799625635d861f5beb89039da5f38c'],0,18,18,616704,1,0,1,1,1996
cf0edd365909ae3cc1b6afb12ed69ff6c4e8a147,0,Roger Meier,2014-05-04 21:52:36+02:00,['40f8ce2b4dd270d56ae39a4638f4a05bbdeb83d4'],0,3,3,616707,1,0,1,0,1996
1953e21a373c2bfd9e8a0804b71297039319021c,0,Roger Meier,2014-05-04 22:02:17+02:00,['cf0edd365909ae3cc1b6afb12ed69ff6c4e8a147'],1,1,2,616709,1,,,,1996
5c80b56573bbe217034c6ba5a425d9e78507a93a,1,Roger Meier,2014-05-04 22:19:46+02:00,['1953e21a373c2bfd9e8a0804b71297039319021c'],31,112,143,616852,2,0,0.363636364,0.945454545,1996
6370cfdd7a84fbece58fd1bf6547570d3c8880db,0,Roger Meier,2014-05-04 22:21:58+02:00,['5c80b56573bbe217034c6ba5a425d9e78507a93a'],261,216,477,617329,3,,,,1996
4fba9d2c3c57684950ffe70979de77bb18973d05,0,Roger Meier,2014-05-04 22:34:44+02:00,['6370cfdd7a84fbece58fd1bf6547570d3c8880db'],99,104,203,617532,1,,,,1996
2c60625b53be953e40729eff8cee4291d4b20db8,0,Roger Meier,2014-05-04 22:56:44+02:00,['4fba9d2c3c57684950ffe70979de77bb18973d05'],1,0,1,617533,1,,,,1996
37042270ef670aad7b11c94e31bafc9d84092d76,0,Roger Meier,2014-05-04 22:58:15+02:00,['2c60625b53be953e40729eff8cee4291d4b20db8'],1,0,1,617534,1,,,,1996
c0ad3684863649a02a53ec7e462af248acaf1bd7,0,Jens Geyer,2014-05-08 22:31:34+02:00,['37042270ef670aad7b11c94e31bafc9d84092d76'],9,24,33,617567,1,0.833333333,0.833333333,1,1996
f459868f939e702eb71cdb6202d1d725e3132c89,1,Jens Geyer,2014-05-08 23:18:44+02:00,['c0ad3684863649a02a53ec7e462af248acaf1bd7'],50,2200,2250,619817,16,0.519345238,0.572916667,0.743303571,2007
9c929c8979fab8d883b83df87034ed81373effb5,0,Roger Meier,2014-05-09 22:37:51+02:00,['ff980c1432936c6bc897c60469ab05b5e0c6cb5e'],0,25,25,619842,1,,,,2008
958581d090d13cfc23162eb823f5ac6af36a8cb1,0,Jens Geyer,2014-05-09 23:35:24+02:00,['f459868f939e702eb71cdb6202d1d725e3132c89'],1,1,2,619844,1,,,,2008
facc8dc6c77b4bdb38e403306e9d9824cd420537,0,Jens Geyer,2014-05-09 23:48:57+02:00,['958581d090d13cfc23162eb823f5ac6af36a8cb1'],6,43,49,619893,3,1,1,1,2009
20aeba3e384f6590770dc3b4343e6d5dfcbd3ce1,1,ra,2014-05-11 00:25:01-07:00,['facc8dc6c77b4bdb38e403306e9d9824cd420537'],198,998,1196,621089,10,0.536842105,0.606315789,0.924210526,2009
73b58a24699eb6b9d43ad05f8a19cd084979c31a,1,Roger Meier,2014-05-11 17:39:34+02:00,['20aeba3e384f6590770dc3b4343e6d5dfcbd3ce1'],175,240,415,621504,2,,,,2009
303eb1b4f0ada3b6be45625beb6020a757a2f429,1,Roger Meier,2014-05-14 00:49:41+02:00,['73b58a24699eb6b9d43ad05f8a19cd084979c31a'],23,111,134,621638,9,,,,2011
816790b18d13f91efa807ce941ac0b56cd20e569,0,jfarrell,2014-05-15 23:25:46-04:00,['303eb1b4f0ada3b6be45625beb6020a757a2f429'],2,21,23,621661,1,1,1,1,2011
cc0fe274c03add48d00f604896bb7b3745ac9e55,0,Roger Meier,2014-05-16 23:18:25+02:00,['816790b18d13f91efa807ce941ac0b56cd20e569'],4,93,97,621758,1,,,,2011
b7cb9457dcb486f34443a429f7686acf2a2d1dbb,0,Jens Geyer,2014-05-17 00:38:06+02:00,['cc0fe274c03add48d00f604896bb7b3745ac9e55'],3,3,6,621764,1,,,,2011
91cfb9901ebd6d584b0055bff5f91c372875a276,1,Jens Geyer,2014-05-17 01:07:28+02:00,['b7cb9457dcb486f34443a429f7686acf2a2d1dbb'],9,57,66,621830,4,0,0.325,1,2011
6ff1dfb3af52a7df0e6705c9dc9eea8d10e47316,0,Jens Geyer,2014-05-17 01:20:32+02:00,['91cfb9901ebd6d584b0055bff5f91c372875a276'],3,0,3,621833,1,,,,2011
a47cf906ab060e7f6520d0eb8e5703008183f219,0,Jens Geyer,2014-05-17 01:54:09+02:00,['6ff1dfb3af52a7df0e6705c9dc9eea8d10e47316'],0,1,1,621834,1,,,,2011
ada1016fdd6408694f9b82d5de8c1fbbf8d8a528,1,Pascal Schweizer,2014-05-19 17:21:34+02:00,['a47cf906ab060e7f6520d0eb8e5703008183f219'],19,993,1012,622846,2,0.025252525,0,0.878787879,2012
d0265c705271716c046dd33d14adf40464cdcea8,1,henrique,2014-05-19 19:31:09+02:00,['ada1016fdd6408694f9b82d5de8c1fbbf8d8a528'],4,15,19,622865,2,,,,2012
4f073d8af4c7358f6956ff8f8f6eb0f227a6a695,0,henrique,2014-05-19 21:59:39+02:00,['d0265c705271716c046dd33d14adf40464cdcea8'],18,18,36,622901,1,,,,2012
ad4df16579b63a66ab95f9a01d3eb9cd1b352ebc,0,henrique,2014-05-20 13:18:45+02:00,['4f073d8af4c7358f6956ff8f8f6eb0f227a6a695'],9,6,15,622916,2,,,,2012
c62798bb6e6128fed9301bd5864a79d2a052f601,0,Roger Meier,2014-05-23 12:54:08+02:00,['ad4df16579b63a66ab95f9a01d3eb9cd1b352ebc'],1,1,2,622918,1,,,,2012
d9b331d2662ff8bbd14f04800ce5de56b21ba01a,0,Roger Meier,2014-05-25 22:59:17+02:00,['c62798bb6e6128fed9301bd5864a79d2a052f601'],1,17,18,622936,1,,,,2012
f64d7e07dec0e41cbf85ef0dc1f57f1a210dc848,1,Jens Geyer,2014-05-26 23:34:35+02:00,['d9b331d2662ff8bbd14f04800ce5de56b21ba01a'],1,395,396,623332,2,0.446601942,0.825242718,0.762135922,2013
8fcc82ba704602d6889b1effe8aebfa1a2c90b72,0,Jens Geyer,2014-05-26 23:39:47+02:00,['f64d7e07dec0e41cbf85ef0dc1f57f1a210dc848'],0,1,1,623333,1,,,,2013
5c6ad2427c67023a67e873d2e389838394053272,0,Roger Meier,2014-05-27 21:18:00+02:00,['8fcc82ba704602d6889b1effe8aebfa1a2c90b72'],0,33,33,623366,1,,,,2013
0cf802a366f8ad315665194d406fd2d59df5ac34,0,Jens Geyer,2014-05-27 23:10:11+02:00,['8fcc82ba704602d6889b1effe8aebfa1a2c90b72'],0,2,2,623368,1,,,,2013
44460e2e7a79c0e06bb473379c161353bc733cf8,0,Roger Meier,2014-05-27 23:57:38+02:00,"['5c6ad2427c67023a67e873d2e389838394053272', '0cf802a366f8ad315665194d406fd2d59df5ac34']",0,2,2,623370,1,,,,2013
f8c1c989f2116ef8cecb85dcf16657c04fc27435,0,Roger Meier,2014-05-28 00:04:32+02:00,['44460e2e7a79c0e06bb473379c161353bc733cf8'],3,23,26,623396,2,,,,2013
97243a73eab86b634540756f72be1c500cfeea6c,1,Roger Meier,2014-05-28 14:19:09+02:00,['f8c1c989f2116ef8cecb85dcf16657c04fc27435'],54,101,155,623551,13,0.325581395,0.325581395,1,2013
4b0fede142950c31ac04460221021ebc2800c0db,0,Jens Geyer,2014-05-28 22:35:15+02:00,['97243a73eab86b634540756f72be1c500cfeea6c'],10,10,20,623571,1,,,,2013
72268b78a39fb035a13bbe552774099d44b1c0de,0,Roger Meier,2014-05-28 23:08:09+02:00,['4b0fede142950c31ac04460221021ebc2800c0db'],36,118,154,623725,1,,,,2013
80a44f84fb161d77bf53261d024489df0aa7589c,0,Roger Meier,2014-05-29 16:25:22+02:00,['72268b78a39fb035a13bbe552774099d44b1c0de'],0,10,10,623735,1,0,0,1,2013
7ca13f5507af5c67e0e93a2774f2b122374e0276,0,Roger Meier,2014-05-29 22:40:32+02:00,['80a44f84fb161d77bf53261d024489df0aa7589c'],0,11,11,623746,1,0,1,1,2013
e86428c6b0a278c070038b8c0182ceccc60196d5,1,Roger Meier,2014-05-30 00:17:12+02:00,['7ca13f5507af5c67e0e93a2774f2b122374e0276'],3,37,40,623786,4,0,0,0.882352941,2013
5c976038f9876198de0e4e5fa91029eda0c33264,1,Roger Meier,2014-05-30 00:18:50+02:00,['e86428c6b0a278c070038b8c0182ceccc60196d5'],0,49,49,623835,1,1,1,1,2014
6848de85b8bc94910842fc4c4bfa72c250d4b7ab,0,Roger Meier,2014-05-30 03:03:09+02:00,['5c976038f9876198de0e4e5fa91029eda0c33264'],1,1,2,623837,1,,,,2014
e9f00cbe64afac087c01dad7dee2fe90402d9218,1,Roger Meier,2014-05-30 14:40:36+02:00,['6848de85b8bc94910842fc4c4bfa72c250d4b7ab'],8,296,304,624141,6,,,,2019
73464acebf22b770cef752c91ae5d13dbce236e5,0,Roger Meier,2014-05-30 14:53:22+02:00,['e9f00cbe64afac087c01dad7dee2fe90402d9218'],18,0,18,624159,4,,,,2019
91b3b1a6b204b381d6ccea1016b6900667ac1a6c,1,ra,2014-05-30 06:31:00-07:00,['73464acebf22b770cef752c91ae5d13dbce236e5'],4,20,24,624183,1,0,0,0,2019
eb1e1d5567cabe4a4f7f58c380f651325cdba77e,1,Jens Geyer,2014-05-30 17:53:45+02:00,['91b3b1a6b204b381d6ccea1016b6900667ac1a6c'],3,10,13,624196,1,0,0,0,2019
5588a569d5a08c23dca8d770dfe87892f950deb8,0,Jens Geyer,2014-05-30 17:53:47+02:00,['eb1e1d5567cabe4a4f7f58c380f651325cdba77e'],2,2,4,624200,1,,,,2019
76150722af2751768411573b9fbbed163f4f55db,0,Roger Meier,2014-05-31 22:22:07+02:00,['5588a569d5a08c23dca8d770dfe87892f950deb8'],37,150,187,624387,4,0,0,0.6,2019
a3350b48eade40903b4cb7986301fafa8297fb16,0,Jens Geyer,2014-05-31 22:32:18+02:00,['76150722af2751768411573b9fbbed163f4f55db'],32,21,53,624440,8,0,1,1,2019
cf18e91831507f20ac777262174288d64e3f5bbe,0,Jens Geyer,2014-05-31 22:58:15+02:00,['a3350b48eade40903b4cb7986301fafa8297fb16'],1,1,2,624442,1,,,,2019
245dbdfd1150d844a26fbb5cdeb6348028b3145c,0,henrique,2014-06-04 18:14:39+02:00,['cf18e91831507f20ac777262174288d64e3f5bbe'],1,3,4,624446,2,,,,2019
7b11fec0c53b3231a472e008dfbb285d1aac44df,0,Jens Geyer,2014-06-05 22:03:19+02:00,['245dbdfd1150d844a26fbb5cdeb6348028b3145c'],6,22,28,624474,1,0.125,1,0.875,2019
27b57834e2f1308c2b009dac710d83f4c0f027b9,0,Roger Meier,2014-06-09 22:37:42+02:00,['7b11fec0c53b3231a472e008dfbb285d1aac44df'],0,1,1,624475,1,,,,2019
faf52db2160df39289550cb6ba714adc47c395cf,0,Roger Meier,2014-06-09 22:41:06+02:00,['27b57834e2f1308c2b009dac710d83f4c0f027b9'],23,71,94,624569,4,,,,2020
6eb015aa555ba120c156e21a8a9ecff15589c7b0,1,one,2014-06-10 13:33:58+02:00,['faf52db2160df39289550cb6ba714adc47c395cf'],0,165,165,624734,2,,,,2021
42be4e818ada259080811a87fb239fa81222f581,0,one,2014-06-10 13:33:58+02:00,['6eb015aa555ba120c156e21a8a9ecff15589c7b0'],6,13,19,624753,1,,,,2021
569863a1385c38eb937662aa655db1c3fb0819fe,1,Pascal Bach,2014-06-10 13:44:02+02:00,['42be4e818ada259080811a87fb239fa81222f581'],2,22,24,624777,3,,,,2022
48b189716f7611a73e9a2d9b4e2f3989c101740f,0,henrique,2014-06-10 15:19:55+02:00,['faf52db2160df39289550cb6ba714adc47c395cf'],8,7,15,624792,3,,,,2022
a3570ac36716d0313e2c1c6143cfffc5ddae8fec,1,Roger Meier,2014-06-10 22:16:14+02:00,['48b189716f7611a73e9a2d9b4e2f3989c101740f'],686,488,1174,625966,8,0.107843137,0,0,2023
bbac92453b4e89fe097a13bf5a1e358dab60b0bd,0,henrique,2014-06-11 09:28:17+02:00,"['a3570ac36716d0313e2c1c6143cfffc5ddae8fec', '569863a1385c38eb937662aa655db1c3fb0819fe']",0,192,192,626158,4,,,,2023
40cc23269da6880d83dce17ff05a545d16fd787c,1,Roger Meier,2014-06-11 11:09:14+02:00,['bbac92453b4e89fe097a13bf5a1e358dab60b0bd'],0,218,218,626376,2,0.13559322,0.13559322,0.13559322,2025
cd9dd515bb2bc49459af1114c40f020c96e87b41,0,Roger Meier,2014-06-11 14:15:21+02:00,['40cc23269da6880d83dce17ff05a545d16fd787c'],70,182,252,626628,2,0.731343284,1,0.76119403,2025
746952efc182d0b391539aeaec96a0cc6183bd40,1,Roger Meier,2014-06-14 21:59:24+02:00,['cd9dd515bb2bc49459af1114c40f020c96e87b41'],38,37,75,626703,2,,,,2025
63fcb7e756a88adca994111e1d9bc0c3c5186c36,0,Roger Meier,2014-06-15 21:51:32+02:00,['746952efc182d0b391539aeaec96a0cc6183bd40'],10,96,106,626809,7,0.75,0.75,0.75,2028
db372ac2489b690d2e7675f85e479105446a1da1,0,Roger Meier,2014-06-16 07:32:12+02:00,['63fcb7e756a88adca994111e1d9bc0c3c5186c36'],2,2,4,626813,1,,,,2028
44c9b4411aac88638797fe37279e632a6799b510,1,Randy Abernethy,2014-06-16 21:15:23-07:00,['db372ac2489b690d2e7675f85e479105446a1da1'],0,7,7,626820,1,0,0,1,2028
55087a49d335db7da23e23d8d8a9368e4e5ae7a6,1,henrique,2014-06-17 12:36:39+02:00,['44c9b4411aac88638797fe37279e632a6799b510'],7,37,44,626864,2,,,,2028
32f3982275882b2886dd9cbde2d49b99b8ed1f5f,1,Roger Meier,2014-06-18 22:43:17+02:00,['55087a49d335db7da23e23d8d8a9368e4e5ae7a6'],30,164,194,627058,6,0.5,0.5,0.5,2028
329d59aab0543171d0af193837db5fec714e0a73,1,Jens Geyer,2014-06-19 22:11:53+02:00,['32f3982275882b2886dd9cbde2d49b99b8ed1f5f'],4,109,113,627171,2,0.302325581,0.302325581,1,2028
c0d126fcafe215b40a83c779751d97192f9d10b1,1,Jens Geyer,2014-06-19 22:49:54+02:00,['329d59aab0543171d0af193837db5fec714e0a73'],2,75,77,627248,4,0.761904762,0.761904762,0.761904762,2030
104ecb658919afb506c58092d2dadfeb503e2286,0,Jens Geyer,2014-06-19 23:25:50+02:00,['c0d126fcafe215b40a83c779751d97192f9d10b1'],1,1,2,627250,1,,,,2030
ebddd933d1d4c28f6a214d0dab450a30c135c798,1,Jens Geyer,2014-06-22 19:06:51+02:00,['104ecb658919afb506c58092d2dadfeb503e2286'],28,157,185,627435,1,0.070175439,0.973684211,1,2030
9999f5295e0c70443a5a5e5f206c87797cae56b0,0,Jens Geyer,2014-06-22 19:09:06+02:00,['ebddd933d1d4c28f6a214d0dab450a30c135c798'],1,1,2,627437,1,,,,2030
bd05f9e06c594683c650feabf240b24834a29c5a,0,Jens Geyer,2014-06-22 19:47:52+02:00,['9999f5295e0c70443a5a5e5f206c87797cae56b0'],8,24,32,627469,1,0,0,0.5625,2030
ad67aa0acf0bb75ceb650e61626e9f51cb28549f,0,henrique,2014-06-24 15:45:41+02:00,['bd05f9e06c594683c650feabf240b24834a29c5a'],2,8,10,627479,2,0.833333333,1,1,2030
d5acf051b5836b5817096c217c2cda2cdb796ac4,0,Henrique Mendonça,2014-06-24 16:06:32+02:00,['ad67aa0acf0bb75ceb650e61626e9f51cb28549f'],7,11,18,627497,1,,,,2030
58993d120578ce36fb88f7af06c06d2eba213b65,1,henrique,2014-06-24 16:08:22+02:00,['ad67aa0acf0bb75ceb650e61626e9f51cb28549f'],41,55,96,627593,5,0,1,,2030
cf9d968a89a42c6a7738449f3594af48cb86281a,0,henrique,2014-06-24 16:11:26+02:00,"['58993d120578ce36fb88f7af06c06d2eba213b65', 'd5acf051b5836b5817096c217c2cda2cdb796ac4']",7,11,18,627611,1,,,,2030
ff296c8841d78dff9213342b21def57029ea83e7,1,Jens Geyer,2014-06-24 21:06:58+02:00,['cf9d968a89a42c6a7738449f3594af48cb86281a'],0,5,5,627616,3,,,,2030
c9bdd50270d2eb60488ef38c56f990b781bbb3d2,0,henrique,2014-06-25 13:13:23+02:00,['ff296c8841d78dff9213342b21def57029ea83e7'],2,23,25,627641,4,1,1,1,2030
bf2617ed15f95e22bcf41fd9d08e7ce562464f46,0,jfarrell,2014-06-26 22:53:01-04:00,['c9bdd50270d2eb60488ef38c56f990b781bbb3d2'],11,219,230,627871,5,0.8,1,0.983333333,2033
7878f11024a0d74ee3c0abfbe8fed1a95440f046,0,David Robakowski,2014-06-28 08:37:21+02:00,['bf2617ed15f95e22bcf41fd9d08e7ce562464f46'],2,8,10,627881,1,0,0,1,2033
35c8b97fbfd277cbb195486e29be17aba714a7b1,0,Roger Meier,2014-06-29 22:53:23+02:00,['7878f11024a0d74ee3c0abfbe8fed1a95440f046'],31,18,49,627930,1,0.785714286,1,0,2033
0cb870bac149094850c6492e30f410254a5274b8,0,jfarrell,2014-06-30 22:45:28-04:00,['35c8b97fbfd277cbb195486e29be17aba714a7b1'],0,135,135,628065,2,,,,2034
9bb4c117aacb38e143b616bd70edb1bf1cbab883,1,Jens Geyer,2014-07-04 00:11:56+02:00,['0cb870bac149094850c6492e30f410254a5274b8'],56,75,131,628196,2,,,,2034
12ee88170a30c025962513b993f8f2c421b5f08c,1,Jens Geyer,2014-07-04 00:12:25+02:00,['9bb4c117aacb38e143b616bd70edb1bf1cbab883'],30,37,67,628263,1,0,0,1,2034
f16daad8d32cf6d0b04e2ce71d890fa080cb68a1,0,Roger Meier,2014-07-04 15:38:20+02:00,['12ee88170a30c025962513b993f8f2c421b5f08c'],0,1,1,628264,1,,,,2034
0dd35a6c4b6e211c0fec867d279cee5172280f4b,0,Roger Meier,2014-07-04 21:28:44+02:00,['f16daad8d32cf6d0b04e2ce71d890fa080cb68a1'],14,11,25,628289,4,0.666666667,0,0.666666667,2034
45abf12f1353e982aea74ac9394438deb8a0a05e,0,Roger Meier,2014-07-04 21:42:32+02:00,['0dd35a6c4b6e211c0fec867d279cee5172280f4b'],0,2,2,628291,1,0,1,0,2034
bc2ca4e5d76486729b5ebc0e5318b822cd87a438,0,Jens Geyer,2014-07-04 21:45:55+02:00,['45abf12f1353e982aea74ac9394438deb8a0a05e'],3,97,100,628391,2,0.242424242,1,1,2035
9a4f40de1949e45d0b4e76f93ba737186b4a474d,0,Jens Geyer,2014-07-04 22:02:21+02:00,['bc2ca4e5d76486729b5ebc0e5318b822cd87a438'],0,3,3,628394,1,,,,2035
41312c7e928ca9f29b1e132114c56c890a60870c,1,Jens Geyer,2014-07-04 22:09:31+02:00,['9a4f40de1949e45d0b4e76f93ba737186b4a474d'],0,9,9,628403,1,,,,2035
81b3a42c936a21c8396b3ba008e7637beae0f1e4,0,Jens Geyer,2014-07-04 22:30:14+02:00,['41312c7e928ca9f29b1e132114c56c890a60870c'],0,8,8,628411,2,,,,2035
f9fbda8f4256602a7965921074f9cf99634b5761,0,Roger Meier,2014-07-06 12:33:38+02:00,['81b3a42c936a21c8396b3ba008e7637beae0f1e4'],2,0,2,628413,1,,,,2035
1a5127b76d54268884397f24ed1566f3caa07ed6,0,Roger Meier,2014-07-07 21:44:30+02:00,['f9fbda8f4256602a7965921074f9cf99634b5761'],1,0,1,628414,1,,,,2035
464a3a44328a290772defe4729b6b52fb2605ddf,0,Roger Meier,2014-07-07 21:48:28+02:00,['1a5127b76d54268884397f24ed1566f3caa07ed6'],0,3,3,628417,1,1,1,1,2035
ca545bd42924878fca866d66fa7a8ecd2f996596,0,Roger Meier,2014-07-07 21:53:04+02:00,['464a3a44328a290772defe4729b6b52fb2605ddf'],1,0,1,628418,1,,,,2035
9a242c02f6bb1d6c851d75d38522527ebdfbc12c,0,Roger Meier,2014-07-07 21:55:27+02:00,['ca545bd42924878fca866d66fa7a8ecd2f996596'],3,1,4,628422,1,0,0,0,2035
2768eb29cebf22f4b225654f61ed1806e0cabb85,0,Roger Meier,2014-07-07 21:56:44+02:00,['9a242c02f6bb1d6c851d75d38522527ebdfbc12c'],6,0,6,628428,1,,,,2035
5f61d29a26b7d3988c0ca7ec3bbac160c0cb7511,0,Roger Meier,2014-07-07 22:02:57+02:00,['2768eb29cebf22f4b225654f61ed1806e0cabb85'],1,1,2,628430,1,,,,2035
f83c0e13b7db684b9cef2a50e1bcc0bfbcef0c9c,0,Roger Meier,2014-07-07 22:06:45+02:00,['5f61d29a26b7d3988c0ca7ec3bbac160c0cb7511'],0,5,5,628435,1,,,,2035
3e50a9a1d01950f356242aaab0cbf5fae778b81c,0,Roger Meier,2014-07-08 07:29:12+02:00,['f83c0e13b7db684b9cef2a50e1bcc0bfbcef0c9c'],15,13,28,628463,2,,,,2035
2e9be756cea30243bc6071d898f37933deaf4f12,1,Roger Meier,2014-07-08 07:46:11+02:00,['3e50a9a1d01950f356242aaab0cbf5fae778b81c'],0,5,5,628468,1,1,1,1,2035
6f86f9ac583a9ce088568fb149f58bf0d88ee549,1,Jens Geyer,2014-07-08 21:31:52+02:00,['2e9be756cea30243bc6071d898f37933deaf4f12'],14,188,202,628670,2,0.376811594,0.376811594,0.507246377,2036
b7af66e1899fcaf66166ef7d5a8ab9fca15ee033,0,Roger Meier,2014-07-08 23:03:08+02:00,['6f86f9ac583a9ce088568fb149f58bf0d88ee549'],1,1,2,628672,1,,,,2036
3f67978103bc7e3faa036c35cf1f6f548d6c61dd,1,Roger Meier,2014-07-09 13:06:26+02:00,['b7af66e1899fcaf66166ef7d5a8ab9fca15ee033'],25,134,159,628831,3,0.636363636,0.636363636,0.636363636,2037
4402adafe95153bac8ae001445abd2e60a5ed6ac,0,jfarrell,2014-07-09 22:22:52-04:00,['3f67978103bc7e3faa036c35cf1f6f548d6c61dd'],1,4,5,628836,1,,,,2037
3e41ece40cc0cb1aea60bc30d84d8110b469727b,1,jfarrell,2014-07-09 23:35:54-04:00,['4402adafe95153bac8ae001445abd2e60a5ed6ac'],13,23,36,628872,1,,,,2037
dbf2bb5c46ffb519186da4c4f13e288becd42ba2,0,jfarrell,2014-07-09 23:37:12-04:00,['3e41ece40cc0cb1aea60bc30d84d8110b469727b'],33,4,37,628909,2,0.538461538,0.538461538,0,2037
b0350dbc40d3bc442f02bbd5980e2c2b5d83194d,0,jfarrell,2014-07-09 23:39:34-04:00,['dbf2bb5c46ffb519186da4c4f13e288becd42ba2'],5,4,9,628918,3,,,,2037
8fd8c6366d99ceeccdbcbbe94e87ae247c8c66f6,1,jfarrell,2014-07-10 09:14:51-04:00,['b0350dbc40d3bc442f02bbd5980e2c2b5d83194d'],60,129,189,629107,22,,,,2037
750df2ec4c039e504673af2449fa2996138ef767,1,jfarrell,2014-07-10 09:18:42-04:00,['8fd8c6366d99ceeccdbcbbe94e87ae247c8c66f6'],2,8,10,629117,3,,,,2037
ef7d56c1d6e24cdd0a24d3ee825c499b917d7dda,0,jfarrell,2014-07-10 09:21:25-04:00,['750df2ec4c039e504673af2449fa2996138ef767'],1,3,4,629121,1,,,,2037
4f54d13e7924424358e401840f985936f9867274,1,jfarrell,2014-07-10 09:23:43-04:00,['ef7d56c1d6e24cdd0a24d3ee825c499b917d7dda'],0,59,59,629180,3,,,,2038
507ba1bb3dc2274ad0387469a3a8b7cb64ec1fa5,0,jfarrell,2014-07-10 12:44:51-04:00,['4f54d13e7924424358e401840f985936f9867274'],682,1176,1858,631038,1,,,,2038
4c8506e30d2eee616ea62b79fc6c3e523a03f294,0,jfarrell,2014-07-10 14:17:49-04:00,['507ba1bb3dc2274ad0387469a3a8b7cb64ec1fa5'],4,1,5,631043,2,,,,2038
30a472e04f26312f93cee0faaaa80a99bb3ed776,0,jfarrell,2014-07-10 18:42:30-04:00,['4c8506e30d2eee616ea62b79fc6c3e523a03f294'],10,13,23,631066,5,,,,2038
cdab7eef751ab26204d644da457f98ce77ad109f,0,Jens Geyer,2014-07-12 12:36:41+02:00,['30a472e04f26312f93cee0faaaa80a99bb3ed776'],1,2,3,631069,1,0,0,1,2038
0e86f1f7748c8a4386af8a817d50e4fe39e6b872,1,Randy Abernethy,2014-07-13 09:50:19-07:00,['cdab7eef751ab26204d644da457f98ce77ad109f'],558,672,1230,632299,8,0.595238095,0,0.904761905,2039
1a3632351ee2e16635962fb133e65a3816ce4c93,0,Jens Geyer,2014-07-14 19:51:36+02:00,['0e86f1f7748c8a4386af8a817d50e4fe39e6b872'],2,25,27,632326,2,0,1,0.3125,2039
3974aaba691cfc3681b71667ddd5c65a3d7e74ac,0,Roger Meier,2014-07-14 20:22:12+02:00,['1a3632351ee2e16635962fb133e65a3816ce4c93'],1,3,4,632330,2,,,,2039
9a93fe07ffd591222e22a7e35cb42549b3d4fe5e,0,Jens Geyer,2014-07-14 22:39:46+02:00,['3974aaba691cfc3681b71667ddd5c65a3d7e74ac'],0,6,6,632336,1,1,1,1,2039
57e6de46f385a1b220be3134bbe80d9d806d01f6,0,Roger Meier,2014-07-16 10:19:59+02:00,['9a93fe07ffd591222e22a7e35cb42549b3d4fe5e'],0,2,2,632338,1,,,,2039
cb3f3f37e2060ba19b97ebe0cc815b5107f3dab9,1,Roger Meier,2014-07-16 19:54:02+02:00,['57e6de46f385a1b220be3134bbe80d9d806d01f6'],12,427,439,632777,3,,,,2040
c437cff08f0013aa832d2efa871539f5d2a04891,1,Roger Meier,2014-07-16 20:09:49+02:00,['cb3f3f37e2060ba19b97ebe0cc815b5107f3dab9'],2,5,7,632784,1,0,1,1,2040
8a2bab3f72e85b8ba6c96d63ab4df708ec211ac0,0,henrique,2014-07-16 20:10:57+02:00,['57e6de46f385a1b220be3134bbe80d9d806d01f6'],2,30,32,632816,3,0.35,0.5,0.5,2040
3148f21c8e8a78b565bd281645b8faacef6eb858,0,Roger Meier,2014-07-16 20:16:22+02:00,"['c437cff08f0013aa832d2efa871539f5d2a04891', '8a2bab3f72e85b8ba6c96d63ab4df708ec211ac0']",2,30,32,632848,3,,,,2040
a75a5f0f703aeee3dd4fd6fd2b7c8cd4c9469d34,1,Roger Meier,2014-07-16 21:13:28+02:00,['3148f21c8e8a78b565bd281645b8faacef6eb858'],132,128,260,633108,1,1,0,0,2040
7a8b286b3f03046a1b89f405129dbc042ddae818,0,henrique,2014-07-16 22:05:08+02:00,['a75a5f0f703aeee3dd4fd6fd2b7c8cd4c9469d34'],110,100,210,633318,3,0,0.333333333,1,2040
dd077c8b0b1427c44e0234e266046bbdc5306b1f,0,Jens Geyer,2014-07-22 00:41:07+02:00,['7a8b286b3f03046a1b89f405129dbc042ddae818'],0,1,1,633319,1,,,,2040
1d7e35a7cb588a1e1f679a7306ff4bb57305ee11,1,Roger Meier,2014-07-22 21:56:12+02:00,['dd077c8b0b1427c44e0234e266046bbdc5306b1f'],107,210,317,633636,2,0.03030303,0.439393939,1,2040
feea9477e75ed2f9d2654bda200c1cf79c1f7a31,1,Roger Meier,2014-07-22 22:04:42+02:00,['1d7e35a7cb588a1e1f679a7306ff4bb57305ee11'],6,9,15,633651,2,0,1,1,2040
ac8d8e260e3b0087ae2975ffcbea842255f57601,1,henrique,2014-07-23 23:31:04+02:00,['feea9477e75ed2f9d2654bda200c1cf79c1f7a31'],41,135,176,633827,3,,,,2042
8b51bc6ad7e19bbc1003144cf9b4cb3086de6747,0,Roger Meier,2014-07-24 23:33:33+02:00,['ac8d8e260e3b0087ae2975ffcbea842255f57601'],71,71,142,633969,16,,,,2042
dfdc0088a74656a462ba7fb087aee3a654f17c80,0,Roger Meier,2014-07-24 23:40:38+02:00,['8b51bc6ad7e19bbc1003144cf9b4cb3086de6747'],0,6,6,633975,1,1,1,1,2042
909f186fa6a68b0ec187aa6b0588ea2b899ea59b,1,Roger Meier,2014-07-24 23:52:14+02:00,['dfdc0088a74656a462ba7fb087aee3a654f17c80'],2,276,278,634253,4,0.172619048,1,0.75,2043
16e2ed25acb7909f1b95e897b5b03f59be6f9398,0,Roger Meier,2014-07-24 23:54:53+02:00,['909f186fa6a68b0ec187aa6b0588ea2b899ea59b'],0,1,1,634254,1,,,,2043
577f407df96ffe15177b5435ba99db56ae0129d8,1,Jens Geyer,2014-07-25 00:13:27+02:00,['16e2ed25acb7909f1b95e897b5b03f59be6f9398'],6,295,301,634555,4,0.603174603,0.507936508,0.706349206,2045
fb6ed7ead165cc494bda7d59691a33809281ef3a,1,Roger Meier,2014-07-25 00:09:25+02:00,['577f407df96ffe15177b5435ba99db56ae0129d8'],2,295,297,634852,2,,,,2046
7dce7b2a306900bbf181fab70a86fac71b67eae8,0,Jens Geyer,2014-07-25 22:00:44+02:00,['fb6ed7ead165cc494bda7d59691a33809281ef3a'],1,20,21,634873,1,0,1,1,2046
da8b60715f79f9e49bde90403b0b17eba0c212c8,1,Roger Meier,2014-07-25 23:16:24+02:00,['7dce7b2a306900bbf181fab70a86fac71b67eae8'],0,3,3,634876,1,0,0,1,2046
ce9cf13bb30239d3b63ecbf2a8ff769998c0307f,0,Roger Meier,2014-07-25 23:20:54+02:00,['da8b60715f79f9e49bde90403b0b17eba0c212c8'],6,54,60,634936,4,1,0.481481481,1,2046
9df385408b8228bb4571d84e88360731fa355823,0,Roger Meier,2014-07-25 23:24:46+02:00,['ce9cf13bb30239d3b63ecbf2a8ff769998c0307f'],0,6,6,634942,1,,,,2046
84d1188842a27ae3019ddedbfb89039eb3528730,1,Roger Meier,2014-07-25 23:26:11+02:00,['9df385408b8228bb4571d84e88360731fa355823'],25,78,103,635045,3,0.666666667,0.666666667,0.976190476,2046
fcd062d6ceb5689fe204329923f6366a5fd711c2,0,Roger Meier,2014-07-25 23:40:27+02:00,['84d1188842a27ae3019ddedbfb89039eb3528730'],6,18,24,635069,2,1,1,0,2046
6aacd4cc719e5a392236b9b351397d03f80ae0d6,1,Roger Meier,2014-07-26 00:19:02+02:00,['fcd062d6ceb5689fe204329923f6366a5fd711c2'],0,223,223,635292,2,1,1,0.793103448,2047
e3f0a42347433e0c65d4635d86d93f72cfc83aff,0,Roger Meier,2014-07-26 00:24:39+02:00,['6aacd4cc719e5a392236b9b351397d03f80ae0d6'],1,1,2,635294,1,,,,2047
54c0d2e8e71678f3f77339f4b3a3a640c29aeaa4,1,Roger Meier,2014-07-26 00:37:44+02:00,['e3f0a42347433e0c65d4635d86d93f72cfc83aff'],1,71,72,635366,3,0.9375,0.9375,1,2049
2591be279025eb3e4031a22ee2d68e10ceb416d2,0,Roger Meier,2014-07-26 09:40:07+02:00,['54c0d2e8e71678f3f77339f4b3a3a640c29aeaa4'],1,1,2,635368,1,,,,2049
c0a7d72c83d93cf266d57b25a3b8850eb81c47d6,0,henrique,2014-07-26 13:11:12+02:00,['2591be279025eb3e4031a22ee2d68e10ceb416d2'],10,14,24,635392,4,,,,2049
3c494114b16d2873ebd6f28297d3ae91843b065f,0,Roger Meier,2014-07-26 14:43:57+02:00,['c0a7d72c83d93cf266d57b25a3b8850eb81c47d6'],1,1,2,635394,1,,,,2049
8345772f299a308496ebaae6516f3f813469f829,0,Jens Geyer,2014-07-26 18:02:12+02:00,['3c494114b16d2873ebd6f28297d3ae91843b065f'],14,49,63,635457,2,0,0,1,2049
8953e7016a42de9dc45af92799245e1033575318,1,Roger Meier,2014-07-26 22:13:55+02:00,['8345772f299a308496ebaae6516f3f813469f829'],83,96,179,635636,2,,,,2049
c0ff5561fefa4b690d6c72ac7d792f9a1e480bda,0,Roger Meier,2014-07-26 22:13:55+02:00,['8953e7016a42de9dc45af92799245e1033575318'],7,16,23,635659,2,1,1,1,2049
bee7b738025ea7f2fa861a9567570ca502468c46,1,Roger Meier,2014-07-26 22:13:55+02:00,['c0ff5561fefa4b690d6c72ac7d792f9a1e480bda'],1,88,89,635748,3,1,1,1,2050
11066bd56d05e6ab1b8dec8cdb4b981c88039c46,0,Roger Meier,2014-07-26 22:30:37+02:00,['bee7b738025ea7f2fa861a9567570ca502468c46'],20,26,46,635794,1,0.333333333,0.333333333,0.333333333,2050
f04d9f45dd71318dddb00fb58814c8fb36a61372,0,Jens Geyer,2014-07-27 13:35:04+02:00,['11066bd56d05e6ab1b8dec8cdb4b981c88039c46'],1,1,2,635796,1,,,,2050
557d6ea410c03a4cfb126e2031b605f8692c2a6a,0,Jens Geyer,2014-07-27 14:48:28+02:00,['f04d9f45dd71318dddb00fb58814c8fb36a61372'],1,1,2,635798,1,,,,2050
5c0e987ac10ef4c16fdca68397dc380e5d8466b3,0,Jens Geyer,2014-07-27 19:19:31+02:00,['557d6ea410c03a4cfb126e2031b605f8692c2a6a'],2,2,4,635802,1,,,,2050
87a0477a084a7c5fd1d7118f70ea02bb208b9f96,0,Roger Meier,2014-07-28 08:18:20+02:00,['5c0e987ac10ef4c16fdca68397dc380e5d8466b3'],1,1,2,635804,1,,,,2050
60b7ad6b3d84127b322d65eba049ce3b6dd17e6b,1,Roger Meier,2014-07-29 23:25:53+02:00,['87a0477a084a7c5fd1d7118f70ea02bb208b9f96'],68,1505,1573,637377,3,0.071103008,0.500455789,1,2050
2814c2e7265ff7316cf9b2cad42827ec6df2bc47,1,Roger Meier,2014-07-29 23:28:46+02:00,['60b7ad6b3d84127b322d65eba049ce3b6dd17e6b'],0,261,261,637638,4,0,0,1,2052
8033e7e794e8b6304b91f0c3a8f7e30343444fd6,0,Roger Meier,2014-07-30 01:01:50+02:00,['2814c2e7265ff7316cf9b2cad42827ec6df2bc47'],49,14,63,637701,2,1,1,0,2052
75eb2a31a158846513c719724000542f2750d695,0,Roger Meier,2014-07-30 01:14:08+02:00,['8033e7e794e8b6304b91f0c3a8f7e30343444fd6'],75,98,173,637874,2,,,,2052
6e25d749b67bc354e0f1c23ae2b33ceadfcf955f,0,Roger Meier,2014-07-30 01:17:58+02:00,['75eb2a31a158846513c719724000542f2750d695'],0,1,1,637875,1,,,,2052
57e68b2500ca941e313651370ac4d52139a060eb,0,Charles O'Farrell,2014-08-01 18:09:38+10:00,['6e25d749b67bc354e0f1c23ae2b33ceadfcf955f'],1,13,14,637889,1,1,1,0,2052
790a3881b2bd8d0e0f868e9f28205ea60cfb0f2d,1,Jens Geyer,2014-08-01 22:25:51+02:00,['57e68b2500ca941e313651370ac4d52139a060eb'],0,11,11,637900,1,0,0,0,2052
e8bafb6d92ee19e9e714533abdac762c6086c97c,0,Roger Meier,2014-08-01 23:39:32+02:00,['790a3881b2bd8d0e0f868e9f28205ea60cfb0f2d'],20,94,114,638014,3,0,0,0,2052
b360ed393cc4845d9933d45dacbf0dd0446f0a88,1,Jens Geyer,2014-08-02 16:23:13+02:00,['e8bafb6d92ee19e9e714533abdac762c6086c97c'],11,19,30,638044,1,0,0,1,2052
f341c590dcaa99fad8e768e1e8f06f19179bb737,1,Roger Meier,2014-08-02 18:05:23+02:00,['b360ed393cc4845d9933d45dacbf0dd0446f0a88'],30,15,45,638089,4,1,1,1,2053
a0b86741169b8ef0a1e663154db447517bd89b0b,0,Jens Geyer,2014-08-03 19:14:11+02:00,['f341c590dcaa99fad8e768e1e8f06f19179bb737'],8,11,19,638108,1,0,0,1,2053
06d0fa05a56880ff341d8cc8f5de0ed47cf61c2c,1,Roger Meier,2014-08-07 02:41:29+02:00,['a0b86741169b8ef0a1e663154db447517bd89b0b'],45,144,189,638297,9,,,,2056
16c164ed3054b4edc65992a2b781307116fbca56,0,Roger Meier,2014-08-07 03:09:23+02:00,['06d0fa05a56880ff341d8cc8f5de0ed47cf61c2c'],4,48,52,638349,4,,,,2057
c53bbd2c4b2df1dafaf71fec822269b0a63268ef,0,Roger Meier,2014-08-07 03:20:21+02:00,['16c164ed3054b4edc65992a2b781307116fbca56'],16,39,55,638404,2,0,0,0,2057
7fd06407a035795bccceade0e56768825e927004,0,Roger Meier,2014-08-07 14:36:49+02:00,['c53bbd2c4b2df1dafaf71fec822269b0a63268ef'],0,6,6,638410,1,0,0,1,2057
f5136abebad443c02d740bf0546b9dba689192cd,0,Roger Meier,2014-08-07 14:54:30+02:00,['7fd06407a035795bccceade0e56768825e927004'],39,16,55,638465,2,1,1,1,2057
d52edba00fe1b1a5f8df3cfbfb1244dca7b1a0a4,1,Roger Meier,2014-08-07 17:04:23+02:00,['f5136abebad443c02d740bf0546b9dba689192cd'],312,277,589,639054,3,1,1,1,2057
ca44a622dfd0d01f1b0d00d26b9208eb69995176,1,Roger Meier,2014-08-07 17:40:22+02:00,['d52edba00fe1b1a5f8df3cfbfb1244dca7b1a0a4'],7,11,18,639072,2,,,,2057
c20eeaae8296fa9d9de34b07fe8b21cf509c8884,0,Jens Geyer,2014-08-07 22:41:24+02:00,['ca44a622dfd0d01f1b0d00d26b9208eb69995176'],1,1,2,639074,1,,,,2057
044e89de0a73d8f1fcc580fbef498ee1195ea9d7,0,Jens Geyer,2014-08-07 22:50:15+02:00,['c20eeaae8296fa9d9de34b07fe8b21cf509c8884'],12,36,48,639122,1,1,0.647058824,0.764705882,2057
bea273484d63e5c14481754da9ff786b12835471,0,Roger Meier,2014-08-08 00:32:58+02:00,['044e89de0a73d8f1fcc580fbef498ee1195ea9d7'],0,7,7,639129,1,,,,2057
af5d64adb7c2e0ac130e9f9499375429f1408eff,1,Roger Meier,2014-08-10 21:11:43+02:00,['bea273484d63e5c14481754da9ff786b12835471'],948,2527,3475,642604,34,0,0,0.905940594,2064
862218ec1380e62ed413bb3c25a9f6b72d154212,0,Roger Meier,2014-08-10 21:13:58+02:00,['af5d64adb7c2e0ac130e9f9499375429f1408eff'],4,3,7,642611,3,,,,2064
79c3f4a7311e91dbd3edd85a30c54b2ccce57781,0,Roger Meier,2014-08-10 21:26:17+02:00,['862218ec1380e62ed413bb3c25a9f6b72d154212'],26,23,49,642660,1,0,0,0,2064
5e5eacfefed73d0ad03c94e5e852176bf0849bde,0,Roger Meier,2014-08-10 21:30:50+02:00,['79c3f4a7311e91dbd3edd85a30c54b2ccce57781'],1,1,2,642662,1,,,,2064
0d4072b0cf1a03e7b26c5212d1b456a7736b0bdc,0,Roger Meier,2014-08-10 21:45:30+02:00,['5e5eacfefed73d0ad03c94e5e852176bf0849bde'],19,40,59,642721,4,0,0,0,2064
a07ec0bdf2cd74f15dbd7b383c52034348bfde26,1,Roger Meier,2014-08-10 21:59:37+02:00,['0d4072b0cf1a03e7b26c5212d1b456a7736b0bdc'],8,22,30,642751,4,0,0,1,2064
c983250355bc5fd572a6b56fc5637461ef868ec8,1,Roger Meier,2014-08-13 12:36:42+02:00,['a07ec0bdf2cd74f15dbd7b383c52034348bfde26'],3,72,75,642826,2,0.422222222,0.866666667,0.911111111,2064
5f841dff8b264708fe961186bd26c1016acdfca4,0,Roger Meier,2014-08-13 12:54:53+02:00,['c983250355bc5fd572a6b56fc5637461ef868ec8'],1,4,5,642831,2,0,1,1,2064
d1041656e8625453a7ee49556bcb1260807c2c4a,1,Roger Meier,2014-08-15 22:41:06+02:00,['5f841dff8b264708fe961186bd26c1016acdfca4'],87,101,188,643019,1,,,,2064
dace6937a7c1f53c45c005f0d5d6e2851b656da6,0,Roger Meier,2014-08-15 23:01:09+02:00,['d1041656e8625453a7ee49556bcb1260807c2c4a'],4,44,48,643067,1,,,,2064
8720260e39c730be6803a17192b533e3fe6bcbf8,1,Roger Meier,2014-08-15 23:07:12+02:00,['dace6937a7c1f53c45c005f0d5d6e2851b656da6'],5,34,39,643106,5,,,,2064
d92179129a5674784da7248f09bd41d32bb762bc,0,Roger Meier,2014-08-15 23:34:45+02:00,['8720260e39c730be6803a17192b533e3fe6bcbf8'],188,340,528,643634,5,,,,2064
9ea3d2e75d6ee20af34dca1a60a48f485958603b,0,Roger Meier,2014-08-16 22:15:01+02:00,['d92179129a5674784da7248f09bd41d32bb762bc'],130,135,265,643899,2,,,,2064
7191bc99fe3de1027f7fab21232d5bc6ed1d5db5,0,Roger Meier,2014-08-17 21:48:21+02:00,['9ea3d2e75d6ee20af34dca1a60a48f485958603b'],4,4,8,643907,2,,,,2064
311f7157a2dc5285b027cbf0bc517e9e741de687,0,Roger Meier,2014-08-17 22:24:30+02:00,['7191bc99fe3de1027f7fab21232d5bc6ed1d5db5'],10,6,16,643923,3,,,,2064
e26db2fcf2f7853aaa076f7e299dcdb433029cd1,0,Roger Meier,2014-08-18 21:19:44+02:00,['311f7157a2dc5285b027cbf0bc517e9e741de687'],2,2,4,643927,1,,,,2064
9cc7e8696b0c768b5e4d072a5f383b5317d608be,0,Roger Meier,2014-08-20 14:24:54+02:00,['e26db2fcf2f7853aaa076f7e299dcdb433029cd1'],1,1,2,643929,1,,,,2064
9be413fca40d75559c2776618c904a5e140d3418,0,Pascal Bach,2014-08-21 14:36:25+02:00,['9cc7e8696b0c768b5e4d072a5f383b5317d608be'],1,55,56,643985,7,0.92,0.28,1,2064
5d6378f61e2bed18e316f8f6d48de419a5848b12,0,Roger Meier,2014-08-23 22:22:46+02:00,['9be413fca40d75559c2776618c904a5e140d3418'],1,7,8,643993,1,0,1,1,2064
f9b8f5e64137248ea2a1b95312916491d23ab94a,1,Roger Meier,2014-08-23 22:27:45+02:00,['5d6378f61e2bed18e316f8f6d48de419a5848b12'],0,228,228,644221,1,0,0.009852217,0.960591133,2064
e1358ce8f411241e022e0a3faecce8c26a287922,0,Roger Meier,2014-09-01 20:08:49+02:00,['f9b8f5e64137248ea2a1b95312916491d23ab94a'],1,1,2,644223,1,,,,2064
7fa9848b85479f81767a36a96e7e9805683015d4,1,Roger Meier,2014-09-01 20:21:33+02:00,['e1358ce8f411241e022e0a3faecce8c26a287922'],22,120,142,644365,2,0.014492754,1,0.942028986,2064
546209c9615632fa76edf1cc9604b5ad8837a97c,0,Roger Meier,2014-09-01 20:23:26+02:00,['7fa9848b85479f81767a36a96e7e9805683015d4'],2,14,16,644381,1,0.333333333,0.666666667,0,2064
008f42cb3846fdfbcdc85acfe129680fd51c2def,0,Roger Meier,2014-09-01 20:26:01+02:00,['546209c9615632fa76edf1cc9604b5ad8837a97c'],3,6,9,644390,1,0,0,0,2064
b3c8409c246565af0fb9944f13bd716bd5687a72,1,Roger Meier,2014-09-01 21:53:40+02:00,['008f42cb3846fdfbcdc85acfe129680fd51c2def'],0,1687,1687,646077,6,0.01440678,0.01440678,1,2066
aa42d61d7a596c00b6587f14ed5e87bbbbf0646e,1,Roger Meier,2014-09-01 21:55:04+02:00,['b3c8409c246565af0fb9944f13bd716bd5687a72'],3,19,22,646099,2,,,,2066
db8751b1bc87bb50d356aa88c1902f8ff6972fee,0,Roger Meier,2014-09-01 21:58:07+02:00,['aa42d61d7a596c00b6587f14ed5e87bbbbf0646e'],19,31,50,646149,3,0.4,0.4,0,2066
b191ecc8dcfe43a0e352c0a3fc034b94263ae907,0,Roger Meier,2014-09-01 22:01:10+02:00,['db8751b1bc87bb50d356aa88c1902f8ff6972fee'],1,1,2,646151,1,,,,2066
e26a19bba0a91e31d0ec8092940992534426a26f,0,Roger Meier,2014-09-01 22:04:36+02:00,['b191ecc8dcfe43a0e352c0a3fc034b94263ae907'],1,1,2,646153,1,,,,2066
d0bd17e7263cb8f92c21d3e1dad2ee5b5e9f79e5,1,Jens Geyer,2014-09-01 23:05:08+02:00,['e26a19bba0a91e31d0ec8092940992534426a26f'],1,1,2,646155,1,,,,2066
b3f6ea100fae38a568e1844923c4c945cab5b536,1,Roger Meier,2014-09-03 23:41:32+02:00,['d0bd17e7263cb8f92c21d3e1dad2ee5b5e9f79e5'],3,333,336,646491,5,0.788359788,0.968253968,0.904761905,2068
d62473c3b0fff3f50f5d1f7e9dd6f8bdf91d4a66,1,Roger Meier,2014-09-04 00:16:50+02:00,['b3f6ea100fae38a568e1844923c4c945cab5b536'],8,14,22,646513,1,0,0,0,2068
0cc6d3c7bd454ad701bf5652a58a49f689babfc5,0,Roger Meier,2014-09-04 00:24:17+02:00,['d62473c3b0fff3f50f5d1f7e9dd6f8bdf91d4a66'],3,12,15,646528,2,0,0,0,2068
067779bbda32412ff67a777582465579a9f18c84,0,Jens Geyer,2014-09-04 22:35:38+02:00,['0cc6d3c7bd454ad701bf5652a58a49f689babfc5'],2,5,7,646535,1,0,1,1,2068
ae0b22cc29a329f5e094c37d8fff166d01b6fab5,1,Jens Geyer,2014-09-04 23:40:14+02:00,['067779bbda32412ff67a777582465579a9f18c84'],75,205,280,646815,10,0,1,0,2070
3e8454cc71210a7298aa91d7c2042d40a3b46feb,0,Jens Geyer,2014-09-04 23:40:32+02:00,['ae0b22cc29a329f5e094c37d8fff166d01b6fab5'],0,3,3,646818,1,,,,2070
4d223c6fee2fc6a37217d506c0879f7eab85541a,0,Jens Geyer,2014-09-05 22:31:39+02:00,['3e8454cc71210a7298aa91d7c2042d40a3b46feb'],1,1,2,646820,1,,,,2070
1235ee3f2a65694793a3ef0c7c47d0245b293e52,1,Jens Geyer,2014-09-06 14:59:51+02:00,['4d223c6fee2fc6a37217d506c0879f7eab85541a'],2,3,5,646825,2,,,,2070
6bbbf1946e55f91f063251679f479daab62e51df,1,Jens Geyer,2014-09-07 01:45:56+02:00,['1235ee3f2a65694793a3ef0c7c47d0245b293e52'],1,12,13,646838,3,,,,2070
a8eec715d827a973d963edb4f348ff4fb2a48a81,0,Roger Meier,2014-09-08 23:13:08+02:00,['6bbbf1946e55f91f063251679f479daab62e51df'],24,21,45,646883,2,1,0.666666667,0,2070
684ccab5e72cddacda7a1fc2c1a80f23e1bc3163,1,Jens Geyer,2014-09-11 21:14:44+02:00,['a8eec715d827a973d963edb4f348ff4fb2a48a81'],86,60,146,647029,2,,,,2070
089bcd3f8cd643091cd29126b236271c069b18e9,0,Jens Geyer,2014-09-11 22:36:41+02:00,['684ccab5e72cddacda7a1fc2c1a80f23e1bc3163'],14,82,96,647125,4,,,,2072
86b309cde09b6bdbe95c4c9d77ca6ad0bc6c6805,0,Jens Geyer,2014-09-12 00:23:51+02:00,['089bcd3f8cd643091cd29126b236271c069b18e9'],13,9,22,647147,2,,,,2072
2de7e198998adeabbc7a31ecf2c1f06fc0304834,0,Jens Geyer,2014-09-12 00:23:53+02:00,['86b309cde09b6bdbe95c4c9d77ca6ad0bc6c6805'],9,13,22,647169,1,0,1,1,2072
b3e5ebe1e4fdbbc34df5d4dabcdd15f25a7ee2fd,0,name,2014-09-12 11:15:24+02:00,['2de7e198998adeabbc7a31ecf2c1f06fc0304834'],21,21,42,647211,2,,,,2072
3e8d9272cecfb6dcfe7a03faafdba295c7d1838e,1,Jens Geyer,2014-09-17 21:53:55+02:00,['b3e5ebe1e4fdbbc34df5d4dabcdd15f25a7ee2fd'],37,201,238,647449,5,,,,2072
a86886e77d355ec7523f0b9041f9f0ac03e4dd33,1,Jens Geyer,2014-09-17 22:36:00+02:00,['3e8d9272cecfb6dcfe7a03faafdba295c7d1838e'],42,103,145,647594,33,0.027777778,0,1,2072
3dcef37686016e7c6c427bd5054eb12934f82d33,1,Jens Geyer,2014-09-17 22:55:56+02:00,['a86886e77d355ec7523f0b9041f9f0ac03e4dd33'],0,4,4,647598,2,,,,2072
be8326d5862b134cf8d302923fb8f195c3d79124,0,Jens Geyer,2014-09-19 20:35:46+02:00,['3dcef37686016e7c6c427bd5054eb12934f82d33'],5,7,12,647610,2,,,,2072
4ab18cef740941fff5b8477d715994fd44bfe2df,0,Roger Meier,2014-09-22 23:38:29+02:00,['be8326d5862b134cf8d302923fb8f195c3d79124'],2,2,4,647614,1,,,,2072
f8a1b7a29abadf315f4be186fc7dfa4c0a906c42,1,Jens Geyer,2014-09-24 00:26:46+02:00,['4ab18cef740941fff5b8477d715994fd44bfe2df'],242,491,733,648347,6,,,,2072
b360b65d3f5841938361f64c1265d3dddc66d281,0,Jens Geyer,2014-09-28 01:55:46+02:00,['f8a1b7a29abadf315f4be186fc7dfa4c0a906c42'],16,16,32,648379,1,,,,2072
51ba56c31b5a49c7d4fd24d3e30ce2b9d8579d17,0,Roger Meier,2014-09-28 22:39:55+02:00,['b360b65d3f5841938361f64c1265d3dddc66d281'],31,76,107,648486,2,0,0,1,2072
63243c6a2923cfee1d7d7d3b74ba7ccfcd448dc0,1,Roger Meier,2014-09-29 20:29:58+02:00,['51ba56c31b5a49c7d4fd24d3e30ce2b9d8579d17'],55,2054,2109,650595,21,0.055471125,0.152735562,0.921732523,2078
15df0767d3ddeb87b5f1b2fa832e1502b9a6884f,1,Roger Meier,2014-09-29 20:50:56+02:00,['63243c6a2923cfee1d7d7d3b74ba7ccfcd448dc0'],77,1547,1624,652219,7,0.143421053,0.85,0.263157895,2081
4606d7db90343014908acd80267034f2d750d660,1,Roger Meier,2014-09-29 21:01:58+02:00,['15df0767d3ddeb87b5f1b2fa832e1502b9a6884f'],34,574,608,652827,4,0.230769231,0.705882353,0.511312217,2082
eb8e5ad87fc8d715a40416f789774da2856a6d69,1,Jens Geyer,2014-09-29 21:50:15+02:00,['4606d7db90343014908acd80267034f2d750d660'],19,50,69,652896,4,0.444444444,0.666666667,0.777777778,2082
1ff4a97a45a78e4afe88660927fb798c18336f7d,1,Roger Meier,2014-09-29 22:05:49+02:00,['eb8e5ad87fc8d715a40416f789774da2856a6d69'],12,3,15,652911,3,,,,2082
05d64b4e3bcac81b31b89a2db2255edd72b783a8,0,Konrad Grochowski,2014-09-29 22:08:58+02:00,['1ff4a97a45a78e4afe88660927fb798c18336f7d'],5,15,20,652931,2,0.875,0.875,1,2082
aa99e0e2b8b29b75b18b5dfc8e8c17245cb43e75,0,Jens Geyer,2014-09-29 22:11:08+02:00,['05d64b4e3bcac81b31b89a2db2255edd72b783a8'],0,404,404,653335,4,0.918367347,1,1,2086
25c68f45daa4644ce4e691a78a2013289abffa46,1,Roger Meier,2014-09-29 22:14:30+02:00,['aa99e0e2b8b29b75b18b5dfc8e8c17245cb43e75'],18,8,26,653361,6,,,,2086
eb393ac3cd7aad50e65b30a110c0d40eaebf7c25,0,Jens Geyer,2014-09-29 22:47:44+02:00,['25c68f45daa4644ce4e691a78a2013289abffa46'],2,2,4,653365,1,,,,2086
03394b54fb9a7e43b41299ee3886ae4fabb7fb64,0,Konrad Grochowski,2014-09-29 23:04:30+02:00,['eb393ac3cd7aad50e65b30a110c0d40eaebf7c25'],9,6,15,653380,1,1,1,0,2086
485d71acd10b543890ea3114fda5be8cb88a2f0e,0,Konrad Grochowski,2014-09-29 23:38:15+02:00,['03394b54fb9a7e43b41299ee3886ae4fabb7fb64'],1,1,2,653382,1,,,,2086
3a724e37d49be1990fe2432c4ee7751653336c65,1,Konrad Grochowski,2014-09-29 23:55:47+02:00,['485d71acd10b543890ea3114fda5be8cb88a2f0e'],26,34,60,653442,4,,,,2086
293a40e960d87d83ec57f89738c3ec174981335b,1,Konrad Grochowski,2014-09-30 12:04:02+02:00,['3a724e37d49be1990fe2432c4ee7751653336c65'],29,13,42,653484,3,,,,2086
ab3f848dec6fee43650c727014d165929b383e55,0,Randy Abernethy,2014-09-30 14:09:41-07:00,['293a40e960d87d83ec57f89738c3ec174981335b'],102,124,226,653710,2,0,0.083333333,0.916666667,2086
99b9e1d405c80059e9bf680081501bf729c33a74,0,Konrad Grochowski,2014-10-01 00:14:14+02:00,['ab3f848dec6fee43650c727014d165929b383e55'],3,1,4,653714,1,,,,2086
38f7a56e559508f7f110697cbf42587c5a9c7d0f,0,Randy Abernethy,2014-09-30 15:37:26-07:00,['99b9e1d405c80059e9bf680081501bf729c33a74'],4,3,7,653721,3,,,,2086
775248a2f78082e8f8159cab6bdecfc62a1d6fff,0,Randy Abernethy,2014-09-30 15:44:16-07:00,['38f7a56e559508f7f110697cbf42587c5a9c7d0f'],0,1,1,653722,1,,,,2086
92a1ed001797f6a13bd0ce0bf235b5fa766578b0,1,Randy Abernethy,2014-09-30 16:16:10-07:00,['775248a2f78082e8f8159cab6bdecfc62a1d6fff'],16,63,79,653801,1,,,,2086
bd2fce6fa3beda151da1f09ea62b4925c8784bbe,0,Randy Abernethy,2014-09-30 17:12:27-07:00,['92a1ed001797f6a13bd0ce0bf235b5fa766578b0'],5,2,7,653808,2,,,,2086
5057b4cb5ad13c1e9637e7ed58e2c7acd855a216,1,Randy Abernethy,2014-09-30 17:34:44-07:00,['bd2fce6fa3beda151da1f09ea62b4925c8784bbe'],4,4,8,653816,1,,,,2086
b898eaa25cecace8a9edf65445ab1e576203d2e5,0,Jens Geyer,2014-10-01 03:00:19+02:00,['5057b4cb5ad13c1e9637e7ed58e2c7acd855a216'],2,0,2,653818,1,0,0,0,2086
5aff35f7bef2ca02eb363ad9093cd62385f43cd6,1,Jens Geyer,2014-10-01 21:06:52+02:00,['b898eaa25cecace8a9edf65445ab1e576203d2e5'],0,14,14,653832,1,,,,2086
cc4ac4955c968a6171aec0f65b14e16d141f81ce,1,Jens Geyer,2014-10-01 21:13:39+02:00,['5aff35f7bef2ca02eb363ad9093cd62385f43cd6'],46,81,127,653959,3,,,,2086
656a2fbdaedf5b25bbb7ba2c08d0cd8c0592f917,0,Jens Geyer,2014-10-01 21:53:02+02:00,['cc4ac4955c968a6171aec0f65b14e16d141f81ce'],16,2,18,653977,1,,,,2086
63ad5f6f514a6d977d960a41bcda607d701f284c,1,jfarrell,2014-10-01 21:44:30-04:00,['656a2fbdaedf5b25bbb7ba2c08d0cd8c0592f917'],15,2,17,653994,1,,,,2086
6d15c3090f7bd0e8ab754e98098910985718777f,1,Jens Geyer,2014-10-02 10:06:07+02:00,['63ad5f6f514a6d977d960a41bcda607d701f284c'],158,960,1118,655112,14,0.352941176,0.823529412,0.852941176,2089
afec3578d2928dd84044f65a1016564bdc2b7314,0,Konrad Grochowski,2014-10-02 17:19:15+02:00,['6d15c3090f7bd0e8ab754e98098910985718777f'],2,2,4,655116,1,,,,2089
23b60b51dfda16135e525ecf3a8d52347f574f21,0,Konrad Grochowski,2014-10-02 17:25:47+02:00,['afec3578d2928dd84044f65a1016564bdc2b7314'],2,2,4,655120,1,,,,2089
d5436f5cf7a100d89abb3d125d8f241ca7dc925e,0,Jens Geyer,2014-10-03 20:12:40+02:00,['23b60b51dfda16135e525ecf3a8d52347f574f21'],10086,10098,20184,675304,94,,,,2089
aaa8947f3a149d38dd4bfd395573860c2f18ea93,0,Jens Geyer,2014-10-03 20:30:38+02:00,['d5436f5cf7a100d89abb3d125d8f241ca7dc925e'],826,826,1652,676956,60,,,,2089
79f988c27ac97b7a89e6c78a64da2f3a2f65d916,0,Jens Geyer,2014-10-03 20:42:54+02:00,['aaa8947f3a149d38dd4bfd395573860c2f18ea93'],710,710,1420,678376,48,,,,2089
196c5afbb1dcd9f815c055e76b3603bb9acccbb4,0,Jens Geyer,2014-10-03 21:12:58+02:00,['79f988c27ac97b7a89e6c78a64da2f3a2f65d916'],4,4,8,678384,1,,,,2089
dd971d5377c3e0271ffb9692217196274a8e02e4,0,Jens Geyer,2014-10-07 21:17:10+02:00,['196c5afbb1dcd9f815c055e76b3603bb9acccbb4'],35,0,35,678419,2,,,,2089
8f8eaf376f3799305f5ecfe5fcee3f5c3d14b016,0,Jens Geyer,2014-10-07 21:42:43+02:00,['dd971d5377c3e0271ffb9692217196274a8e02e4'],3,3,6,678425,1,,,,2089
2771991ca29978e180a25970c9c58fb6d74ae2ab,0,Jens Geyer,2014-10-07 21:51:35+02:00,['8f8eaf376f3799305f5ecfe5fcee3f5c3d14b016'],110,2,112,678537,1,,,,2089
3da090642c10c74289f22c5b02a31c408384cc0a,0,jfarrell,2014-10-08 01:18:07-04:00,['2771991ca29978e180a25970c9c58fb6d74ae2ab'],10,11,21,678558,1,,,,2089
5e58b80c8b1f6b0a74c9a4cb7bce62c57c88c014,0,Roger Meier,2014-10-08 11:59:44+02:00,['3da090642c10c74289f22c5b02a31c408384cc0a'],0,1,1,678559,1,,,,2089
9a7cb9f6c8e6cab5970075e2faf40944ce331ad2,0,Roger Meier,2014-10-08 12:31:26+02:00,['5e58b80c8b1f6b0a74c9a4cb7bce62c57c88c014'],0,1,1,678560,1,0,0,1,2089
93fea15b51494a79992a5323c803325537134bd8,1,Konrad Grochowski,2014-10-08 13:35:54+02:00,['9a7cb9f6c8e6cab5970075e2faf40944ce331ad2'],13,40,53,678613,4,1,1,1,2089
d5f3be5ebdb2973b41b9bc902696845ed0b43f75,1,Konrad Grochowski,2014-10-08 15:40:00+02:00,['93fea15b51494a79992a5323c803325537134bd8'],4,21,25,678638,2,1,0.133333333,1,2089
964082a8eb06a5f36eff87132a048cbb3ea5e7a5,1,Roger Meier,2014-10-08 23:41:18+02:00,['d5f3be5ebdb2973b41b9bc902696845ed0b43f75'],18,184,202,678840,4,0.445544554,0.633663366,0.613861386,2090
87caecf6f178ac76ebed3480ea99a3b4586b8cdc,0,Roger Meier,2014-10-09 00:55:01+02:00,['964082a8eb06a5f36eff87132a048cbb3ea5e7a5'],10,0,10,678850,1,,,,2090
371358ce4e58ed45e86c87cc79d3b67ac95cfc98,0,Roger Meier,2014-10-09 01:17:06+02:00,['87caecf6f178ac76ebed3480ea99a3b4586b8cdc'],1,0,1,678851,1,1,1,0,2090
275278e00cf5217c4ec60fb8e7f23e3f51bc6db4,1,Roger Meier,2014-10-09 01:28:31+02:00,['371358ce4e58ed45e86c87cc79d3b67ac95cfc98'],1,1,2,678853,1,,,,2090
f49ea0691cd788ee3f622f3e97b8d1dcbf0ff89f,0,Roger Meier,2014-10-09 01:50:33+02:00,['275278e00cf5217c4ec60fb8e7f23e3f51bc6db4'],0,1,1,678854,1,0,0,1,2090
25023b16eb4f26d7fcf986e817e8c437e2f08bf3,1,Roger Meier,2014-10-09 02:01:17+02:00,['f49ea0691cd788ee3f622f3e97b8d1dcbf0ff89f'],28,34,62,678916,3,0,0,0,2090
a9ddab5fa791b223f526e07a9530fd292ff96646,0,Roger Meier,2014-10-09 02:11:14+02:00,['25023b16eb4f26d7fcf986e817e8c437e2f08bf3'],1,4,5,678921,1,0,1,0,2090
f98a67bb24569ac5dee0cf94d711dd3d63316447,1,jfarrell,2014-10-08 23:07:33-04:00,['a9ddab5fa791b223f526e07a9530fd292ff96646'],0,1228,1228,680149,8,0.613157895,0.713157895,0.973684211,2098
2c7eb9ee60e5e8235f2c756ca67778a765ba019f,0,jfarrell,2014-10-08 23:15:20-04:00,['f98a67bb24569ac5dee0cf94d711dd3d63316447'],6,13,19,680168,1,,,,2098
5d4953fc4c90445807e1b52f3a2f6c915d82dd42,1,jfarrell,2014-10-08 23:21:19-04:00,['2c7eb9ee60e5e8235f2c756ca67778a765ba019f'],30,9,39,680207,3,,,,2098
f2319457f2b2e2e5fd85ed7ff554b1e2e982ec18,0,jfarrell,2014-10-08 23:24:37-04:00,['5d4953fc4c90445807e1b52f3a2f6c915d82dd42'],3,7,10,680217,1,,,,2098
4d3f937abd9df3b51ae0f76825fc403958ee6805,0,jfarrell,2014-10-08 23:35:05-04:00,['f2319457f2b2e2e5fd85ed7ff554b1e2e982ec18'],3,3,6,680223,2,,,,2098
dabdf659ef6b028f7ac0db732ee1c2ddd33e5a6f,0,jfarrell,2014-10-08 23:41:47-04:00,['4d3f937abd9df3b51ae0f76825fc403958ee6805'],2,2,4,680227,1,,,,2098
07218673b0cd4ff9e90d6c04e4a035a7881962ef,0,Konrad Grochowski,2014-10-09 12:18:25+02:00,['dabdf659ef6b028f7ac0db732ee1c2ddd33e5a6f'],4,4,8,680235,1,,,,2098
ec71f2ebc55b79faa3534ecb0c0d6f3476a3d5bf,0,Roger Meier,2014-10-09 12:38:55+02:00,['07218673b0cd4ff9e90d6c04e4a035a7881962ef'],8,8,16,680251,1,,,,2098
62d2af7cd3a72ab6f861670503bb16c946d9ca8e,0,Jens Geyer,2014-10-09 20:56:44+02:00,['ec71f2ebc55b79faa3534ecb0c0d6f3476a3d5bf'],1,3,4,680255,1,,,,2098
18502ee177e137d54dba520418d6e9208dc04ba7,0,Jens Geyer,2014-10-10 19:30:58+02:00,['62d2af7cd3a72ab6f861670503bb16c946d9ca8e'],1,4,5,680260,1,,,,2098
2adfb0a8d3be85fadeb52e9d18af36dd38c42c0b,0,Jens Geyer,2014-10-10 19:31:14+02:00,['18502ee177e137d54dba520418d6e9208dc04ba7'],0,2,2,680262,1,,,,2098
7a03611fae753ad053db7f364ac1e0c258e070a4,0,Jens Geyer,2014-10-11 11:19:35+02:00,['2adfb0a8d3be85fadeb52e9d18af36dd38c42c0b'],25,35,60,680322,1,,,,2098
1107b17ae4bcfbdb7fb485f026da95ceb6079311,0,Randy Abernethy,2014-10-11 13:42:31-07:00,['7a03611fae753ad053db7f364ac1e0c258e070a4'],3,3,6,680328,1,,,,2098
1a74d9c0b0b9993678ecd7936e20175c2b0f79f0,0,Roger Meier,2014-10-12 23:35:43+02:00,['1107b17ae4bcfbdb7fb485f026da95ceb6079311'],0,475,475,680803,3,0.219941349,0.513196481,0.976539589,2099
f31eba9d459bb927be3af7f608a3c4e8cd0174e0,0,Roger Meier,2014-10-13 00:53:49+02:00,['1a74d9c0b0b9993678ecd7936e20175c2b0f79f0'],4,4,8,680811,1,,,,2099
ec300e33d49bc57d8cc3b744ea16e5af615c8f94,1,Roger Meier,2014-10-13 02:13:35+02:00,['f31eba9d459bb927be3af7f608a3c4e8cd0174e0'],10,15,25,680836,8,,,,2099
d8dd7ea99fdbf0bbe687f3edca2577c735ec2986,1,Roger Meier,2014-10-13 18:07:59+02:00,['ec300e33d49bc57d8cc3b744ea16e5af615c8f94'],12,33,45,680881,1,0,0,0,2099
157691fa987c6f672585854839598216c08eec44,0,Jens Geyer,2014-10-13 21:34:51+02:00,['d8dd7ea99fdbf0bbe687f3edca2577c735ec2986'],7,38,45,680926,1,1,1,1,2099
04a4c152f5c0d0f1b218f1b6cff5dceba00afca2,0,Jens Geyer,2014-10-14 21:30:28+02:00,['157691fa987c6f672585854839598216c08eec44'],0,3,3,680929,1,,,,2099
9b0c47f77e48d3972d275112e5a8cf1ff05d65be,0,Jens Geyer,2014-10-17 10:22:14+02:00,['04a4c152f5c0d0f1b218f1b6cff5dceba00afca2'],0,30,30,680959,1,,,,2100
cb0754db1e73e7ea347aae07e0ef1de9792ef99e,0,Roger Meier,2014-10-21 21:28:04+02:00,['9b0c47f77e48d3972d275112e5a8cf1ff05d65be'],7,1,8,680967,2,,,,2100
d5c7a0f6f7e20bd1cddf98e61a2d1173669206ae,0,Roger Meier,2014-10-21 21:53:05+02:00,['cb0754db1e73e7ea347aae07e0ef1de9792ef99e'],348,348,696,681663,1,,,,2100
a70986fc34428c665ffadd602aae6a69ceeb418e,1,Roger Meier,2014-10-21 23:01:36+02:00,['d5c7a0f6f7e20bd1cddf98e61a2d1173669206ae'],24,60,84,681747,11,0,0.648648649,0.243243243,2100
b006a5078339d125e62919bcc76956c9849000af,0,Roger Meier,2014-10-21 23:49:50+02:00,['a70986fc34428c665ffadd602aae6a69ceeb418e'],0,3,3,681750,2,0.666666667,1,0.666666667,2100
81a1f996bc055c6833c829beaf9e5549db2a774d,1,Roger Meier,2014-10-22 14:09:43+02:00,['b006a5078339d125e62919bcc76956c9849000af'],17,27,44,681794,14,,,,2100
a5bf1a1ff05d2e49b80b999cb8f111e0c8691288,1,Roger Meier,2014-10-22 23:26:01+02:00,['81a1f996bc055c6833c829beaf9e5549db2a774d'],88,89,177,681971,4,,,,2100
ba4a5f0009686f0b633b72d1127fc9ee8a26aba5,0,Roger Meier,2014-10-22 23:36:13+02:00,['a5bf1a1ff05d2e49b80b999cb8f111e0c8691288'],0,2,2,681973,1,,,,2100
035870d333bd57b926a257a7713e60d2c122b9f6,0,Roger Meier,2014-10-22 23:43:05+02:00,['ba4a5f0009686f0b633b72d1127fc9ee8a26aba5'],1,1,2,681975,1,,,,2100
902b7af4c84b8f716668d4d4f10612c16109c09a,1,Jens Geyer,2014-10-23 19:36:36+02:00,['035870d333bd57b926a257a7713e60d2c122b9f6'],3,11,14,681989,1,0,1,1,2100
fdd8d13bd4e82c9e3e73f72e5556f5921e351fa0,1,Jens Geyer,2014-10-29 19:42:26+02:00,['902b7af4c84b8f716668d4d4f10612c16109c09a'],1,1,2,681991,1,,,,2100
cc15dff1274eebb8306e131530ef74e910f32ae9,1,Jens Geyer,2014-10-29 19:54:58+02:00,['fdd8d13bd4e82c9e3e73f72e5556f5921e351fa0'],2,11,13,682004,1,0,1,1,2100
5b0296064845240006a66e94037c90c0a6aad87f,0,jfarrell,2014-10-29 22:27:34-04:00,['cc15dff1274eebb8306e131530ef74e910f32ae9'],21,70,91,682095,1,0.678571429,0.678571429,1,2100
b5fd81658a0be1c88a93f31bc9745caae1f1331f,0,jfarrell,2014-10-29 23:19:23-04:00,['5b0296064845240006a66e94037c90c0a6aad87f'],1,1,2,682097,1,,,,2100
6f28c04560e69b455932efe183ed3b00ade49c70,0,Roger Meier,2014-11-01 20:31:44+01:00,['b5fd81658a0be1c88a93f31bc9745caae1f1331f'],2,2,4,682101,2,,,,2100
6e43b18526a92264dca8d3d0d6ac27b9fcdc1961,1,Jens Geyer,2014-11-01 22:35:17+02:00,['6f28c04560e69b455932efe183ed3b00ade49c70'],5,5,10,682111,1,,,,2100
3fa5d89e16e0ebdfaa096a7785d450b55404ea72,0,Roger Meier,2014-11-02 12:19:54+01:00,['6e43b18526a92264dca8d3d0d6ac27b9fcdc1961'],1,1,2,682113,1,,,,2100
4776166509cad7a2e3a624d39cbc2e97d9598311,0,Roger Meier,2014-11-02 12:20:53+01:00,['3fa5d89e16e0ebdfaa096a7785d450b55404ea72'],4,23,27,682140,3,,,,2100
591e20f9636c37527a70dc03598218c3468a0eff,0,jfarrell,2014-11-04 21:12:20-05:00,['4776166509cad7a2e3a624d39cbc2e97d9598311'],350,528,878,683018,34,,,,2100
e81367bb95714a4720d36c5bf3bb0386d4ae04c0,0,jfarrell,2014-11-05 07:06:58-05:00,['4776166509cad7a2e3a624d39cbc2e97d9598311'],0,1,1,683019,1,,,,2100
4f4b15ba2b89aa553f982cd36b1cd70fd82a156e,0,Roger Meier,2014-11-05 16:53:41+01:00,['e81367bb95714a4720d36c5bf3bb0386d4ae04c0'],543,542,1085,684104,22,,,,2100
cc092b37c8665384f2f7cb60d184a44f59ac3ba3,0,Konrad Grochowski,2014-11-05 19:00:54+01:00,['4f4b15ba2b89aa553f982cd36b1cd70fd82a156e'],4,13,17,684121,2,0.857142857,0.857142857,0.142857143,2100
b3f5ffc42d4c52e4a76ff429411164d27fb65b22,0,Konrad Grochowski,2014-11-06 19:32:59+01:00,['cc092b37c8665384f2f7cb60d184a44f59ac3ba3'],5,15,20,684141,6,0,1,0.818181818,2100
157872dd21879da84a02fbb7c2ea1816a8454a93,0,Konrad Grochowski,2014-11-06 19:55:28+01:00,['b3f5ffc42d4c52e4a76ff429411164d27fb65b22'],3,2,5,684146,2,,,,2100
a4b72eed2cd0ef4839874a69f76021c0267289f3,1,Jens Geyer,2014-11-06 21:14:04+01:00,['157872dd21879da84a02fbb7c2ea1816a8454a93'],6,8,14,684160,1,0,0,1,2100
fed887f9d9f563c123acafec9a0335e325e74a51,0,Konrad Grochowski,2014-11-07 18:28:00+01:00,['a4b72eed2cd0ef4839874a69f76021c0267289f3'],4,39,43,684203,4,,,,2101
71bd360f048f087d00fffc77605eff22f223fcf4,0,Roger Meier,2014-11-08 23:13:13+01:00,['fed887f9d9f563c123acafec9a0335e325e74a51'],6,6,12,684215,1,,,,2101
4712f8c2e36fabfb00cfc67a6ecf5d6de20e3c18,0,Roger Meier,2014-11-08 23:19:02+01:00,['71bd360f048f087d00fffc77605eff22f223fcf4'],1,1,2,684217,1,,,,2101
bd52f1a1dd0a45aa01c551cdb15338ff3ac82a02,1,Jens Geyer,2014-11-09 01:58:25+01:00,['4712f8c2e36fabfb00cfc67a6ecf5d6de20e3c18'],1,10917,10918,695135,91,0.116404715,0.342829077,0.667485265,2182
fea00ac871202a819c5bc88cf0cc18ed5edcc84a,1,Jens Geyer,2014-11-09 01:58:29+01:00,['bd52f1a1dd0a45aa01c551cdb15338ff3ac82a02'],302,1426,1728,696863,40,0,0,0,2200
b502832c7930ba08700f10928cadb49c020ba93f,0,Jens Geyer,2014-11-09 02:50:33+01:00,['fea00ac871202a819c5bc88cf0cc18ed5edcc84a'],4370,4378,8748,705611,60,,,,2200
0c449122dd2d871f560a1a9b4730a6077a967a05,1,Jens Geyer,2014-11-09 16:25:05+01:00,['b502832c7930ba08700f10928cadb49c020ba93f'],2,6,8,705619,1,,,,2200
9fdc90ad64bdbc75314f71da8fbce71501a5b131,0,Konrad Grochowski,2014-11-10 18:21:44+01:00,['0c449122dd2d871f560a1a9b4730a6077a967a05'],0,1,1,705620,1,,,,2200
1cf9612a7064cc1676f242eaa70af201793e390e,0,Konrad Grochowski,2014-11-10 19:07:40+01:00,['9fdc90ad64bdbc75314f71da8fbce71501a5b131'],2,2,4,705624,1,,,,2200
4c33094050e48222b0b9ecb837644d8ef1619c1c,0,Jens Geyer,2014-11-10 21:22:34+01:00,['1cf9612a7064cc1676f242eaa70af201793e390e'],0,5,5,705629,1,1,1,1,2200
6794c624854e86fa9b73f36cac70b583a3629d02,0,Jens Geyer,2014-11-11 00:11:16+01:00,['4c33094050e48222b0b9ecb837644d8ef1619c1c'],11,2,13,705642,1,1,0,0,2200
65e9bde0ede772c9148e33ccc9be7f92eeeb9638,1,Jens Geyer,2014-11-11 01:35:21+01:00,['6794c624854e86fa9b73f36cac70b583a3629d02'],42,319,361,706003,13,,,,2204
96dfcd5c5d25df035c8e3ebd29cb160fb54fd822,1,Jens Geyer,2014-11-11 01:35:24+01:00,['65e9bde0ede772c9148e33ccc9be7f92eeeb9638'],86,94,180,706183,1,1,1,0,2204
e5ff9a860d69fbd6cc6d6cb79833930e1148e4c0,1,Jens Geyer,2014-11-11 01:39:38+01:00,['96dfcd5c5d25df035c8e3ebd29cb160fb54fd822'],23,808,831,707014,11,,,,2208
565ea0c497c78cc62a7c8c980992f10a3d278c20,0,Jens Geyer,2014-11-14 21:29:19+01:00,['e5ff9a860d69fbd6cc6d6cb79833930e1148e4c0'],2,2,4,707018,1,,,,2208
38f2a2aed3eace2a9c6e715a2dd7a98a13c76e95,0,Jens Geyer,2014-11-14 22:30:16+01:00,['565ea0c497c78cc62a7c8c980992f10a3d278c20'],1,1,2,707020,1,,,,2208
e38f1e2dc2aa5a3c232c54400a5609074f7c2476,0,Jens Geyer,2014-11-14 22:31:22+01:00,['38f2a2aed3eace2a9c6e715a2dd7a98a13c76e95'],1,11,12,707032,1,0.666666667,1,0.666666667,2208
8c12b19eb7645dc9f8a9996d6d5d3e3a0a57fa05,0,Konrad Grochowski,2014-11-15 12:57:23+01:00,['e38f1e2dc2aa5a3c232c54400a5609074f7c2476'],1,0,1,707033,1,,,,2208
b2652300c0eabfd375786e3733c3c90b810fdb34,1,Randy Abernethy,2014-11-15 12:02:57-08:00,['8c12b19eb7645dc9f8a9996d6d5d3e3a0a57fa05'],59,66,125,707158,3,,,,2208
182411406a5f8128077ecb1fba097fb8625da337,0,Jens Geyer,2014-11-15 23:51:39+01:00,['b2652300c0eabfd375786e3733c3c90b810fdb34'],6,6,12,707170,3,,,,2208
b029aa8b8245d3ed42507e4174c19a08e41db8ee,1,Jens Geyer,2014-11-15 23:54:16+01:00,['182411406a5f8128077ecb1fba097fb8625da337'],8,26,34,707204,2,,,,2208
8c16ed79c4d2d384f11275f526f9ca34cab77b3e,1,Randy Abernethy,2014-11-15 21:29:18-08:00,['b029aa8b8245d3ed42507e4174c19a08e41db8ee'],1,1,2,707206,1,,,,2208
c118db2ce4423e725da2ada57998bc857e3e411a,0,Randy Abernethy,2014-11-15 22:21:36-08:00,['8c16ed79c4d2d384f11275f526f9ca34cab77b3e'],5,5,10,707216,2,,,,2208
2e091f681b48562f7b9706c77243787901963e44,1,Randy Abernethy,2014-11-15 23:05:22-08:00,['c118db2ce4423e725da2ada57998bc857e3e411a'],26,438,464,707680,6,0.545454545,0.584415584,0.831168831,2210
5effab65e38d1e4170d21e92c150d34375aab872,1,Roger Meier,2014-11-16 22:31:33+01:00,['2e091f681b48562f7b9706c77243787901963e44'],30,165,195,707875,1,,,,2210
6fb5923711a1ad9e90f7b55f724be5db5e299bbf,1,Roger Meier,2014-11-16 22:41:20+01:00,['5effab65e38d1e4170d21e92c150d34375aab872'],666,1072,1738,709613,54,1,1,0.696629213,2210
1cdf2504e0e3cc04ded8fc6e48431a1459ea27cf,1,jfarrell,2014-11-16 22:37:57-05:00,['6fb5923711a1ad9e90f7b55f724be5db5e299bbf'],1,1,2,709615,1,,,,2210
ca7e97e0423e785bd7a6b7b8400e67897975e7f6,1,Jens Geyer,2014-11-18 02:17:10+01:00,['1cdf2504e0e3cc04ded8fc6e48431a1459ea27cf'],6,81,87,709702,1,0,0,1,2210
74260aa9099c3bb209bc8e524b0e8ba603f62c41,0,Konrad Grochowski,2014-11-18 10:02:08+01:00,['ca7e97e0423e785bd7a6b7b8400e67897975e7f6'],28035,24382,52417,762119,235,0.708430008,0.492910544,0.227635989,2211
240120c8434b49d1f76d207aff4e3530d3ada14b,0,Konrad Grochowski,2014-11-18 11:33:31+01:00,['74260aa9099c3bb209bc8e524b0e8ba603f62c41'],24382,28035,52417,814536,235,0.291569992,0.507089456,0.772364011,2211
16a23a6618754a5a87aeb8df99a72516b0272fb3,1,Konrad Grochowski,2014-11-18 11:39:10+01:00,['240120c8434b49d1f76d207aff4e3530d3ada14b'],28036,24382,52418,866954,235,0.727754237,0.506355932,0.230667373,2212
0a93dcde9fff3b04cd37386bb2461e62dec3ed01,0,jfarrell,2014-11-18 08:45:41-05:00,['16a23a6618754a5a87aeb8df99a72516b0272fb3'],1,1,2,866956,1,,,,2212
9c0316bbf382860019e434e10955d3ac4186b830,0,Randy Abernethy,2014-11-18 12:11:31-08:00,['0a93dcde9fff3b04cd37386bb2461e62dec3ed01'],5,2,7,866963,1,1,0,0.5,2212
2f971e8f742fcaa0c84cfcc4f02eb844123e5819,1,Jens Geyer,2014-11-18 22:18:09+01:00,['9c0316bbf382860019e434e10955d3ac4186b830'],57,189,246,867209,3,0,0.932773109,1,2212
0dd4801ce5cd45ca076b1c716fa6f94f418731a2,0,Jens Geyer,2014-11-18 22:18:13+01:00,['2f971e8f742fcaa0c84cfcc4f02eb844123e5819'],2,9,11,867220,1,0,0,1,2212
5f9bdffd2aefb3e1d1b0cc717f0e7dc5a2a16ad7,1,Jens Geyer,2014-11-18 22:18:15+01:00,['0dd4801ce5cd45ca076b1c716fa6f94f418731a2'],0,529,529,867749,3,0.348066298,0.533149171,0.914364641,2215
6a4589aa4fc2634bd0dcb37ab5782c9d39d28b41,0,Randy Abernethy,2014-11-18 21:25:59-08:00,['5f9bdffd2aefb3e1d1b0cc717f0e7dc5a2a16ad7'],9,9,18,867767,1,,,,2215
ba302396876cf5858b640b634efd5ba9f49c5f1c,1,Randy Abernethy,2014-11-19 18:09:58-08:00,['6a4589aa4fc2634bd0dcb37ab5782c9d39d28b41'],0,335,335,868102,2,,,,2217
ea2fbcfc917ea84f5f367fbbc5ea5bffe023eae8,0,jfarrell,2014-11-21 10:06:55-05:00,['ba302396876cf5858b640b634efd5ba9f49c5f1c'],1,1,2,868104,1,,,,2217
e50f12a5ff6cd2660d7a4853318dd651ab3794a3,0,Jens Geyer,2014-11-22 21:58:59+01:00,['ea2fbcfc917ea84f5f367fbbc5ea5bffe023eae8'],13,0,13,868117,1,,,,2217
eab29a0da9eb775bb7e1e7cff6b4eeaecf237151,0,Jens Geyer,2014-11-22 22:06:58+01:00,['e50f12a5ff6cd2660d7a4853318dd651ab3794a3'],1,5,6,868123,5,,,,2217
3b5dacba44e4fa5c07c8b828d2f65215f9c91e34,0,Konrad Grochowski,2014-11-24 10:55:31+01:00,['eab29a0da9eb775bb7e1e7cff6b4eeaecf237151'],132,132,264,868387,72,,,,2217
05fb842f6dcb5d359809a0eaaad8366bdea389f7,0,Konrad Grochowski,2014-11-24 11:16:54+01:00,['3b5dacba44e4fa5c07c8b828d2f65215f9c91e34'],0,26,26,868413,1,,,,2217
28d9315de806fed4ce93a020a2ef1bb4a384b2dd,0,Konrad Grochowski,2014-11-24 11:36:20+01:00,['05fb842f6dcb5d359809a0eaaad8366bdea389f7'],7,7,14,868427,1,,,,2217
cb0afcc0353af24b111dc000a98915580768c8bb,0,Jens Geyer,2014-11-24 22:55:42+01:00,['28d9315de806fed4ce93a020a2ef1bb4a384b2dd'],2,33,35,868462,2,0.137931034,0.137931034,1,2217
740db54d1aaad2ae185982d38e4179091b9495ab,0,Jens Geyer,2014-11-25 00:37:33+01:00,['cb0afcc0353af24b111dc000a98915580768c8bb'],3,1,4,868466,1,,,,2217
1e7971cfff020be14bd30114f0dfe264797f259a,0,Jens Geyer,2014-11-25 21:43:54+01:00,['740db54d1aaad2ae185982d38e4179091b9495ab'],21,1,22,868488,5,0,0,0,2217
eed6a6d657a131fde14b994fc8f18491c058bfe4,0,Jens Geyer,2014-11-28 00:54:55+01:00,['1e7971cfff020be14bd30114f0dfe264797f259a'],0,2,2,868490,1,0,0,0,2217
406e7956c1a5ac83b74e12cce52f7159ed708211,1,Jens Geyer,2014-11-29 19:05:46+01:00,['eed6a6d657a131fde14b994fc8f18491c058bfe4'],29,43,72,868562,1,0,0,1,2217
d35f616c7324d1d50651bcf035b3e2bc40a1a3a3,0,Jens Geyer,2014-11-29 19:23:19+01:00,['406e7956c1a5ac83b74e12cce52f7159ed708211'],10,205,215,868777,5,,,,2219
05c1bff7e8e92c6acd715237c1e6a58da78a69b5,0,Jens Geyer,2014-11-29 23:42:56+01:00,['d35f616c7324d1d50651bcf035b3e2bc40a1a3a3'],8,6,14,868791,1,,,,2219
6aeb82ef5d5c90311d9514aa6082b55cb2663ca2,0,Jens Geyer,2014-11-29 23:47:11+01:00,['05c1bff7e8e92c6acd715237c1e6a58da78a69b5'],14,90,104,868895,2,0.62962963,0.740740741,0.777777778,2220
200150d330b0f2ad986ff4993f1c45c64e4736a3,1,Jens Geyer,2014-11-30 12:29:37+01:00,['6aeb82ef5d5c90311d9514aa6082b55cb2663ca2'],0,4,4,868899,2,,,,2220
527b6d9c86a7e5cde14cbb09a0e3103be0791c3a,1,Jens Geyer,2014-11-30 15:24:08+01:00,['200150d330b0f2ad986ff4993f1c45c64e4736a3'],31,612,643,869542,6,0.025806452,0.137634409,0.223655914,2223
ffa255cac5487c46729771bec7c93402d443216d,1,Jens Geyer,2014-12-01 02:15:54+01:00,['527b6d9c86a7e5cde14cbb09a0e3103be0791c3a'],211,732,943,870485,3,0.403100775,0.503875969,0.976744186,2224
dae6d3cbd14c505cdafc3f98992ca16a57b68f7e,0,Konrad Grochowski,2014-12-01 11:26:07+01:00,['ffa255cac5487c46729771bec7c93402d443216d'],133,139,272,870757,6,0,0,0.444444444,2224
9462ce388e0607b5f9200b4e3f50d096130456e7,0,Konrad Grochowski,2014-12-01 12:11:31+01:00,['dae6d3cbd14c505cdafc3f98992ca16a57b68f7e'],5,12,17,870774,1,1,1,1,2224
6ce1e73d71eb15d48c84e1f7a187d198d9a91b1b,1,Konrad Grochowski,2014-12-01 19:30:33+01:00,['9462ce388e0607b5f9200b4e3f50d096130456e7'],363,526,889,871663,1,0.0125,0.025,0.85625,2224
4bf97c196aba9e50289333c15336ad109fc87f2d,0,Roger Meier,2014-12-02 00:10:11+01:00,['6ce1e73d71eb15d48c84e1f7a187d198d9a91b1b'],6,2,8,871671,1,,,,2224
fc1303e2b59e47fc3bdecf17bce84b50a4092155,0,Roger Meier,2014-12-02 00:11:54+01:00,['4bf97c196aba9e50289333c15336ad109fc87f2d'],4,17,21,871692,1,0.5,0.833333333,0.333333333,2224
3a5252999d88cc2eaca76469e60a24969ec77da6,0,Roger Meier,2014-12-02 00:14:11+01:00,['fc1303e2b59e47fc3bdecf17bce84b50a4092155'],1,6,7,871699,1,1,1,1,2224
878483759c55365ef5da07ad8915e9a8e4af88d9,0,Randy Abernethy,2014-12-02 05:42:00-08:00,['3a5252999d88cc2eaca76469e60a24969ec77da6'],5,19,24,871723,2,0.857142857,0.857142857,0.857142857,2224
78c57e1720995821d80009dd99698b3a34f52e93,0,Jens Geyer,2014-12-02 21:22:04+01:00,['878483759c55365ef5da07ad8915e9a8e4af88d9'],1,1,2,871725,1,,,,2224
fb05cf67db2d9515186acb94aa41160d2a1281fc,1,Jens Geyer,2014-12-04 21:52:28+01:00,['78c57e1720995821d80009dd99698b3a34f52e93'],3,14,17,871742,2,0.083333333,0.083333333,1,2224
37b7a0afe081c04402d011b652eca4ba39cdf69b,0,Konrad Grochowski,2014-12-04 22:35:39+01:00,['fb05cf67db2d9515186acb94aa41160d2a1281fc'],18,2,20,871762,1,0,0,0.2,2224
6794698a12b32d15e2bb7c627d813514c41be0b2,0,Konrad Grochowski,2014-12-04 23:22:41+01:00,['37b7a0afe081c04402d011b652eca4ba39cdf69b'],1,1,2,871764,1,,,,2224
9db4b51b667e3d442c30c5bc06fa07bc96ef191b,0,Konrad Grochowski,2014-12-04 23:32:52+01:00,['6794698a12b32d15e2bb7c627d813514c41be0b2'],0,19,19,871783,1,0,1,1,2224
3de6b8fe23af201caa86fff51bd6dcd745bd4123,0,Roger Meier,2014-12-06 16:30:03+01:00,['9db4b51b667e3d442c30c5bc06fa07bc96ef191b'],4,4,8,871791,2,,,,2224
bf9603c77e9605fc1466d825d77e8867f32b770c,0,Roger Meier,2014-12-06 18:52:35+01:00,['3de6b8fe23af201caa86fff51bd6dcd745bd4123'],1,1,2,871793,1,,,,2224
4c1fde226ebe601d673a3457c71fe48902ce5e2d,0,Konrad Grochowski,2014-12-06 19:54:26+01:00,['bf9603c77e9605fc1466d825d77e8867f32b770c'],16,16,32,871825,2,,,,2224
0494987fd16f4892dbca9c6a22aa5af0e5b20fc5,0,Konrad Grochowski,2014-12-06 20:09:10+01:00,['4c1fde226ebe601d673a3457c71fe48902ce5e2d'],16,15,31,871856,1,0,0,1,2224
71067a80908af91e73aac5dc31d672f13085dabd,0,Roger Meier,2014-12-07 14:02:45+01:00,['0494987fd16f4892dbca9c6a22aa5af0e5b20fc5'],0,0,0,871856,1,,,,2224
d0d7a6558112b2abe9dd21ef562d7de8e2ea7d58,1,Roger Meier,2014-12-07 17:00:02+01:00,['71067a80908af91e73aac5dc31d672f13085dabd'],2,167,169,872025,5,0.6,0.8875,1,2225
38a1c66428af48e59ff15f3ef40b04128ba52036,0,Roger Meier,2014-12-08 20:54:46+01:00,['d0d7a6558112b2abe9dd21ef562d7de8e2ea7d58'],3,3,6,872031,1,,,,2225
57cd421de3b681b4e401dcc5d965671362663998,1,Jens Geyer,2014-12-08 21:31:33+01:00,['38a1c66428af48e59ff15f3ef40b04128ba52036'],7,6,13,872044,1,,,,2225
1f42d315759a725f9c2846b0996d03128e2f1887,1,Jens Geyer,2014-12-08 21:49:54+01:00,['57cd421de3b681b4e401dcc5d965671362663998'],16,255,271,872315,3,0,0.378504673,0.579439252,2225
3876ea70a28ad92f982b3b5acd4a234a61fae33b,0,Konrad Grochowski,2014-12-09 15:24:56+01:00,['1f42d315759a725f9c2846b0996d03128e2f1887'],2,2,4,872319,1,,,,2225
40b2b64b16fe48d9290036259bf22738e4c33a08,0,Konrad Grochowski,2014-12-09 15:26:39+01:00,['3876ea70a28ad92f982b3b5acd4a234a61fae33b'],0,3,3,872322,1,,,,2225
119869a2041e6348027c161f144b0b3eeefb043c,1,Jens Geyer,2014-12-10 20:54:14+01:00,['40b2b64b16fe48d9290036259bf22738e4c33a08'],1,10,11,872333,1,1,1,1,2225
0a378709ab8b3b0de4bafde60a803da24096e8bd,0,Jens Geyer,2014-12-10 21:04:28+01:00,['119869a2041e6348027c161f144b0b3eeefb043c'],1,7,8,872341,1,0.5,0.5,0.5,2225
714a9aa1c544508e430d1d74a39202fc784df947,0,Konrad Grochowski,2014-12-12 16:03:40+01:00,['0a378709ab8b3b0de4bafde60a803da24096e8bd'],0,2,2,872343,1,,,,2225
3c5a788d8f243e23474b3ac09a795e4e15a8933f,1,Roger Meier,2014-12-13 21:22:47+01:00,['714a9aa1c544508e430d1d74a39202fc784df947'],14,92,106,872449,1,0.145833333,0.145833333,0,2225
de76a3772b5642d093765e2cf1de5b9e0201067c,0,Roger Meier,2014-12-13 21:29:55+01:00,['3c5a788d8f243e23474b3ac09a795e4e15a8933f'],3,11,14,872463,2,1,1,1,2225
a195a2574ef9729da9be65283d29b87e39e8ebcb,1,Roger Meier,2014-12-13 21:36:25+01:00,['de76a3772b5642d093765e2cf1de5b9e0201067c'],3,5,8,872471,2,,,,2225
d5f87e1f2135f51d6b9ab019f23891f3b1aeceec,1,Roger Meier,2014-12-13 22:02:29+01:00,['a195a2574ef9729da9be65283d29b87e39e8ebcb'],55,1647,1702,874173,19,,,,2242
54d3969e44af71317218b003b9ff7ae9c77ea707,0,Roger Meier,2014-12-13 22:02:29+01:00,['d5f87e1f2135f51d6b9ab019f23891f3b1aeceec'],3,15,18,874191,1,,,,2242
4991574b5e9696dd405afe80588cc2278149c80d,0,Jens Geyer,2014-12-13 23:48:33+01:00,['54d3969e44af71317218b003b9ff7ae9c77ea707'],10,1,11,874202,1,0,0,0,2242
d8bddbcefba85bb70cf2ae97f2d87ae092ffefad,1,Jens Geyer,2014-12-14 00:41:33+01:00,['4991574b5e9696dd405afe80588cc2278149c80d'],18,131,149,874351,2,,,,2242
15fe1cb5f434a5b4dcba49e3547365d705ac8f84,1,Jens Geyer,2014-12-14 03:18:18+01:00,['d8bddbcefba85bb70cf2ae97f2d87ae092ffefad'],0,6,6,874357,1,0,1,1,2242
9f9535c5fbe0973ae803112075bff65b83bd7636,0,Jens Geyer,2014-12-14 15:00:34+01:00,['15fe1cb5f434a5b4dcba49e3547365d705ac8f84'],1,2,3,874360,2,,,,2242
a792e5d5ac8747f7f0d4b59c3a631bb86159fe18,1,Jens Geyer,2014-12-16 22:59:02+01:00,['9f9535c5fbe0973ae803112075bff65b83bd7636'],2,4,6,874366,1,,,,2242
3bb34df8f325d93e21069da6735867edf62816f3,1,Jens Geyer,2014-12-18 00:14:46+01:00,['a792e5d5ac8747f7f0d4b59c3a631bb86159fe18'],160,211,371,874737,4,0.948717949,0.948717949,1,2242
c61b3a8170e0decf2a4e863c89bf34acc16b0363,0,Jens Geyer,2014-12-18 21:48:42+01:00,['3bb34df8f325d93e21069da6735867edf62816f3'],5,8,13,874750,1,0,0,0,2242
20b51b667ba97dac72d5618114996c1fbd173006,0,Jens Geyer,2014-12-18 22:15:49+01:00,['c61b3a8170e0decf2a4e863c89bf34acc16b0363'],1,1,2,874752,1,,,,2242
80784b1098d95232b329cdec6e8f056d10380409,1,Roger Meier,2014-12-18 22:20:55+01:00,['20b51b667ba97dac72d5618114996c1fbd173006'],2,2,4,874756,1,,,,2242
6af074e4194f4568739c3dd7176bb23b8b18d150,0,Jens Geyer,2014-12-18 22:34:53+01:00,['80784b1098d95232b329cdec6e8f056d10380409'],0,3,3,874759,1,1,1,1,2242
ec8d8778b51341a7c661f05e3e84465f437fd006,1,Konrad Grochowski,2014-12-20 12:50:30+01:00,['6af074e4194f4568739c3dd7176bb23b8b18d150'],10,12,22,874781,2,,,,2242
38bf23404c8caad07766023d2861d1316be23080,0,Konrad Grochowski,2014-12-20 13:23:27+01:00,['ec8d8778b51341a7c661f05e3e84465f437fd006'],1,1,2,874783,1,,,,2242
051ea1cf2fe202deb2078017185a1a5b1c9d8cb7,0,Roger Meier,2014-12-20 22:43:24+01:00,['38bf23404c8caad07766023d2861d1316be23080'],1,1,2,874785,1,,,,2242
2825664f25e084a922462c77f496d215e41251a9,1,Roger Meier,2014-12-21 16:36:46+01:00,['051ea1cf2fe202deb2078017185a1a5b1c9d8cb7'],17,45,62,874847,11,,,,2242
6304a5341459eaa33e64aea80e0d0cc7d1b0b765,1,Roger Meier,2014-12-21 16:36:46+01:00,['2825664f25e084a922462c77f496d215e41251a9'],9,114,123,874970,5,1,1,0.909090909,2243
6622877a09a1ec6d38132bcdc9ac9a856d1c3931,1,Roger Meier,2014-12-21 16:36:47+01:00,['6304a5341459eaa33e64aea80e0d0cc7d1b0b765'],3,149,152,875122,10,,,,2246
a10697a9dbdfada8ed138f40c6ce5c1830c0daa8,1,Roger Meier,2014-12-21 16:36:47+01:00,['6622877a09a1ec6d38132bcdc9ac9a856d1c3931'],150,81,231,875353,2,,,,2246
6d9a3ca7d912482fb1321efae80a07eff9de2b85,1,Roger Meier,2014-12-21 17:38:58+01:00,['a10697a9dbdfada8ed138f40c6ce5c1830c0daa8'],26,39,65,875418,2,0,0,1,2246
1b17991f26e68c5b701c0d5f712a0f4eead16d4f,0,Roger Meier,2014-12-21 21:05:14+01:00,['6d9a3ca7d912482fb1321efae80a07eff9de2b85'],0,88,88,875506,1,0,0.970149254,0.970149254,2246
3e9c3a2af34fb8d2f37880e245e37e19dfb6edfa,1,Jens Geyer,2014-12-22 22:34:21+01:00,['1b17991f26e68c5b701c0d5f712a0f4eead16d4f'],11,16,27,875533,5,0,1,0.666666667,2246
2ac3a3c821dc35c3d7cd06978bc1bcfa5453951b,0,Jens Geyer,2014-12-23 18:18:58+01:00,['3e9c3a2af34fb8d2f37880e245e37e19dfb6edfa'],10,14,24,875557,2,,,,2246
4461a2fc16098227e850d689236b3b1bae6650da,1,Jens Geyer,2014-12-23 18:22:54+01:00,['2ac3a3c821dc35c3d7cd06978bc1bcfa5453951b'],4,9,13,875570,1,,,,2246
89dc20f4e05cca8f77bd9451c4091971eb6859ae,1,Jens Geyer,2014-12-24 02:39:53+01:00,['4461a2fc16098227e850d689236b3b1bae6650da'],0,4,4,875574,2,,,,2246
8c8e9c6a555f3b7f57cf1f214242918f2343ebbd,0,Jens Geyer,2014-12-29 19:52:47+01:00,['89dc20f4e05cca8f77bd9451c4091971eb6859ae'],1,9,10,875584,2,,,,2246
326cf0d0fbb6ef79358500b17fa0a9327d2e6df9,0,Jens Geyer,2014-12-29 23:56:12+01:00,['8c8e9c6a555f3b7f57cf1f214242918f2343ebbd'],0,2,2,875586,1,,,,2246
3a3ba00b97ac6c69108c770c0e5204dbe767bb2c,0,Jens Geyer,2014-12-30 00:10:06+01:00,['326cf0d0fbb6ef79358500b17fa0a9327d2e6df9'],1,1,2,875588,1,,,,2246
5c10fd8cb146181e1c835787167812fcf1cbf169,0,Jens Geyer,2014-12-30 16:15:57+01:00,['3a3ba00b97ac6c69108c770c0e5204dbe767bb2c'],0,1,1,875589,1,,,,2246
c444fb581d2157c260f36db091a7cdd4511c6e32,1,Roger Meier,2015-01-03 10:08:09+01:00,['5c10fd8cb146181e1c835787167812fcf1cbf169'],7,7,14,875603,3,,,,2246
a2d5dfd9f60baf2bf8629b62ba1dde78bcc371b0,0,Jens Geyer,2015-01-03 17:37:10+01:00,['c444fb581d2157c260f36db091a7cdd4511c6e32'],0,7,7,875610,1,,,,2246
71e814a9a2b7b15cf29c2527e7a81145c01fbde8,1,Jens Geyer,2015-01-03 17:37:14+01:00,['a2d5dfd9f60baf2bf8629b62ba1dde78bcc371b0'],0,58,58,875668,2,0.18,0.18,1,2246
fd1b3585596fdec749372f383208069d0ca1d9b0,1,Jens Geyer,2015-01-03 17:37:18+01:00,['71e814a9a2b7b15cf29c2527e7a81145c01fbde8'],6,69,75,875743,4,,,,2246
43e195afcd4cd3db67c7343271920af147e268e6,0,Jens Geyer,2015-01-03 17:37:22+01:00,['fd1b3585596fdec749372f383208069d0ca1d9b0'],0,72,72,875815,2,,,,2246
8bcfdd98ae59d840b677a485b74dda3953b4bcc1,1,Jens Geyer,2015-01-03 17:37:54+01:00,['43e195afcd4cd3db67c7343271920af147e268e6'],3,176,179,875994,39,0.987012987,0.987012987,0.857142857,2246
1d30558c8c09d08a60f6ddc602b6994cfc9f74b3,0,Roger Meier,2015-01-04 13:55:52+01:00,['8bcfdd98ae59d840b677a485b74dda3953b4bcc1'],0,2,2,875996,1,1,1,1,2246
8016af800ff19e2b67f691453c573f3d8f34211d,1,Roger Meier,2015-01-04 16:50:59+01:00,['1d30558c8c09d08a60f6ddc602b6994cfc9f74b3'],2,62,64,876060,4,0.741935484,0.032258065,1,2246
4f2c0a066f1d59c1d57a718e829eb67e488b3c62,0,Jens Geyer,2015-01-05 21:17:06+01:00,['8016af800ff19e2b67f691453c573f3d8f34211d'],2,4,6,876066,1,1,1,1,2246
4a78c6eb8670cbb664a199b1c98518033e51e525,1,Roger Meier,2015-01-06 23:57:26+01:00,['4f2c0a066f1d59c1d57a718e829eb67e488b3c62'],4,4,8,876074,2,,,,2246
f9c4be80a58f323fd4b960357885be3390c2be5c,0,Konrad Grochowski,2015-01-09 11:32:26+01:00,['4a78c6eb8670cbb664a199b1c98518033e51e525'],923,923,1846,877920,3,,,,2246
da80afe740ec2c97c22b806b96c9ac6650688908,1,Randy Abernethy,2015-01-09 14:32:24-08:00,['f9c4be80a58f323fd4b960357885be3390c2be5c'],0,1,1,877921,1,0,1,1,2246
307144a5b5539c169e4c3b52d1f58c1bf8b88dab,1,Jens Geyer,2015-01-20 22:40:38+01:00,['da80afe740ec2c97c22b806b96c9ac6650688908'],1,135,136,878057,3,0,0,0.716049383,2247
ce36aac5916ec02bf5b5a0be0684c079e797d000,1,Jens Geyer,2015-01-20 23:31:19+01:00,['307144a5b5539c169e4c3b52d1f58c1bf8b88dab'],11,14,25,878082,2,1,1,1,2247
7d88208945894aa4c2dfab0ef22163b807d58ce6,1,Jens Geyer,2015-01-28 00:52:45+01:00,['ce36aac5916ec02bf5b5a0be0684c079e797d000'],16,12,28,878110,4,1,1,0,2247
a7363f233fa3cd303d99592cabecb9dfcf3b795c,1,Jens Geyer,2015-01-28 00:54:48+01:00,['7d88208945894aa4c2dfab0ef22163b807d58ce6'],18,158,176,878286,1,0,0,0.487394958,2247
176c9261ed4008a90c0e94fb1007c152dec91ac3,0,Jens Geyer,2015-01-29 00:30:08+01:00,['a7363f233fa3cd303d99592cabecb9dfcf3b795c'],2,2,4,878290,1,,,,2247
4e16718e998df64e0e3c9a01ddb85af32f344933,0,jfarrell,2015-01-29 23:03:34-05:00,['176c9261ed4008a90c0e94fb1007c152dec91ac3'],6,81,87,878377,4,0.457142857,1,1,2248
8f2596ad546451c50e48425e37eddc9195c5807e,0,jfarrell,2015-01-29 23:42:05-05:00,['4e16718e998df64e0e3c9a01ddb85af32f344933'],2,66,68,878445,5,0.375,1,1,2250
5bde9f75b817e2a6e5f109ccfbbc52a63b33c374,1,Randy Abernethy,2015-01-31 06:19:21-08:00,['8f2596ad546451c50e48425e37eddc9195c5807e'],1,1,2,878447,1,,,,2250
662eea9e69b044fcfc3bb6c0f3e467057ea5a13d,0,Jens Geyer,2015-02-01 20:20:34+01:00,['5bde9f75b817e2a6e5f109ccfbbc52a63b33c374'],4,12,16,878463,1,,,,2250
4e1e132142f78cafa4e83526dd7a613833715cd3,0,Randy Abernethy,2015-02-02 04:43:23-08:00,['662eea9e69b044fcfc3bb6c0f3e467057ea5a13d'],3,101,104,878567,1,0,0,1,2250
1097c40ed0f36f44081d454dab7914673fb6ea07,0,Randy Abernethy,2015-02-02 05:18:59-08:00,['4e1e132142f78cafa4e83526dd7a613833715cd3'],1,1,2,878569,1,,,,2250
cf743d7ac7f198b841f820d9b241569b29c74677,0,Randy Abernethy,2015-02-02 05:56:14-08:00,['1097c40ed0f36f44081d454dab7914673fb6ea07'],28,28,56,878625,2,,,,2250
97c4398c382342a19920693a6318826c66fe7b7f,0,Randy Abernethy,2015-02-02 06:51:25-08:00,['cf743d7ac7f198b841f820d9b241569b29c74677'],4,4,8,878633,1,,,,2250
9d8c1bf6f62c22c13c5b6b4da51b1de1a9d27339,0,Roger Meier,2015-02-02 21:47:14+01:00,['97c4398c382342a19920693a6318826c66fe7b7f'],4,2,6,878639,2,,,,2250
1abd746b9cda67bf7a3f6d246c4181dcac515308,0,Roger Meier,2015-02-02 21:59:38+01:00,['9d8c1bf6f62c22c13c5b6b4da51b1de1a9d27339'],3,3,6,878645,1,,,,2250
208738a6e34c7153908bad77210c6d194ea9d3ab,0,Roger Meier,2015-02-02 22:04:29+01:00,['1abd746b9cda67bf7a3f6d246c4181dcac515308'],1,1,2,878647,1,,,,2250
a0c5ab711ef47142ca8abb55bc1d4ba139ef8129,1,Roger Meier,2015-02-02 22:06:39+01:00,['208738a6e34c7153908bad77210c6d194ea9d3ab'],0,20,20,878667,3,,,,2250
2f2d6ac7ea9b77bbfc8edf36980155473c6fd86c,0,henrique,2015-02-03 12:47:31+11:00,['a0c5ab711ef47142ca8abb55bc1d4ba139ef8129'],2,32,34,878701,1,0,0.6,0.4,2250
8e73137c278b1ac7f4a455217393a7e6348c0766,0,Randy Abernethy,2015-02-03 00:04:40-08:00,['2f2d6ac7ea9b77bbfc8edf36980155473c6fd86c'],15,79,94,878795,3,,,,2251
12d430e723b020f7a8ce42a40c19edf88f948367,1,Jens Geyer,2015-02-03 22:34:41+01:00,['8e73137c278b1ac7f4a455217393a7e6348c0766'],7,13,20,878815,1,0,0,0,2251
2663ec43ab5954d65d4bfb1509d963ac40019789,1,Jens Geyer,2015-02-03 22:45:18+01:00,['12d430e723b020f7a8ce42a40c19edf88f948367'],1,1,2,878817,1,,,,2251
b3654df14cd4b391943eeab8124735a005fa7454,1,Jens Geyer,2015-02-03 23:40:02+01:00,['2663ec43ab5954d65d4bfb1509d963ac40019789'],3,66,69,878886,1,0,0.681818182,0,2251
281bdae6b2e40694db57f19b0ee13eb51b575c39,1,Roger Meier,2015-02-03 23:45:21+01:00,['b3654df14cd4b391943eeab8124735a005fa7454'],4,6,10,878896,3,,,,2251
a7270074d31a25cd5e3965db7013446ac5d21c52,0,Randy Abernethy,2015-02-04 13:18:53-08:00,['281bdae6b2e40694db57f19b0ee13eb51b575c39'],12,8,20,878916,3,1,1,1,2251
2f34da70243675c4d8e04f368522046fe99dcb50,0,henrique,2015-02-05 12:39:34+11:00,['a7270074d31a25cd5e3965db7013446ac5d21c52'],5,11,16,878932,2,,,,2251
3bc6424c76c1c29da72fe16ad9d3014b09b02b0f,1,Konrad Grochowski,2015-02-05 12:15:19+01:00,['2f34da70243675c4d8e04f368522046fe99dcb50'],65,149,214,879146,28,,,,2277
468e63b36d7ae4c1071d358eefcb253d83704c27,1,Jens Geyer,2015-02-08 14:43:15+01:00,['3bc6424c76c1c29da72fe16ad9d3014b09b02b0f'],7,671,678,879824,3,,,,2278
c5026aaa3765ab1c8032984c00cc521679423b87,1,Roger Meier,2015-02-09 12:03:59+01:00,['468e63b36d7ae4c1071d358eefcb253d83704c27'],0,228,228,880052,1,,,,2279
e0ab13f63a5946ca4e98f3b5923ff15d9fca8c0f,0,Roger Meier,2015-02-09 12:08:07+01:00,['c5026aaa3765ab1c8032984c00cc521679423b87'],4,0,4,880056,1,,,,2279
17aa474938b6ffab6a7a2b328f6aa1a2b3a431be,0,Roger Meier,2015-02-09 12:09:19+01:00,['e0ab13f63a5946ca4e98f3b5923ff15d9fca8c0f'],2,14,16,880072,1,,,,2279
43509df15c6b20964e306636cea35cc57df397b6,0,Roger Meier,2015-02-09 20:27:49+01:00,['17aa474938b6ffab6a7a2b328f6aa1a2b3a431be'],1,1,2,880074,1,,,,2279
96f4f07beb758db9c17d1332b5d225b6b627538c,1,Randy Abernethy,2015-02-10 02:29:15-08:00,['43509df15c6b20964e306636cea35cc57df397b6'],2289,2692,4981,885055,28,0,0.361702128,0.680851064,2287
22dddc9fab9f48a242004ed96ccdd8f1c5c91a71,0,Jens Geyer,2015-02-12 23:12:17+01:00,['96f4f07beb758db9c17d1332b5d225b6b627538c'],1,239,240,885295,3,,,,2289
283899bf9a8de07522b6507dfd0f6ab70d5a7147,1,Roger Meier,2015-02-15 00:04:46+01:00,['22dddc9fab9f48a242004ed96ccdd8f1c5c91a71'],10,10,20,885315,5,,,,2289
0d964d8e520067c461f9dcef9f7654d43c8fba7f,1,Roger Meier,2015-02-15 19:24:50+01:00,['283899bf9a8de07522b6507dfd0f6ab70d5a7147'],0,17,17,885332,2,0.4,0.4,1,2289
ded6401da41fa20ca4d1614957ea09f72a300c02,0,Randy Abernethy,2015-02-15 11:28:40-08:00,['0d964d8e520067c461f9dcef9f7654d43c8fba7f'],375,375,750,886082,6,,,,2289
4702fe63c813cc521438c0ab437784befe1effbd,0,Roger Meier,2015-02-15 21:17:30+01:00,['ded6401da41fa20ca4d1614957ea09f72a300c02'],2,2,4,886086,2,,,,2289
3b9ff4de6e38eb2e0e17eacd22865e4b8ce27e37,1,Randy Abernethy,2015-02-16 00:51:24-08:00,['4702fe63c813cc521438c0ab437784befe1effbd'],1829,939,2768,888854,16,0.193473193,0,0.011655012,2292
d8187c5ff1d8b83d170cbce69282688be39df19c,1,Randy Abernethy,2015-02-16 01:25:53-08:00,['3b9ff4de6e38eb2e0e17eacd22865e4b8ce27e37'],248,836,1084,889938,16,0.856589147,0.837209302,0.848837209,2296
80aa53e6bcc766a985d7a05c20e85e21e2bdd65f,1,Jens Geyer,2015-02-18 23:25:13+01:00,['d8187c5ff1d8b83d170cbce69282688be39df19c'],1,14,15,889953,2,0,0,1,2296
e03f7e8e75f4ecb41b5f82a5fb9ae3712959e74c,1,jfarrell,2015-02-18 23:25:54-05:00,['80aa53e6bcc766a985d7a05c20e85e21e2bdd65f'],5,312,317,890270,19,,,,2300
2e0531608dfc40d5dd0bef250e7b1c805c06e8bc,0,Roger Meier,2015-02-19 17:27:53+01:00,['e03f7e8e75f4ecb41b5f82a5fb9ae3712959e74c'],1,1,2,890272,1,,,,2300
7f9fa8831f382cf3631acfb2ac8aa809459c4d95,0,henrique,2015-02-23 10:27:34+08:00,['2e0531608dfc40d5dd0bef250e7b1c805c06e8bc'],1,1,2,890274,1,,,,2300
12b06e4f8ccf90de5e993eaf9ed7bec450c723e6,1,Konrad Grochowski,2015-02-23 17:19:33+01:00,['7f9fa8831f382cf3631acfb2ac8aa809459c4d95'],19,49,68,890342,1,1,1,1,2300
8b14d179c4a5f6335989fa11ac3c1117daa2f86b,0,Jens Geyer,2015-02-27 00:27:00+01:00,['12b06e4f8ccf90de5e993eaf9ed7bec450c723e6'],1,12,13,890355,1,0,1,1,2300
2ad6c307be41c4ddc8ea2887acd93b9b3331cc6a,1,Jens Geyer,2015-02-27 00:39:36+01:00,['8b14d179c4a5f6335989fa11ac3c1117daa2f86b'],14,11,25,890380,3,,,,2300
bd60b92c6f31c871d5bd52debbe75394575cd786,1,Randy Abernethy,2015-02-26 16:59:14-08:00,['2ad6c307be41c4ddc8ea2887acd93b9b3331cc6a'],23,90,113,890493,4,0,0.220588235,0.985294118,2300
962e41078bb92656d4e28acfb717884e1ef57f5e,0,Jens Geyer,2015-02-27 22:53:00+01:00,['bd60b92c6f31c871d5bd52debbe75394575cd786'],2,17,19,890512,3,0.615384615,0.615384615,0.615384615,2300
00a4e3e802ea68fd992e1fa0061fe6f3f39872ee,1,Jens Geyer,2015-02-27 23:15:21+01:00,['962e41078bb92656d4e28acfb717884e1ef57f5e'],22,30,52,890564,1,0,0,1,2300
6b61601cc1c3ef5142ac000fcfc98634970d5d12,1,Roger Meier,2015-03-01 12:32:50+01:00,['00a4e3e802ea68fd992e1fa0061fe6f3f39872ee'],104,189,293,890857,12,0.779591837,0.983673469,1,2300
96eff17e50a8421bfa48072b2e2aa229b3169eb5,0,Jens Geyer,2015-03-02 02:12:45+01:00,['6b61601cc1c3ef5142ac000fcfc98634970d5d12'],2,2,4,890861,1,,,,2300
f0e63317c7132c57af822283c98235a4100bd517,1,Jens Geyer,2015-03-02 02:16:11+01:00,['96eff17e50a8421bfa48072b2e2aa229b3169eb5'],2,1090,1092,891953,6,,,,2301
f702fed427b1bd5443ae11ab591e313c269ab5b6,0,Randy Abernethy,2015-03-03 08:14:12-08:00,['f0e63317c7132c57af822283c98235a4100bd517'],3,5,8,891961,1,1,1,0.5,2301
3811e59c15af82b14413520b377a4d225f8f0e5a,0,Jens Geyer,2015-03-03 21:35:36+01:00,['f702fed427b1bd5443ae11ab591e313c269ab5b6'],0,1,1,891962,1,0,0,0,2301
a6ea4442dddfac1342835a30b1c8a81adb207a46,1,Jens Geyer,2015-03-03 21:35:40+01:00,['3811e59c15af82b14413520b377a4d225f8f0e5a'],2,25,27,891989,1,,,,2301
eda0f844ee5f564aa50e5d406b0ff0350beba9f6,1,Jens Geyer,2015-03-03 21:35:44+01:00,['a6ea4442dddfac1342835a30b1c8a81adb207a46'],0,3,3,891992,1,0,0,1,2301
6f7399b355b77b3e6dc32ffa475d42493afe2d90,0,Roger Meier,2015-03-04 14:32:59+01:00,['eda0f844ee5f564aa50e5d406b0ff0350beba9f6'],7,0,7,891999,2,1,1,0,2301
426ab8680126ac914c566adbcda3d6e93d57df64,1,Jens Geyer,2015-03-05 23:43:23+01:00,['6f7399b355b77b3e6dc32ffa475d42493afe2d90'],73,1162,1235,893234,9,,,,2305
8cc78c101a86e9d200a09996e75f3cabec18bad4,0,Jens Geyer,2015-03-06 01:26:13+01:00,['426ab8680126ac914c566adbcda3d6e93d57df64'],2,8,10,893244,2,,,,2305
65ee9838bcfe1da945647b27f8db98ea573e5def,0,Jens Geyer,2015-03-06 01:27:48+01:00,['8cc78c101a86e9d200a09996e75f3cabec18bad4'],30,58,88,893332,9,,,,2306
624781c1c4b89dce9f48fa80b841b5cd3d93aebb,0,Jens Geyer,2015-03-06 02:12:29+01:00,['65ee9838bcfe1da945647b27f8db98ea573e5def'],0,3,3,893335,1,,,,2306
d6834409b4876592b6aae036e8d6e9c6ffc814d8,0,Jens Geyer,2015-03-07 14:24:55+01:00,['624781c1c4b89dce9f48fa80b841b5cd3d93aebb'],6,14,20,893355,1,,,,2306
c7cf379aaede7df0f6117008a561c1ba9aa73044,0,Jens Geyer,2015-03-07 14:24:58+01:00,['d6834409b4876592b6aae036e8d6e9c6ffc814d8'],0,4,4,893359,1,,,,2306
28c1c19f913a4bee97a8309cf4b65914f705faea,1,Jens Geyer,2015-03-07 14:25:00+01:00,['c7cf379aaede7df0f6117008a561c1ba9aa73044'],20,79,99,893458,4,1,1,1,2308
1d1bca2738febb87bf132d041a73cd8da5a6328b,1,Jens Geyer,2015-03-14 16:38:43+02:00,['28c1c19f913a4bee97a8309cf4b65914f705faea'],15,101,116,893574,4,0.380952381,1,1,2310
aad5de793097307e67be78a8d029d3170e229b91,0,Randy Abernethy,2015-03-15 08:26:23-07:00,['1d1bca2738febb87bf132d041a73cd8da5a6328b'],1,1,2,893576,1,,,,2310
65cf6c14da72a5122f4f52e228b6f3fcd68ccb7d,0,Randy Abernethy,2015-03-15 17:38:19-07:00,['aad5de793097307e67be78a8d029d3170e229b91'],4,4,8,893584,1,,,,2310
43ceaf7cf5f414fe03d857aee1f7199036d2f62f,0,Jens Geyer,2015-03-17 00:39:36+02:00,['65cf6c14da72a5122f4f52e228b6f3fcd68ccb7d'],15,47,62,893646,1,0,0,1,2310
d565e2f496ab894e737b143cf71c2f5e3cee871b,1,jfarrell,2015-03-18 21:02:47-04:00,['43ceaf7cf5f414fe03d857aee1f7199036d2f62f'],28,28,56,893702,5,,,,2310
0cfdf7cb9de0657f01882e356f447651914e4a21,0,Jens Geyer,2015-03-19 04:08:18+02:00,['d565e2f496ab894e737b143cf71c2f5e3cee871b'],1,18,19,893721,1,,,,2310
e6789480d262357d4de4ab608267165c79631cb3,1,Roger Meier,2015-03-23 20:41:15+01:00,['0cfdf7cb9de0657f01882e356f447651914e4a21'],35,289,324,894045,3,0.492647059,0.558823529,1,2312
2bb6f51dda6838a7d7c946d4a0ee50f40bcda54b,0,Roger Meier,2015-03-23 20:56:27+01:00,['e6789480d262357d4de4ab608267165c79631cb3'],15,12,27,894072,5,1,1,1,2312
47accfc802d040386c83fcfd1199d60012c47757,1,Roger Meier,2015-03-24 21:01:46+01:00,['2bb6f51dda6838a7d7c946d4a0ee50f40bcda54b'],5,5,10,894082,2,,,,2312
a2d12b6ee3d9aa66f2c16dc6a5ee6eef5f1eba92,0,Roger Meier,2015-03-24 21:15:06+01:00,['47accfc802d040386c83fcfd1199d60012c47757'],13,13,26,894108,2,,,,2312
41ad4342c5a0389ab2cf2dbf098086413ac01204,1,Roger Meier,2015-03-24 22:30:40+01:00,['a2d12b6ee3d9aa66f2c16dc6a5ee6eef5f1eba92'],612,2416,3028,897136,43,0.674220963,0.862606232,0.679886686,2321
cada37008ce6e609fe6312596d3ced760e5cd60c,0,Randy Abernethy,2015-03-26 16:03:08-07:00,['41ad4342c5a0389ab2cf2dbf098086413ac01204'],8,5,13,897149,1,0.333333333,0.333333333,0,2321
58ed1cdf3cd4da9d013e4cd4b92b3f4e440d145d,0,Roger Meier,2015-03-29 14:39:32+02:00,['cada37008ce6e609fe6312596d3ced760e5cd60c'],1,1,2,897151,1,,,,2321
f5b795d3be6acc0da30afc4b4aa77e531125eec6,1,Roger Meier,2015-03-29 14:39:32+02:00,['58ed1cdf3cd4da9d013e4cd4b92b3f4e440d145d'],1469,139,1608,898759,8,0.555555556,1,1,2321
664dd0a0130546d59e7398e72c1af09c692e5a6f,1,Randy Abernethy,2015-03-29 10:10:02-07:00,['f5b795d3be6acc0da30afc4b4aa77e531125eec6'],0,181,181,898940,1,0.75862069,1,0.827586207,2322
6fc2115e187e34101515aa0bb509d83549c157d0,1,Roger Meier,2015-03-29 20:56:04+02:00,['664dd0a0130546d59e7398e72c1af09c692e5a6f'],0,6,6,898946,1,0.6,0.6,1,2322
af577247c9b6af55f8828d56e10d4db7298cb97e,1,Jens Geyer,2015-03-30 23:44:51+02:00,['6fc2115e187e34101515aa0bb509d83549c157d0'],17,15,32,898978,2,1,0,0,2322
b149c4f0448c713ea2e76457c096c5c16d85cf23,0,Jens Geyer,2015-04-02 22:41:22+02:00,['af577247c9b6af55f8828d56e10d4db7298cb97e'],0,1,1,898979,1,,,,2322
c2145725e1c397167514cf3f4d659eabcb3d4eb3,1,Jens Geyer,2015-04-02 22:54:02+02:00,['b149c4f0448c713ea2e76457c096c5c16d85cf23'],2,802,804,899783,7,,,,2327
4aa95df383bfa13c46a4dc0b41672ec29d476300,1,Jens Geyer,2015-04-03 12:38:17+02:00,['c2145725e1c397167514cf3f4d659eabcb3d4eb3'],0,10,10,899793,2,,,,2327
434edf6d5d5f9705c1ebf3f711fd7e1b8efbb40d,0,Jens Geyer,2015-04-03 12:52:01+02:00,['4aa95df383bfa13c46a4dc0b41672ec29d476300'],1,1,2,899795,1,,,,2327
8ffabb02c2c07aee575149ad3a2043520ef82b85,0,Jens Geyer,2015-04-03 14:31:27+02:00,['434edf6d5d5f9705c1ebf3f711fd7e1b8efbb40d'],0,312,312,900107,4,1,1,0.90960452,2330
011445528fc779c27e8755c0af4ea5dff8c1005d,1,Roger Meier,2015-04-04 16:14:08+02:00,['8ffabb02c2c07aee575149ad3a2043520ef82b85'],11,177,188,900295,7,0.68,1,0.9,2332
3815e0b2dcd63ebfe245dcc41022c64a898bd667,0,Roger Meier,2015-04-04 16:26:30+02:00,['011445528fc779c27e8755c0af4ea5dff8c1005d'],0,1,1,900296,1,,,,2332
1dc265301d7d184438c163afd5bfd93918844603,1,Jens Geyer,2015-04-05 19:27:19+02:00,['3815e0b2dcd63ebfe245dcc41022c64a898bd667'],15,93,108,900404,2,0,1,0.508196721,2332
7fc33be18cdf995ac8b0845897f9b4ea3228c50f,0,Jens Geyer,2015-04-06 17:51:24+02:00,['1dc265301d7d184438c163afd5bfd93918844603'],0,3,3,900407,1,,,,2332
7848d887e010ad0abb8a6e5857a41108ee6455b7,0,Roger Meier,2015-04-07 20:46:48+02:00,['7fc33be18cdf995ac8b0845897f9b4ea3228c50f'],32,30,62,900469,3,1,1,0,2332
9226590dc075c9b8e9bc394dab25258d2ded45bf,0,Roger Meier,2015-04-07 22:12:20+02:00,['7848d887e010ad0abb8a6e5857a41108ee6455b7'],3,3,6,900475,1,,,,2332
38772c9c8d2eeb43fcf11ff2bff7729b8d76f431,1,Roger Meier,2015-04-07 22:38:25+02:00,['9226590dc075c9b8e9bc394dab25258d2ded45bf'],3,34,37,900512,1,0,0,1,2332
b5ebcd199c1b603cea652847bfc9177c60fb8e28,1,Roger Meier,2015-04-07 22:38:25+02:00,['38772c9c8d2eeb43fcf11ff2bff7729b8d76f431'],8,14,22,900534,1,0,0,1,2332
d732321bed8f3d3354229907c91b5b418bce608e,0,Roger Meier,2015-04-07 22:59:12+02:00,['b5ebcd199c1b603cea652847bfc9177c60fb8e28'],34,39,73,900607,1,,,,2332
b818185cf8b463cd96189ad75dfbe8ac99c54ba1,0,Roger Meier,2015-04-07 22:59:12+02:00,['d732321bed8f3d3354229907c91b5b418bce608e'],2,3,5,900612,1,,,,2332
e035c1a9c5e1304471cdd6284781628bb237aa44,0,Roger Meier,2015-04-07 23:05:31+02:00,['b818185cf8b463cd96189ad75dfbe8ac99c54ba1'],3,3,6,900618,1,,,,2332
7110ab29513a2606bf3c38b637f9853bba28f9ee,0,Roger Meier,2015-04-07 23:08:29+02:00,['e035c1a9c5e1304471cdd6284781628bb237aa44'],1,1,2,900620,1,,,,2332
8ccd634946077f8915385d5dbd320622b6e70ef3,0,Roger Meier,2015-04-07 23:23:31+02:00,['7110ab29513a2606bf3c38b637f9853bba28f9ee'],2,7,9,900629,1,0,0,1,2332
df71a2e7ac19704a89a232b83a5d06c1d2daf640,1,Roger Meier,2015-04-09 01:06:49+02:00,['8ccd634946077f8915385d5dbd320622b6e70ef3'],0,53,53,900682,1,,,,2333
86f7350f90c7432c9415cb43d003ff7e6385c258,0,Jens Geyer,2015-04-11 02:04:09+02:00,['df71a2e7ac19704a89a232b83a5d06c1d2daf640'],25,78,103,900785,10,1,1,0,2333
bb23eadca16f18afaee8e7f69c02f3456358cc6b,0,Roger Meier,2015-04-11 13:15:13+02:00,['86f7350f90c7432c9415cb43d003ff7e6385c258'],19,9,28,900813,3,,,,2333
6d71dc868873691a62b3cb28bf48dcb0e225fa95,0,Roger Meier,2015-04-12 09:58:22+02:00,['bb23eadca16f18afaee8e7f69c02f3456358cc6b'],1,1,2,900815,1,,,,2333
147a5a278a71e4652edb8f60043a057f26d60d1d,1,Roger Meier,2015-04-12 09:58:22+02:00,['6d71dc868873691a62b3cb28bf48dcb0e225fa95'],1,6,7,900822,2,,,,2333
5af3b8abf7df61e0fd7f92f65721ab593c920e34,0,Roger Meier,2015-04-12 11:41:55+02:00,['147a5a278a71e4652edb8f60043a057f26d60d1d'],2,0,2,900824,1,,,,2333
79e971e7de6bfe586872323e548e8c23f79c5f08,1,Roger Meier,2015-04-12 13:11:33+02:00,['5af3b8abf7df61e0fd7f92f65721ab593c920e34'],7,7,14,900838,1,,,,2333
2659381e7f94b825c0b1ff6e80a119035a4a0de5,1,Roger Meier,2015-04-12 16:10:35+02:00,['79e971e7de6bfe586872323e548e8c23f79c5f08'],3,129,132,900970,5,,,,2335
b1a35da9168cca5a7524ab9814161f024da145df,1,Roger Meier,2015-04-12 17:46:35+02:00,['2659381e7f94b825c0b1ff6e80a119035a4a0de5'],0,4,4,900974,1,0,0,1,2335
81b3c440c64a372b6e47f9cb50804bd60f83e83f,0,Roger Meier,2015-04-12 21:06:11+02:00,['b1a35da9168cca5a7524ab9814161f024da145df'],27,7,34,901008,9,,,,2335
5af78c8776a668c6b46a1eba33823a068d16f1f3,1,Roger Meier,2015-04-12 21:43:12+02:00,['81b3c440c64a372b6e47f9cb50804bd60f83e83f'],7,27,34,901042,9,,,,2335
5d0a8067851ab01369357ddb0ddf25782bd34ccc,0,Roger Meier,2015-04-12 21:45:11+02:00,['5af78c8776a668c6b46a1eba33823a068d16f1f3'],3,3,6,901048,1,,,,2335
19e32dc0ed5090d6cc464242ede7d862c146fc3b,0,Roger Meier,2015-04-12 22:03:00+02:00,['5d0a8067851ab01369357ddb0ddf25782bd34ccc'],0,24,24,901072,1,,,,2336
b1783a5722e7ab1669f5926c233ea40af0f3c924,0,Roger Meier,2015-04-12 22:08:20+02:00,['19e32dc0ed5090d6cc464242ede7d862c146fc3b'],2,4,6,901078,1,0.5,1,1,2336
932c3ee66e8bddf3619e063683a6047e7673b76c,0,Roger Meier,2015-04-12 22:11:04+02:00,['b1783a5722e7ab1669f5926c233ea40af0f3c924'],3,0,3,901081,1,1,0,0,2336
1673adf94a381d66db2f0a062c636b24937473f7,0,Roger Meier,2015-04-13 21:05:53+02:00,['932c3ee66e8bddf3619e063683a6047e7673b76c'],3,11,14,901095,2,,,,2336
a4fc440e51970c8c5d745ac118ba4ffdfdbd2191,0,Jens Geyer,2015-04-14 20:11:24+02:00,['1673adf94a381d66db2f0a062c636b24937473f7'],1,1,2,901097,1,,,,2336
efd14e7c2521c3210531f1893719905ea8a0835e,1,Roger Meier,2015-04-14 21:06:14+02:00,['a4fc440e51970c8c5d745ac118ba4ffdfdbd2191'],2,50,52,901149,4,0.7,0.7,1,2337
7726b03ac11c54502dad3a72c124c24fc17db1b3,1,Roger Meier,2015-04-14 21:47:58+02:00,['efd14e7c2521c3210531f1893719905ea8a0835e'],3,3,6,901155,1,,,,2337
afc3777f9b0904120369e67585e60e703f20ced8,0,Roger Meier,2015-04-14 21:50:31+02:00,['7726b03ac11c54502dad3a72c124c24fc17db1b3'],3,10,13,901168,1,0,0,1,2337
8f27189dfd2812a9aa5bd57ce7155fbc295440ad,1,Roger Meier,2015-04-14 22:05:50+02:00,['afc3777f9b0904120369e67585e60e703f20ced8'],21,1,22,901190,8,,,,2337
a242c28ba16012ba480c5fbac88bedceaf3aed57,1,Roger Meier,2015-04-14 22:14:41+02:00,['8f27189dfd2812a9aa5bd57ce7155fbc295440ad'],0,30,30,901220,2,0,0.642857143,1,2337
7f47792bf288c3dca049d04de06d57d2f060abba,1,Roger Meier,2015-04-15 22:04:49+02:00,['a242c28ba16012ba480c5fbac88bedceaf3aed57'],4,11,15,901235,3,,,,2337
fdf0198103fddf9cd43955da5eee9dc4c02ef9b4,0,Roger Meier,2015-04-15 22:04:49+02:00,['7f47792bf288c3dca049d04de06d57d2f060abba'],2,2,4,901239,1,,,,2337
f9c318ca9e4b176a9b0220f9c8e872089ac8e720,0,Jens Geyer,2015-04-16 21:29:20+02:00,['fdf0198103fddf9cd43955da5eee9dc4c02ef9b4'],5,5,10,901249,1,,,,2337
f332d16460b2d0e344a47cf43d9d8bf9953d2cdb,0,Jens Geyer,2015-04-16 22:11:11+02:00,['f9c318ca9e4b176a9b0220f9c8e872089ac8e720'],136,410,546,901795,4,0.333333333,1,0.984126984,2340
3b61971c8e8401e09919b3fb40b8e42bd27f9c71,0,Jens Geyer,2015-04-16 22:11:14+02:00,['f332d16460b2d0e344a47cf43d9d8bf9953d2cdb'],3,0,3,901798,1,1,1,0,2340
83494259d1ee7657b90bf8f2c234a3133cde8fa9,1,Roger Meier,2015-04-16 22:23:27+02:00,['3b61971c8e8401e09919b3fb40b8e42bd27f9c71'],9,24,33,901831,6,,,,2340
2aa04bf384a65e8a5ea3f996b790d231aa279626,0,Jens Geyer,2015-04-17 18:44:37+02:00,['83494259d1ee7657b90bf8f2c234a3133cde8fa9'],12,5,17,901848,1,1,1,0,2340
9f74f32ac88d29c8c9d0064d163a3135276d6756,0,Jens Geyer,2015-04-18 00:48:21+02:00,['2aa04bf384a65e8a5ea3f996b790d231aa279626'],12,13,25,901873,1,,,,2340
018c1b8f77e7d69da61014437d5f04fedbaad81d,0,Jens Geyer,2015-04-18 00:52:06+02:00,['9f74f32ac88d29c8c9d0064d163a3135276d6756'],49,157,206,902079,15,0.878787879,0.878787879,1,2341
98201b06053e6c5d74ba3ec5ec702f1892a8dec2,0,Roger Meier,2015-04-20 22:26:37+02:00,['018c1b8f77e7d69da61014437d5f04fedbaad81d'],3,3,6,902085,1,,,,2341
aeb89aa81bdd23aee2f70eabe87f44d7fb2c9c8a,0,Roger Meier,2015-04-20 22:31:12+02:00,['98201b06053e6c5d74ba3ec5ec702f1892a8dec2'],0,12,12,902097,1,,,,2341
3b99c970ad0c9fa2ca009f7b00aaeb902ee9850a,1,Roger Meier,2015-04-20 22:49:48+02:00,['aeb89aa81bdd23aee2f70eabe87f44d7fb2c9c8a'],21,40,61,902158,3,,,,2341
95717c92d8b9f0e081caaca5c67b6ba14a2f4052,1,Jens Geyer,2015-04-23 22:48:13+02:00,['3b99c970ad0c9fa2ca009f7b00aaeb902ee9850a'],157,49,206,902364,15,0.121212121,0.121212121,0,2341
1684c429501e9df9387cb518e660691f032d7926,1,Ben Craig,2015-04-24 08:52:44-05:00,['95717c92d8b9f0e081caaca5c67b6ba14a2f4052'],137,855,992,903356,19,0.364130435,0.774456522,0.991847826,2344
e856d6846bce5402cc79f7bbaa59897690080017,0,Roger Meier,2015-04-26 16:03:38+02:00,['1684c429501e9df9387cb518e660691f032d7926'],10,41,51,903407,4,,,,2344
783660a335aad8818a9ede210e594b7f8677aa56,1,Roger Meier,2015-04-26 16:08:20+02:00,['e856d6846bce5402cc79f7bbaa59897690080017'],7,7,14,903421,1,,,,2344
7ed94ef8e82e3aabec05d638c3fc2736f081b0f8,0,Roger Meier,2015-04-26 16:55:35+02:00,['783660a335aad8818a9ede210e594b7f8677aa56'],0,4,4,903425,1,,,,2344
71f2d8a7140329f0f2fc339d84e50d9b27bf478c,1,Roger Meier,2015-04-26 17:00:04+02:00,['7ed94ef8e82e3aabec05d638c3fc2736f081b0f8'],10,10,20,903445,8,1,0,0,2344
5ec2121cf283e8d708d22ab3e66c9c7103ecbaf0,0,Jens Geyer,2015-04-26 17:47:43+02:00,['71f2d8a7140329f0f2fc339d84e50d9b27bf478c'],2,8,10,903455,2,,,,2344
958a7a242a59bc2d3965399483fbbb0dbeafa0e8,0,Jens Geyer,2015-04-26 17:47:50+02:00,['5ec2121cf283e8d708d22ab3e66c9c7103ecbaf0'],0,6,6,903461,1,0,1,1,2344
811d279d581c7daffcee846492f5efca12fda3db,0,Jens Geyer,2015-04-26 17:47:58+02:00,['958a7a242a59bc2d3965399483fbbb0dbeafa0e8'],16,16,32,903493,1,,,,2344
5ec805b22b81001b1b785cd7f85eb8647fde60df,1,Roger Meier,2015-04-26 20:58:17+02:00,['811d279d581c7daffcee846492f5efca12fda3db'],286,333,619,904112,10,0.931034483,1,0.103448276,2346
fa0a125d2233c7c5f26e3faa8e72fbfee5a1a765,0,Roger Meier,2015-04-27 21:56:51+02:00,['5ec805b22b81001b1b785cd7f85eb8647fde60df'],1,0,1,904113,1,,,,2346
dc799ca078627a8e400cfcdbb965acf6abf86eef,0,Jens Geyer,2015-04-27 23:02:05+02:00,['fa0a125d2233c7c5f26e3faa8e72fbfee5a1a765'],0,723,723,904836,2,0.65060241,0.761044177,1,2348
87bb771d89cc499d4a86fc31fcd954b76c0f5348,0,Konrad Grochowski,2015-04-30 11:38:39+02:00,['dc799ca078627a8e400cfcdbb965acf6abf86eef'],1,1,2,904838,1,,,,2348
21b68524084cb47ada51701aa13061d8820d15e5,1,Roger Meier,2015-04-30 12:41:16+02:00,['87bb771d89cc499d4a86fc31fcd954b76c0f5348'],609,642,1251,906089,12,1,1,0,2350
54283027170a85f04f8f15497af3a9b0c6b52fc7,0,Roger Meier,2015-04-30 16:20:39+02:00,['21b68524084cb47ada51701aa13061d8820d15e5'],2,2,4,906093,1,,,,2350
195142426dd0fc300fae59c49a91a51b16a2ffde,1,Roger Meier,2015-04-30 18:08:53+02:00,['54283027170a85f04f8f15497af3a9b0c6b52fc7'],8,47,55,906148,1,1,1,0.636363636,2350
a199a16622724f7de204f793247e825e200149bf,0,Roger Meier,2015-04-30 18:19:06+02:00,['195142426dd0fc300fae59c49a91a51b16a2ffde'],0,1,1,906149,1,,,,2350
4bf9399ca39ee4147a82aca8d69a97f2cee1b377,0,Roger Meier,2015-04-30 19:42:41+02:00,['a199a16622724f7de204f793247e825e200149bf'],11,39,50,906199,1,0,1,1,2350
79c9911b8780d1f9d7c2c17623d269f0671d1723,1,Roger Meier,2015-04-30 19:48:15+02:00,['4bf9399ca39ee4147a82aca8d69a97f2cee1b377'],74,328,402,906601,15,0.576923077,0.953846154,0.846153846,2350
1a8e048bd05b8506ab06200282e2ba516927786e,0,Jens Geyer,2015-04-30 20:37:20+02:00,['79c9911b8780d1f9d7c2c17623d269f0671d1723'],7,5,12,906613,4,,,,2350
9de9b1f1be7b343e8493560b6eb540a948303f6f,1,Roger Meier,2015-04-30 22:40:26+02:00,['1a8e048bd05b8506ab06200282e2ba516927786e'],69,123,192,906805,20,,,,2350
467998b6e9e05cc047a469b58201f1dea964c3b2,0,henrique,2015-05-01 14:03:19+10:00,['9de9b1f1be7b343e8493560b6eb540a948303f6f'],0,1,1,906806,1,,,,2350
1e723d931e92652e4ccb1385709258759ae5bc54,0,henrique,2015-05-01 14:09:00+10:00,['467998b6e9e05cc047a469b58201f1dea964c3b2'],2,6,8,906814,1,0,0,1,2350
9e78ed81a94dde86f4ac4207c39334255c102a5a,1,Roger Meier,2015-05-02 17:12:47+02:00,['1e723d931e92652e4ccb1385709258759ae5bc54'],2,2,4,906818,1,,,,2350
13699f878a747abf13bbb397ff7de19ed8779399,0,Konrad Grochowski,2015-05-04 11:21:22+02:00,['9e78ed81a94dde86f4ac4207c39334255c102a5a'],1,4,5,906823,1,,,,2350
de7cf5df9244c3e1a45c0150f1f77e730ba20e1c,0,Konrad Grochowski,2015-05-04 11:24:47+02:00,['13699f878a747abf13bbb397ff7de19ed8779399'],6,6,12,906835,3,,,,2350
55c3abcb63f948f18a6db25c51c8a887373ed369,1,henrique,2015-05-04 21:05:48+10:00,['de7cf5df9244c3e1a45c0150f1f77e730ba20e1c'],6,2,8,906843,1,1,1,0,2350
eec445ef8ac88d94049bd7ad1a3d203f34c6f5c8,0,henrique,2015-05-04 21:37:51+10:00,['55c3abcb63f948f18a6db25c51c8a887373ed369'],2,8,10,906853,1,0,0,1,2350
89cffc6f76389da2603aec3f7467c128f79055d2,0,Jens Geyer,2015-05-05 21:10:50+02:00,['eec445ef8ac88d94049bd7ad1a3d203f34c6f5c8'],1,13,14,906867,2,0.6,0.6,0.6,2350
24ea0bf5df0e431416fca897077af220a27b0320,1,Konrad Grochowski,2015-05-07 15:16:24+02:00,['89cffc6f76389da2603aec3f7467c128f79055d2'],129,185,314,907181,11,1,1,1,2351
dfc22ad2059312018777265af0b8684f0173b9dc,0,Jens Geyer,2015-05-08 21:43:50+02:00,['24ea0bf5df0e431416fca897077af220a27b0320'],1,16,17,907198,2,0,0,1,2351
2a15b993724dfef00bdbe28c2a7e1452dec4461a,0,Konrad Grochowski,2015-05-09 11:55:36+02:00,['dfc22ad2059312018777265af0b8684f0173b9dc'],1,6,7,907205,1,1,1,1,2351
ec847acab5fd4bcabdfb7bcca915cca69a1e4784,0,Roger Meier,2015-05-09 21:33:42+02:00,['2a15b993724dfef00bdbe28c2a7e1452dec4461a'],0,2,2,907207,1,,,,2351
446a319f9a26695fb06b725a4959f28c82b558c0,0,Roger Meier,2015-05-09 23:40:54+02:00,['ec847acab5fd4bcabdfb7bcca915cca69a1e4784'],0,12,12,907219,2,,,,2352
9dfe7b83efff9e3b1aec0cdcdb7bfb869c40fbfa,0,Roger Meier,2015-05-09 23:45:33+02:00,['446a319f9a26695fb06b725a4959f28c82b558c0'],0,2,2,907221,1,,,,2352
9f85468eb6acab173dd45a5e8d2c8a87e77923a7,0,Roger Meier,2015-05-10 14:42:42+02:00,['9dfe7b83efff9e3b1aec0cdcdb7bfb869c40fbfa'],1,1,2,907223,1,,,,2352
6077481139933b927397c7da0088aa4678f9fb3c,0,Roger Meier,2015-05-10 14:45:17+02:00,['9f85468eb6acab173dd45a5e8d2c8a87e77923a7'],23,46,69,907292,2,0,1,1,2352
fd5a4d296980d35ce76eeefd35ee1054cb80b35a,0,Roger Meier,2015-05-10 18:25:56+02:00,['6077481139933b927397c7da0088aa4678f9fb3c'],0,1,1,907293,1,,,,2352
2c4edd88b196c48d139644dd83fe57781f85bbe7,0,Roger Meier,2015-05-10 18:25:56+02:00,['fd5a4d296980d35ce76eeefd35ee1054cb80b35a'],2,4,6,907299,1,,,,2352
42bc88cfbbf89b202d8280e7a56a91e508010f74,0,Roger Meier,2015-05-10 18:25:56+02:00,['2c4edd88b196c48d139644dd83fe57781f85bbe7'],0,6,6,907305,3,,,,2352
fbc6977381a58ae018567492399c7ba8130d1b84,0,Roger Meier,2015-05-10 18:25:56+02:00,['42bc88cfbbf89b202d8280e7a56a91e508010f74'],10,12,22,907327,1,0,0,0,2352
63b5120c78163b8d413ec6ed2f4af52519c6f442,1,Roger Meier,2015-05-10 18:25:56+02:00,['fbc6977381a58ae018567492399c7ba8130d1b84'],16,16,32,907359,5,,,,2352
72f8809290a943b12ff7f2cb9395c6ba3506736a,1,Roger Meier,2015-05-10 18:25:56+02:00,['63b5120c78163b8d413ec6ed2f4af52519c6f442'],0,18,18,907377,2,1,1,1,2352
03f0e18fcb423e165ee05757ba449efb3e672dd1,1,Roger Meier,2015-05-10 18:25:56+02:00,['72f8809290a943b12ff7f2cb9395c6ba3506736a'],10,50,60,907437,5,,,,2352
ef0a8fa62a8a86b23999f9a9ad31478852474854,0,Roger Meier,2015-05-10 18:25:56+02:00,['03f0e18fcb423e165ee05757ba449efb3e672dd1'],1,23,24,907461,4,,,,2352
77a7103fe189a6f7f909e3b665bdd5c669ced97c,0,Jens Geyer,2015-05-11 22:45:55+02:00,['ef0a8fa62a8a86b23999f9a9ad31478852474854'],14,14,28,907489,2,,,,2352
b9f6038cfbd39cd8c8f1c4f4047e2a819fb28f5b,0,Jens Geyer,2015-05-12 22:39:31+02:00,['77a7103fe189a6f7f909e3b665bdd5c669ced97c'],6,7,13,907502,1,0,0,1,2352
eab9c45bad1d19e5b2a2c94695699fee5325bd82,0,Jens Geyer,2015-05-12 23:02:32+02:00,['b9f6038cfbd39cd8c8f1c4f4047e2a819fb28f5b'],2,5,7,907509,1,0,0,0,2352
113b63879010c924b03feb2b43158ab6d9fcbac9,0,Roger Meier,2015-05-13 21:40:26+02:00,['eab9c45bad1d19e5b2a2c94695699fee5325bd82'],23,23,46,907555,23,,,,2352
04488dddf813fbbb9798c2a11d86c7601448aba8,0,Jens Geyer,2015-05-14 18:57:50+02:00,['113b63879010c924b03feb2b43158ab6d9fcbac9'],22,39,61,907616,1,,,,2352
516e28a42d481725156d3d521d453c55b1dfd992,0,Roger Meier,2015-05-15 11:23:01+02:00,['04488dddf813fbbb9798c2a11d86c7601448aba8'],0,1,1,907617,1,,,,2352
86fded21b55573bb9240552a284f1f3d7255bd32,1,Roger Meier,2015-05-15 15:44:22+02:00,['516e28a42d481725156d3d521d453c55b1dfd992'],16,19,35,907652,4,,,,2352
a6b66332599f45dbfd7eb75d1bd001661b6cace4,0,Roger Meier,2015-05-15 15:44:22+02:00,['86fded21b55573bb9240552a284f1f3d7255bd32'],37,43,80,907732,4,,,,2352
b7138acd86cebee62bd4606ed2dc01901f042f5b,1,Jens Geyer,2015-05-15 22:35:50+02:00,['a6b66332599f45dbfd7eb75d1bd001661b6cace4'],26,26,52,907784,2,,,,2352
fc8a6a5187a0fbed3e0b758f41116201a89913e0,1,Jens Geyer,2015-05-16 14:33:58+02:00,['b7138acd86cebee62bd4606ed2dc01901f042f5b'],1,1,2,907786,1,,,,2352
4ead520841dce57532c45378fba10b3e033bbf54,0,Roger Meier,2015-05-16 21:09:18+02:00,['fc8a6a5187a0fbed3e0b758f41116201a89913e0'],4,4,8,907794,4,,,,2352
880a2b32e5980ac95618392314521cc02967a344,1,Roger Meier,2015-05-16 22:40:17+02:00,['4ead520841dce57532c45378fba10b3e033bbf54'],8,9,17,907811,2,,,,2352
e46ec45b38f2ba9062f9bcf1709708f8bdab1809,0,Roger Meier,2015-05-17 00:35:52+02:00,['880a2b32e5980ac95618392314521cc02967a344'],0,5,5,907816,1,,,,2352
83cd3e8d41001304f2efac9ebad92e02d3390ca7,0,Jens Geyer,2015-05-17 19:44:01+02:00,['e46ec45b38f2ba9062f9bcf1709708f8bdab1809'],3,3,6,907822,1,,,,2352
3b115dfa614cfac7af86d81d99f69b381508b75e,1,Konrad Grochowski,2015-05-18 19:47:23+02:00,['83cd3e8d41001304f2efac9ebad92e02d3390ca7'],32,92,124,907946,20,0.219512195,0.853658537,0.634146341,2352
1f6e380c5d07686e4cd8c2b172300a1ba7fbd8b9,1,Konrad Grochowski,2015-05-18 19:47:28+02:00,['3b115dfa614cfac7af86d81d99f69b381508b75e'],973,962,1935,909881,45,0,0.6,0,2352
e84c582531a78b41f81165816e0c03d9cbbb5b8c,1,Jens Geyer,2015-05-19 01:33:23+02:00,['1f6e380c5d07686e4cd8c2b172300a1ba7fbd8b9'],0,40,40,909921,1,,,,2352
b26c0b8dcc9a990805574da47ceac56ec5da8345,0,Jens Geyer,2015-05-20 00:46:46+02:00,['e84c582531a78b41f81165816e0c03d9cbbb5b8c'],11,68,79,910000,2,,,,2352
0b09887bc14427c374cd347ebb24a61d8ac0f713,0,Jens Geyer,2015-05-20 21:43:33+02:00,['b26c0b8dcc9a990805574da47ceac56ec5da8345'],3,6,9,910009,2,,,,2352
8606271759315fa49202521e8eec6d34c6375a6f,0,Jens Geyer,2015-05-20 22:44:45+02:00,['0b09887bc14427c374cd347ebb24a61d8ac0f713'],72,72,144,910153,2,,,,2352
04fdd3a7ccb39cfac1c1af0951f5d3a4cc571a92,0,Jens Geyer,2015-05-20 22:44:55+02:00,['8606271759315fa49202521e8eec6d34c6375a6f'],2,2,4,910157,1,,,,2352
70219e108a01340380f65e1ece8d63620d5e22a5,1,Jens Geyer,2015-05-20 23:36:50+02:00,['04fdd3a7ccb39cfac1c1af0951f5d3a4cc571a92'],18,106,124,910281,4,0.470588235,0.588235294,0.882352941,2354
9265222b3f14997b946c9f77f4a7745fd04a557f,0,Jens Geyer,2015-05-21 02:13:18+02:00,['70219e108a01340380f65e1ece8d63620d5e22a5'],1,1,2,910283,1,,,,2354
33eef3534fe4b48be83740cb84fbc7a16a3530f0,0,Jens Geyer,2015-05-21 02:16:47+02:00,['9265222b3f14997b946c9f77f4a7745fd04a557f'],1,1,2,910285,1,,,,2354
549a9e1e6dfbfaf1f7685dc5e26440c501517738,0,Jens Geyer,2015-05-21 22:20:31+02:00,['33eef3534fe4b48be83740cb84fbc7a16a3530f0'],0,92,92,910377,2,0.462962963,1,1,2355
1568aef7d499153469131449ec682998598f0d3c,0,Henrique Mendonça,2015-05-27 22:15:46+10:00,['549a9e1e6dfbfaf1f7685dc5e26440c501517738'],10,733,743,911120,12,0.396103896,0.703463203,0.928571429,2359
b3b7d0457ae67e4eeafbd2137dd94116d4993870,1,Jens Geyer,2015-05-30 22:56:01+02:00,['1568aef7d499153469131449ec682998598f0d3c'],7,22,29,911149,3,1,1,1,2359
bbd6fd777319773b45b258b3ec9e49516a2ce4aa,0,Jens Geyer,2015-05-31 00:39:41+02:00,['b3b7d0457ae67e4eeafbd2137dd94116d4993870'],26,44,70,911219,6,,,,2359
c0e4a8dc07402a03f8627608fbcb84affca200c9,0,Henrique Mendonça,2015-06-01 23:23:22+10:00,['bbd6fd777319773b45b258b3ec9e49516a2ce4aa'],733,10,743,911962,12,0.603896104,0.296536797,0.071428571,2359
86a51e7eca0c33832b8e0421b18a99f4477dc31a,1,Jens Geyer,2015-06-01 21:09:17+02:00,['c0e4a8dc07402a03f8627608fbcb84affca200c9'],7,96,103,912065,4,0.071428571,0.142857143,0.928571429,2361
401d399ed0ceefebced795d450c61f5099a18ce1,0,Roger Meier,2015-06-01 21:28:42+02:00,['86a51e7eca0c33832b8e0421b18a99f4477dc31a'],1,1,2,912067,1,,,,2361
56d38fb913791f7df476471d3c0294849140964a,0,Roger Meier,2015-06-01 22:01:09+02:00,['401d399ed0ceefebced795d450c61f5099a18ce1'],6,8,14,912081,2,1,1,1,2361
7daf00ceb1b6d52f7ab612b03f63907866381ff1,0,Roger Meier,2015-06-03 11:45:35+02:00,['56d38fb913791f7df476471d3c0294849140964a'],3,18,21,912102,1,1,1,1,2361
211b82de11c3c5bb83f669a95373b3ea6601d666,0,Roger Meier,2015-06-04 12:47:31+02:00,['7daf00ceb1b6d52f7ab612b03f63907866381ff1'],1,4,5,912107,1,,,,2361
74d503e0eb1968ddc70bd110223e734838db9bd6,1,Roger Meier,2015-06-05 07:10:19+02:00,['211b82de11c3c5bb83f669a95373b3ea6601d666'],1,49,50,912157,2,,,,2362
99255de85759f66e957ba8f3d9e2a2b4c8b00c0f,0,Roger Meier,2015-06-05 12:44:39+02:00,['74d503e0eb1968ddc70bd110223e734838db9bd6'],0,112,112,912269,1,,,,2363
9b3b8d4987a34ed732a0c3b9edb757d913c38647,1,Jens Geyer,2015-06-12 20:35:23+02:00,['99255de85759f66e957ba8f3d9e2a2b4c8b00c0f'],0,2,2,912271,1,0,1,1,2363
9815c19d7ea39b8585c2848b523e7182bb26b4c7,0,Roger Meier,2015-06-14 20:50:03+02:00,['9b3b8d4987a34ed732a0c3b9edb757d913c38647'],6,5,11,912282,1,0,0,0,2363
4e1ea110120121b597b503c02d3f672c7dfb8a90,0,Roger Meier,2015-06-14 22:23:05+02:00,['9815c19d7ea39b8585c2848b523e7182bb26b4c7'],6,0,6,912288,1,1,1,0,2363
085627309591a78e2c7d4c2168ad4b0939cc4f2e,0,Roger Meier,2015-06-14 22:30:22+02:00,['4e1ea110120121b597b503c02d3f672c7dfb8a90'],19,18,37,912325,4,,,,2363
56a03be3f9bf251d17c89034e4c8f2e668211317,0,Jens Geyer,2015-06-17 22:21:27+02:00,['085627309591a78e2c7d4c2168ad4b0939cc4f2e'],8,8,16,912341,8,,,,2363
8b4700265cef54c6544345530b33cd2274caec62,1,Jens Geyer,2015-06-19 21:22:57+02:00,['56a03be3f9bf251d17c89034e4c8f2e668211317'],3,3,6,912347,2,,,,2363
42b9be191eec2f18c75db965c4839f4a15d20f11,0,Roger Meier,2015-06-21 21:31:41+02:00,['8b4700265cef54c6544345530b33cd2274caec62'],1,1,2,912349,1,,,,2363
417b631c5a80c78eda58824a824782b15455ccc4,1,Jens Geyer,2015-06-22 22:21:27+02:00,['42b9be191eec2f18c75db965c4839f4a15d20f11'],0,4,4,912353,1,1,1,1,2363
6cdbd98b717b9f2b720ce7dc2899fbada94876f9,0,jfarrell,2015-06-23 21:58:50-04:00,['417b631c5a80c78eda58824a824782b15455ccc4'],9,11,20,912373,3,,,,2363
763841b4dd83f7f100b469f2d879b86d2cbfb84a,0,jfarrell,2015-06-24 09:11:54-04:00,['6cdbd98b717b9f2b720ce7dc2899fbada94876f9'],46,27,73,912446,2,,,,2363
0b8132d20ea691c56f0fe973072a58086999a4d8,0,jfarrell,2015-06-24 09:19:15-04:00,['763841b4dd83f7f100b469f2d879b86d2cbfb84a'],1,6,7,912453,1,1,1,1,2363
15d904240e8ee446ce5b9549c1082ea078389774,1,Henrique Mendonça,2015-06-25 22:31:41+10:00,['0b8132d20ea691c56f0fe973072a58086999a4d8'],10,737,747,913200,13,0.398706897,0.704741379,0.92887931,2367
94d0679f4562eec846667cfd69115feaa8bd53fa,0,jfarrell,2015-06-25 10:17:24-04:00,['15d904240e8ee446ce5b9549c1082ea078389774'],1,1,2,913202,1,,,,2367
2238adabbc5317ab59ee1b13d4df4e1d4d889c73,0,jfarrell,2015-06-26 08:58:32-04:00,['94d0679f4562eec846667cfd69115feaa8bd53fa'],8,19,27,913229,1,1,1,1,2367
3f2e7101523bd326577e564c3d154a22082456e7,0,Jens Geyer,2015-06-26 21:55:05+02:00,['2238adabbc5317ab59ee1b13d4df4e1d4d889c73'],2,9,11,913240,1,0,0,1,2367
aba4b1f2b0fbffa66a9072d9ede43b72f114b92e,0,Henrique Mendonça,2015-06-27 12:16:17+10:00,['3f2e7101523bd326577e564c3d154a22082456e7'],0,2,2,913242,1,,,,2367
9d803f512fc133333c493a1ce774cc87b107cd7a,0,jfarrell,2015-06-28 21:23:20-04:00,['aba4b1f2b0fbffa66a9072d9ede43b72f114b92e'],8,0,8,913250,1,,,,2367
507075607f511215cf9c403ff722202c1075dcef,0,Jens Geyer,2015-06-29 11:30:40+02:00,['9d803f512fc133333c493a1ce774cc87b107cd7a'],4,10,14,913264,1,0,0,1,2367
5ef662b9046d18aee224018061413ad7ee5d80a5,1,Henrique Mendonça,2015-06-29 19:49:16+10:00,['507075607f511215cf9c403ff722202c1075dcef'],548,1107,1655,914919,13,0.737100737,1,1,2367
24ef0d6f51691134a52b22a3549695cb5ddd4993,1,Jens Geyer,2015-06-30 21:31:48+02:00,['5ef662b9046d18aee224018061413ad7ee5d80a5'],4,15,19,914938,1,0.714285714,1,0.714285714,2367
77025362496805944f2fc6d8d7a44d29de2bad22,1,Jens Geyer,2015-06-30 21:31:50+02:00,['24ef0d6f51691134a52b22a3549695cb5ddd4993'],2,2,4,914942,1,,,,2367
5cf9d7744c41fa5109c1f8acc198efb4b646cd35,1,Jens Geyer,2015-07-02 21:07:17+02:00,['77025362496805944f2fc6d8d7a44d29de2bad22'],4,103,107,915049,4,0,0.076923077,0.923076923,2369
2fadc8d5cace1854cdd94483f7f231080bbd2d64,0,Roger Meier,2015-07-03 20:42:43+02:00,['5cf9d7744c41fa5109c1f8acc198efb4b646cd35'],5,5,10,915059,1,,,,2369
5903d6745989897fae58f8370c62a1dd5bfe7e66,1,Roger Meier,2015-07-03 20:48:50+02:00,['2fadc8d5cace1854cdd94483f7f231080bbd2d64'],18,31,49,915108,3,1,1,1,2369
74086f18afa336000c3cf210939b1a1b843faaa5,0,Ben Craig,2015-07-04 17:18:58-05:00,['5903d6745989897fae58f8370c62a1dd5bfe7e66'],22,111,133,915241,3,1,1,1,2370
6e4037656885132a44407fb7d66f6d034b379376,1,Jens Geyer,2015-07-05 19:24:11+02:00,['74086f18afa336000c3cf210939b1a1b843faaa5'],7,25,32,915273,1,0,1,0.5,2370
7207c22f9d50ee28ea8c0842404541524bde8bcd,1,Ben Craig,2015-07-06 08:40:35-05:00,['6e4037656885132a44407fb7d66f6d034b379376'],13,42,55,915328,6,,,,2370
f48588f124fb8636f94bf23d098d4483f077e2de,0,Jens Geyer,2015-07-07 22:23:49+02:00,['7207c22f9d50ee28ea8c0842404541524bde8bcd'],1,4,5,915333,1,1,1,1,2370
17044564494a4e6354a49670c281555f9704ecc1,1,Jens Geyer,2015-07-07 22:34:13+02:00,['f48588f124fb8636f94bf23d098d4483f077e2de'],4,1,5,915338,1,0,0,0,2370
8f11f52341f5984f77b2510094e51e6aef4c3552,1,Roger Meier,2015-07-08 11:26:51+02:00,['17044564494a4e6354a49670c281555f9704ecc1'],4,23,27,915365,2,1,1,1,2370
33f3f01ce2a7e0aa1348deada026edec20c937ee,0,Roger Meier,2015-07-08 13:46:29+02:00,['8f11f52341f5984f77b2510094e51e6aef4c3552'],0,1,1,915366,1,1,1,0,2370
384f976a3bb27371de4be5355193450c1f270019,0,Ben Craig,2015-07-08 20:33:03-05:00,['33f3f01ce2a7e0aa1348deada026edec20c937ee'],125,317,442,915808,6,0.112781955,0,1,2370
262cfb4189f3b347f472dfe8b754861ba481c433,0,Ben Craig,2015-07-08 20:37:15-05:00,['384f976a3bb27371de4be5355193450c1f270019'],46,7785,7831,923639,44,0.060267857,0.408482143,0.808035714,2410
cfaadcc4adcfde2a8232c62ec89870b73ef40df1,1,Ben Craig,2015-07-08 20:50:33-05:00,['262cfb4189f3b347f472dfe8b754861ba481c433'],112,166,278,923917,5,0.611111111,0.611111111,0.666666667,2411
d47fcdd66daa5ce7af93edd47c774bf5b9f30430,0,Jens Geyer,2015-07-09 22:20:12+02:00,['cfaadcc4adcfde2a8232c62ec89870b73ef40df1'],4,99,103,924020,2,0,0.333333333,0,2411
40180369804a01845a52e1e012f41dbd14662fdc,0,Jens Geyer,2015-07-09 23:06:41+02:00,['d47fcdd66daa5ce7af93edd47c774bf5b9f30430'],64,148,212,924232,3,0.213114754,0.475409836,0.868852459,2411
3ea26be2ae08c2c7992137e5142cec146627e119,1,Jens Geyer,2015-07-10 02:00:36+02:00,['40180369804a01845a52e1e012f41dbd14662fdc'],6,27,33,924265,1,0,0,0,2411
012dd4e3fc1e75e3434f608ce2ba30dbd29c56cb,0,Ben Craig,2015-07-09 20:55:53-05:00,['3ea26be2ae08c2c7992137e5142cec146627e119'],32,40,72,924337,2,,,,2412
8b4e155f04a0d02b731b1851611a92454d6e0c55,1,Ben Craig,2015-07-09 20:58:04-05:00,['012dd4e3fc1e75e3434f608ce2ba30dbd29c56cb'],0,4,4,924341,2,,,,2412
254b4583f74381295ffbe8cf466eb06eb3c0c172,1,Roger Meier,2015-07-10 15:27:07+02:00,['8b4e155f04a0d02b731b1851611a92454d6e0c55'],3,3,6,924347,1,,,,2412
0104da5a6fe0ef5c52f82198998718cdd8623c4a,0,Roger Meier,2015-07-10 22:13:36+02:00,['254b4583f74381295ffbe8cf466eb06eb3c0c172'],1,2,3,924350,1,,,,2412
90c60e340c322d398adc0de3ed45aed8d6f0c1f9,0,Jens Geyer,2015-07-11 01:19:53+02:00,['0104da5a6fe0ef5c52f82198998718cdd8623c4a'],108,170,278,924628,9,0,1,1,2413
01a77ab01e7459d96059a2b49d9885d14a360ef1,0,Jens Geyer,2015-07-11 11:46:38+02:00,['90c60e340c322d398adc0de3ed45aed8d6f0c1f9'],0,4,4,924632,1,1,1,1,2413
20a25519c45195145c50c350359c98524d17bddb,0,Roger Meier,2015-07-12 21:49:45+02:00,['01a77ab01e7459d96059a2b49d9885d14a360ef1'],1,1,2,924634,1,,,,2413
5af2d99c5e9de2e3af63732a7ee20e1fe49dd564,0,Roger Meier,2015-07-13 15:25:58+02:00,['20a25519c45195145c50c350359c98524d17bddb'],1,6,7,924641,1,0,0,1,2413
1f64ea95995c6a2d35aa9e8a52aed49bf13dfb3c,0,ben-craig,2015-07-15 08:11:57-05:00,['5af2d99c5e9de2e3af63732a7ee20e1fe49dd564'],1,4,5,924646,2,,,,2413
1abcbc721882bdb8fff3739487b518a0ccfefcb2,0,ben-craig,2015-07-15 10:40:29-05:00,['1f64ea95995c6a2d35aa9e8a52aed49bf13dfb3c'],3,15,18,924664,2,,,,2413
fae08e774c04c24c04cea04dc9b90bbcd6dfb98b,1,ben-craig,2015-07-15 11:34:47-05:00,['1abcbc721882bdb8fff3739487b518a0ccfefcb2'],24,49,73,924737,11,0,0,1,2413
af2d9c8b88c4fc7045177f1ce6081189627f6413,1,ben-craig,2015-07-16 08:11:21-05:00,['fae08e774c04c24c04cea04dc9b90bbcd6dfb98b'],47,160,207,924944,6,0.627906977,1,0.953488372,2414
8b01553758365b34eab45f42cdf4934daa85f39a,0,Roger Meier,2015-07-16 23:05:43+02:00,['af2d9c8b88c4fc7045177f1ce6081189627f6413'],1,1,2,924946,1,,,,2414
ecc2a6b60fd8fb29a56f700fd9667a71cade21b8,0,Roger Meier,2015-07-16 23:48:39+02:00,['8b01553758365b34eab45f42cdf4934daa85f39a'],1,1,2,924948,1,,,,2414
e15ade77cbb4578f74b6208f98e5380bb9bd071c,0,Roger Meier,2015-07-16 23:52:42+02:00,['ecc2a6b60fd8fb29a56f700fd9667a71cade21b8'],1,6,7,924955,1,0,0,1,2414
e4b1481c56d7e0c5e0f2aa3674b84730ec71e578,0,Roger Meier,2015-07-17 00:42:19+02:00,['e15ade77cbb4578f74b6208f98e5380bb9bd071c'],1,1,2,924957,1,,,,2414
02bade1583009cfc2725d5171dba3e524f234613,1,ben-craig,2015-07-17 08:40:48-05:00,['e4b1481c56d7e0c5e0f2aa3674b84730ec71e578'],89,664,753,925710,7,0.337988827,0.48603352,0.891061453,2416
bcb17bc7429718a00dee788f25fecaac23139a8d,1,Jens Geyer,2015-07-17 23:16:44+02:00,['02bade1583009cfc2725d5171dba3e524f234613'],25,33,58,925768,1,,,,2416
de78b54b8946dbb65c739608907631c167c871af,0,Ben Craig,2015-07-22 19:38:08-05:00,['bcb17bc7429718a00dee788f25fecaac23139a8d'],0,1,1,925769,1,,,,2416
b141fd0801574761608ce08f1d81ea47392f82cb,0,Jens Geyer,2015-07-24 01:03:07+02:00,['de78b54b8946dbb65c739608907631c167c871af'],1,1,2,925771,1,,,,2416
bf0b483d4f7f15cb88566f9be0c6c796fa05651d,1,Jens Geyer,2015-07-25 15:23:02+02:00,['b141fd0801574761608ce08f1d81ea47392f82cb'],3,3,6,925777,2,,,,2416
e33d16520a483e49e5f73a9ea2091cfc686fb619,0,Jens Geyer,2015-07-25 15:23:45+02:00,['bf0b483d4f7f15cb88566f9be0c6c796fa05651d'],0,1,1,925778,1,,,,2416
f7d327ae96d451ff76b80d7e952f9cc21a1c4464,0,Jens Geyer,2015-07-25 15:44:20+02:00,['e33d16520a483e49e5f73a9ea2091cfc686fb619'],1,1,2,925780,1,,,,2416
ca8469ec578b13524e387782e7ee72d4150ab542,1,Jens Geyer,2015-07-26 02:29:32+02:00,['f7d327ae96d451ff76b80d7e952f9cc21a1c4464'],13,82,95,925875,11,0,0.477272727,1,2416
b2e90c143e266c9af9ed437a3ab0dbb229a0b722,1,jfarrell,2015-07-27 08:50:56-04:00,['ca8469ec578b13524e387782e7ee72d4150ab542'],16,21,37,925912,2,,,,2416
da0b71fdd18551e69cfe1a7b3afe41047e77cda2,0,Jens Geyer,2015-07-27 23:51:47+02:00,['b2e90c143e266c9af9ed437a3ab0dbb229a0b722'],0,8,8,925920,1,,,,2416
8677719180b3ef628122e68c188217d4ba987e40,1,Jens Geyer,2015-07-27 23:52:13+02:00,['da0b71fdd18551e69cfe1a7b3afe41047e77cda2'],40,40,80,926000,3,,,,2416
8c5fce9afabb2476c134a702356bb1bad1eb43f4,1,Jens Geyer,2015-07-28 22:59:16+02:00,['8677719180b3ef628122e68c188217d4ba987e40'],3,3,6,926006,3,,,,2416
57ac33ea1a42e871ef03a7bda770a7ba16745ead,1,Jens Geyer,2015-07-28 23:12:52+02:00,['8c5fce9afabb2476c134a702356bb1bad1eb43f4'],5,35,40,926046,5,0.4,0.4,0.6,2416
1c1902788bef82c0dbf2b10b2d39767ce94a1c38,0,Jens Geyer,2015-07-28 23:15:18+02:00,['57ac33ea1a42e871ef03a7bda770a7ba16745ead'],4,37,41,926087,13,,,,2416
482da722b9c42b5678b8a2ad2d0b0828ab24a8f6,0,Jens Geyer,2015-07-28 23:46:02+02:00,['1c1902788bef82c0dbf2b10b2d39767ce94a1c38'],2,1,3,926090,1,1,0,0,2416
46ab187bb5d42e18b0112af9184f71cb896e9f2f,1,Jens Geyer,2015-07-30 00:01:04+02:00,['482da722b9c42b5678b8a2ad2d0b0828ab24a8f6'],22,95,117,926207,1,0,0,1,2416
6515aad1f1519a9a3e38a3b72ab5d4b1b999fb56,0,Ben Craig,2015-07-29 20:48:48-05:00,['46ab187bb5d42e18b0112af9184f71cb896e9f2f'],0,2,2,926209,1,0,0,1,2416
4a1e8867af5b6ba2a0176bb1d7fb1f04db235335,0,Ben Craig,2015-07-29 20:54:08-05:00,['6515aad1f1519a9a3e38a3b72ab5d4b1b999fb56'],1,0,1,926210,1,,,,2416
f5f1b35a7d1ce819bdfdc966741399605b051c92,1,Roger Meier,2015-07-30 14:19:49+02:00,['4a1e8867af5b6ba2a0176bb1d7fb1f04db235335'],140,900,1040,927250,14,0,0,1,2420
5e0f7752625ffba61dffcb0a1acaf03da5c193cc,1,Roger Meier,2015-07-30 14:27:15+02:00,['f5f1b35a7d1ce819bdfdc966741399605b051c92'],10,80,90,927340,3,1,1,1,2421
7505118a768e7f427aee6b38ef50e7d544e75dd5,0,Jens Geyer,2015-07-30 21:03:54+02:00,['5e0f7752625ffba61dffcb0a1acaf03da5c193cc'],5,13,18,927358,1,0.75,1,1,2421
f6eebba4a05d97ebceb6f3da2973f5f109e8d487,0,Jens Geyer,2015-07-30 21:11:23+02:00,['7505118a768e7f427aee6b38ef50e7d544e75dd5'],4,12,16,927374,3,0,0,1,2421
b0b710a426fedb48ff5d0643ba64e339ee7efa31,1,Roger Meier,2015-07-30 21:57:03+02:00,['f6eebba4a05d97ebceb6f3da2973f5f109e8d487'],11,315,326,927700,7,0.162011173,0.759776536,1,2422
5445e3fdee66a93e04d342bc2d5d1881427be885,0,Roger Meier,2015-07-30 23:53:23+02:00,['b0b710a426fedb48ff5d0643ba64e339ee7efa31'],0,1,1,927701,1,0,0,1,2422
4ed2b855e9dec14afe859330e4f620d026d903e3,0,Roger Meier,2015-07-30 23:55:34+02:00,['5445e3fdee66a93e04d342bc2d5d1881427be885'],1,1,2,927703,1,,,,2422
a2e0c5075d42fc6a5eb8c7b063c2e206e43e1dfe,0,Jens Geyer,2015-07-31 23:23:41+02:00,['4ed2b855e9dec14afe859330e4f620d026d903e3'],49,91,140,927843,3,0,0.214285714,1,2422
c76a9ecdd29ee7c542b276c975c2731687900224,0,Jens Geyer,2015-07-31 23:23:48+02:00,['a2e0c5075d42fc6a5eb8c7b063c2e206e43e1dfe'],1,1,2,927845,1,,,,2422
c1febebef64f854824a5fb5a93c6d06789242942,0,Roger Meier,2015-08-02 16:19:06+02:00,['c76a9ecdd29ee7c542b276c975c2731687900224'],20,24,44,927889,1,0,0,1,2422
31186c467a3bcfc8408592372f998a31e5723281,0,Roger Meier,2015-08-03 19:07:42+02:00,['c1febebef64f854824a5fb5a93c6d06789242942'],1,1,2,927891,1,,,,2422
b62093db94a8505ebc6bac621e257682f12f1ac7,0,Roger Meier,2015-08-03 19:07:42+02:00,['31186c467a3bcfc8408592372f998a31e5723281'],0,1,1,927892,1,,,,2422
89e65def89beed72340f5eacac5b50a70fd6d062,1,Roger Meier,2015-08-03 19:09:02+02:00,['b62093db94a8505ebc6bac621e257682f12f1ac7'],117,164,281,928173,10,0.3,0.95,0.1,2422
03f3f55109e50b3bb556bebcedcb5f8240e9ace9,1,Roger Meier,2015-08-03 22:03:36+02:00,['89e65def89beed72340f5eacac5b50a70fd6d062'],1,1,2,928175,1,,,,2422
db3646faefcd78cebd9f3f288b71590d2d765574,0,Roger Meier,2015-08-03 22:10:22+02:00,['03f3f55109e50b3bb556bebcedcb5f8240e9ace9'],4,4,8,928183,1,,,,2422
c83a2b5185799f287f1548e0dc21c4cdb7bba6cd,1,Roger Meier,2015-08-03 22:10:23+02:00,['db3646faefcd78cebd9f3f288b71590d2d765574'],52,74,126,928309,1,0,0.409090909,0,2422
7bc907a95931985792e11713eb38244259f1b926,0,Roger Meier,2015-08-03 22:10:23+02:00,['c83a2b5185799f287f1548e0dc21c4cdb7bba6cd'],16,33,49,928358,1,0,0,1,2422
38e7155c039f1dba6dd73a3114dd3a5ac7052418,1,Roger Meier,2015-08-03 22:10:23+02:00,['7bc907a95931985792e11713eb38244259f1b926'],15,35,50,928408,8,0.933333333,1,0.133333333,2422
b28e3ccdcbd31ff4975f9b22c3d6622b7d35bb21,1,Roger Meier,2015-08-03 22:10:23+02:00,['38e7155c039f1dba6dd73a3114dd3a5ac7052418'],124,238,362,928770,1,0,0.220338983,0.050847458,2422
54f392b8fd90d53deabbf107565ec92c985d47f5,1,Jens Geyer,2015-08-05 21:45:10+02:00,['b28e3ccdcbd31ff4975f9b22c3d6622b7d35bb21'],6,497,503,929273,4,0.301310044,0.829694323,0.903930131,2424
8dbe5f60a7c1401302e10aec41069f9c385d34a1,1,Randy Abernethy,2015-08-01 22:57:02-07:00,['54f392b8fd90d53deabbf107565ec92c985d47f5'],2038,17,2055,931328,25,0.657848325,0.233686067,0.234567901,2424
c6b991fe00edf7f4c50c7636a3e09a6a9531b615,1,Jens Geyer,2015-08-08 00:24:09+02:00,['8dbe5f60a7c1401302e10aec41069f9c385d34a1'],2,161,163,931491,6,0.901408451,0.901408451,0.901408451,2426
4fed1af57013b9115cc2fc56a66fc452a8711c62,1,Jens Geyer,2015-08-08 00:24:13+02:00,['c6b991fe00edf7f4c50c7636a3e09a6a9531b615'],46,204,250,931741,3,0.291262136,0.941747573,0.669902913,2426
bb98e97fd3c82117c87d23e3fb6b8bbd800784f2,0,Randy Abernethy,2015-08-05 21:02:14-07:00,['4fed1af57013b9115cc2fc56a66fc452a8711c62'],1,118,119,931860,2,0.174603175,1,1,2427
738143cf36436d65c7e379351968e6e0a1f4ca3f,1,Henrique Mendonça,2015-08-16 19:17:33+10:00,['bb98e97fd3c82117c87d23e3fb6b8bbd800784f2'],1,21,22,931882,3,1,1,1,2427
2fab3deb09e492cbcb2b1e4ed1c1d302787a9abd,1,Henrique Mendonça,2015-08-17 21:54:23+10:00,['738143cf36436d65c7e379351968e6e0a1f4ca3f'],73,52,125,932007,5,0.195652174,0.195652174,1,2427
7860ee727a91d2f7e74a48c2048f7f7fc79a5d10,1,Randy Abernethy,2015-08-20 23:50:35-07:00,['2fab3deb09e492cbcb2b1e4ed1c1d302787a9abd'],106,76,182,932189,2,1,0,1,2427
f13e431babd92f08f46cbc1f32da48965e1c5ca8,1,jfarrell,2015-08-25 00:39:29-04:00,['7860ee727a91d2f7e74a48c2048f7f7fc79a5d10'],14,81,95,932284,24,,,,2427
6949b7c96933da182fde5e40b6c493eb054a7672,0,jfarrell,2015-08-25 01:09:35-04:00,['f13e431babd92f08f46cbc1f32da48965e1c5ca8'],2,6,8,932292,1,0,1,1,2427
400d02c75fe0eba95068217dec3af1f033c4bce3,0,jfarrell,2015-08-25 01:14:12-04:00,['6949b7c96933da182fde5e40b6c493eb054a7672'],25,25,50,932342,1,,,,2427
e2e5e22c1183a81fc101e4f2e6c13b7ebd41bc8e,0,jfarrell,2015-08-25 14:59:40-04:00,['400d02c75fe0eba95068217dec3af1f033c4bce3'],7,14,21,932363,6,,,,2427
b92f636f7b3800b2a068e108608e95ea3e64d2ce,0,Randy Abernethy,2015-08-30 10:56:35-07:00,['e2e5e22c1183a81fc101e4f2e6c13b7ebd41bc8e'],0,2,2,932365,1,,,,2427
1f1c206b08323111d7e9dd06321846339ca8f5b0,0,Jens Geyer,2015-09-03 20:53:44+02:00,['b92f636f7b3800b2a068e108608e95ea3e64d2ce'],0,2,2,932367,1,,,,2427
96d80200c5dae4fa95b8fa068c6a712773ec321b,0,Jens Geyer,2015-09-03 21:14:30+02:00,['1f1c206b08323111d7e9dd06321846339ca8f5b0'],0,16,16,932383,3,,,,2427
5bc8b5a3a5da507b6f87436ca629be664496a69f,0,Jens Geyer,2015-09-05 12:50:24+02:00,['96d80200c5dae4fa95b8fa068c6a712773ec321b'],50,52,102,932485,13,1,1,1,2427
34e0bb64bda3f7163e715fab09d014696deefa9c,1,Roger Meier,2015-09-08 23:22:44+02:00,['5bc8b5a3a5da507b6f87436ca629be664496a69f'],14,21,35,932520,3,,,,2427
ab1bfa90136fa0c9c778a3a312a9b762050858ef,0,Jens Geyer,2015-09-11 23:49:54+02:00,['34e0bb64bda3f7163e715fab09d014696deefa9c'],24,69,93,932613,3,,,,2427
0f17e15255f772167ab8bd844a5ddbcbec7ea616,1,Jens Geyer,2015-09-15 21:44:53+02:00,['ab1bfa90136fa0c9c778a3a312a9b762050858ef'],13,75,88,932701,4,1,1,1,2429
614a67016d8b2af56d850070973d4cd8f21c83c5,0,jfarrell,2015-09-15 17:05:41-04:00,['0f17e15255f772167ab8bd844a5ddbcbec7ea616'],1,1,2,932703,1,,,,2429
6857b7fe90bd1561b9b982f9063bccaa25107b1d,0,Roger Meier,2015-09-17 09:46:24+02:00,['614a67016d8b2af56d850070973d4cd8f21c83c5'],1,1,2,932705,1,,,,2429
ff4a8edd50621fb6aab7dbbf6968d4322700ed7d,1,Roger Meier,2015-09-19 20:49:50+02:00,['6857b7fe90bd1561b9b982f9063bccaa25107b1d'],0,4,4,932709,1,,,,2429
b9257395509bc6fbcc2f77e0f9237e39f7ec1a7d,0,Jens Geyer,2015-09-21 22:36:45+02:00,['ff4a8edd50621fb6aab7dbbf6968d4322700ed7d'],5,16,21,932730,1,0.8,1,0.2,2429
61444d7be5d5a0949b87d28d6fc3cd87152716cb,0,Jens Geyer,2015-09-21 22:43:28+02:00,['b9257395509bc6fbcc2f77e0f9237e39f7ec1a7d'],1,17,18,932748,1,0.5,0.5,0.5,2429
c2993c0edfd5355d4a5fae03e0e1c292536001f1,0,Roger Meier,2015-09-21 23:03:30+02:00,['61444d7be5d5a0949b87d28d6fc3cd87152716cb'],1,0,1,932749,1,,,,2429
245c347b7374182f8142ac07e43473ddd8c4d0de,0,Roger Meier,2015-09-21 23:06:18+02:00,['c2993c0edfd5355d4a5fae03e0e1c292536001f1'],1,4,5,932754,1,,,,2429
a649e7473bd0229f160332f0c80407ba49765065,1,Roger Meier,2015-09-21 23:07:39+02:00,['245c347b7374182f8142ac07e43473ddd8c4d0de'],7,235,242,932996,24,0.452702703,0.47972973,0.817567568,2429
293e2f450b22a993516c7703645540e72e7d3e85,0,Jens Geyer,2015-09-21 23:18:07+02:00,['a649e7473bd0229f160332f0c80407ba49765065'],1,1,2,932998,1,,,,2429
840f3ef649053ad0c971afd5558ab45a39b6d11d,0,Roger Meier,2015-09-21 23:36:27+02:00,['293e2f450b22a993516c7703645540e72e7d3e85'],3,2,5,933003,1,,,,2429
2a640c4ca2e577d05b1e592b12402c915e644452,0,Roger Meier,2015-09-21 23:48:09+02:00,['840f3ef649053ad0c971afd5558ab45a39b6d11d'],0,4,4,933007,1,,,,2429
39ba6b71f575432140db5fbd0debee232f097194,0,Jens Geyer,2015-09-22 00:23:51+02:00,['2a640c4ca2e577d05b1e592b12402c915e644452'],0,12,12,933019,2,,,,2429
fa2daef14bae4aea655a94b91a2e4c479debf9c2,0,Jens Geyer,2015-09-22 00:29:32+02:00,['39ba6b71f575432140db5fbd0debee232f097194'],0,26,26,933045,2,,,,2429
cf63c95c17542da2ef94bb6f27463cb7b0ed86b7,0,Roger Meier,2015-09-22 07:46:48+02:00,['fa2daef14bae4aea655a94b91a2e4c479debf9c2'],1,1,2,933047,1,,,,2429
68238297100517db0202a7f9698ac637bc8d1c35,0,Roger Meier,2015-09-22 07:48:25+02:00,['cf63c95c17542da2ef94bb6f27463cb7b0ed86b7'],134,146,280,933327,3,0.591397849,1,0.913978495,2429
d629ea0bb271f625763a4f083602811fc9cf1b61,1,Jens Geyer,2015-09-23 21:20:38+02:00,['68238297100517db0202a7f9698ac637bc8d1c35'],392,557,949,934276,11,0.103603604,0.157657658,1,2430
8c7b03c2a56d157d95cf98df3539128fd353ebe5,1,Jens Geyer,2015-09-23 21:20:57+02:00,['d629ea0bb271f625763a4f083602811fc9cf1b61'],29,37,66,934342,1,0,0.5,1,2430
804504b79a17c6e3e3f59218679288102a4e33aa,0,Jens Geyer,2015-09-23 22:01:06+02:00,['8c7b03c2a56d157d95cf98df3539128fd353ebe5'],1,1,2,934344,1,,,,2430
b121a586b20c801bb52aa423b2d0edddf5d3ce9e,0,Jens Geyer,2015-09-23 23:05:26+02:00,['804504b79a17c6e3e3f59218679288102a4e33aa'],16,13,29,934373,1,0,0,1,2430
27be411ee0eb8799861262275c9745017031c3c4,0,jfarrell,2015-09-24 22:26:37-04:00,['b121a586b20c801bb52aa423b2d0edddf5d3ce9e'],2,1,3,934376,1,1,0,0,2430
a1ae93f4beee0d25a96b51b3022e0bde79ecb445,0,jfarrell,2015-09-24 22:58:45-04:00,['27be411ee0eb8799861262275c9745017031c3c4'],0,27,27,934403,3,,,,2431
ad3a95527cb9cddce38d0c0207ede174b556f972,0,jfarrell,2015-09-24 23:27:34-04:00,['a1ae93f4beee0d25a96b51b3022e0bde79ecb445'],23,23,46,934449,2,,,,2431
c623197d37be470307c70c54d600ce8e74ed1373,1,Konrad Grochowski,2015-09-25 20:41:42+02:00,['ad3a95527cb9cddce38d0c0207ede174b556f972'],28,46,74,934523,1,0.55,0.7,0.7,2431
0621e1fc949a7e67c418b465f7f10ee082ea4a93,0,Jens Geyer,2015-09-25 20:54:45+02:00,['c623197d37be470307c70c54d600ce8e74ed1373'],1,5,6,934529,1,1,1,1,2431
e9bdb411fbf06aa51d25a6fd85a76327b2dc4ae4,1,Konrad Grochowski,2015-09-25 21:04:57+02:00,['0621e1fc949a7e67c418b465f7f10ee082ea4a93'],60,72,132,934661,5,1,0,0,2431
ce636dd65c8de50f8f5d8cab3c2514bff98aab23,0,Konrad Grochowski,2015-09-25 21:11:55+02:00,['e9bdb411fbf06aa51d25a6fd85a76327b2dc4ae4'],1,1,2,934663,1,,,,2431
f2c9f1b968f2b5716cf6b96b36e133cd7e07cde6,0,Jens Geyer,2015-09-25 23:00:30+02:00,['ce636dd65c8de50f8f5d8cab3c2514bff98aab23'],0,1,1,934664,1,,,,2431
01ede042aad2d44a0dbe11818dabef7897e04db4,1,Roger Meier,2015-09-28 20:38:37+02:00,['f2c9f1b968f2b5716cf6b96b36e133cd7e07cde6'],278,376,654,935318,13,1,0,1,2431
0333dbf0b5fc975c9c8d2b8d9dd057e372b9846a,0,Roger Meier,2015-09-29 21:02:10+02:00,['01ede042aad2d44a0dbe11818dabef7897e04db4'],2,2,4,935322,1,,,,2431
15c400488550d565e5436f1e77ad3fdddfd4ef66,0,Jens Geyer,2015-09-29 21:33:23+02:00,['0333dbf0b5fc975c9c8d2b8d9dd057e372b9846a'],2,2,4,935326,1,,,,2431
4a62f188fc6d44f4341b7bdd52179e87b700e707,0,Jens Geyer,2015-09-29 22:09:18+02:00,['15c400488550d565e5436f1e77ad3fdddfd4ef66'],0,4,4,935330,1,,,,2431
a03464c526931fd09fc89a6e952600d0c5514421,0,Roger Meier,2015-09-30 08:15:53+02:00,['4a62f188fc6d44f4341b7bdd52179e87b700e707'],24,33,57,935387,2,,,,2432
60aa640c3028a0c6314a2ae4e40d32e40f355464,0,Roger Meier,2015-09-30 15:49:55+02:00,['a03464c526931fd09fc89a6e952600d0c5514421'],35,29,64,935451,1,,,,2432
178b813acd6dd3e334b88386be938415d9f3bf97,1,Jens Geyer,2015-09-30 23:16:45+02:00,['60aa640c3028a0c6314a2ae4e40d32e40f355464'],351,613,964,936415,12,0.042763158,0,0.782894737,2432
96409d9dfecd8213726ee83ff1ac40695f8eeeec,0,Jens Geyer,2015-09-30 23:30:35+02:00,['178b813acd6dd3e334b88386be938415d9f3bf97'],6,6,12,936427,2,,,,2432
53dd39833a08ce33582e5ff31fa18bb4735d6731,0,jfarrell,2015-10-01 13:16:28-04:00,['f2c9f1b968f2b5716cf6b96b36e133cd7e07cde6'],55,505,560,936987,38,,,,2432
123258ba60facd8581d868c71a543487b2acff3c,0,Jens Geyer,2015-10-02 00:38:17+02:00,['96409d9dfecd8213726ee83ff1ac40695f8eeeec'],29,42,71,937058,11,1,1,1,2432
932c4700c6e3aee20b74d5e2f562326029e6b9c8,1,Jens Geyer,2015-10-03 01:43:59+02:00,['123258ba60facd8581d868c71a543487b2acff3c'],1,7741,7742,944800,69,0.140764331,0.382802548,0.691082803,2491
a8d5a7841d42a9d663bc7fb2379500597a7d5020,0,Jens Geyer,2015-10-03 01:44:44+02:00,['932c4700c6e3aee20b74d5e2f562326029e6b9c8'],11,11,22,944822,5,,,,2491
5bb45d04fecf341e007f627dccda4299f1e50628,0,Jens Geyer,2015-10-05 21:47:05+02:00,['a8d5a7841d42a9d663bc7fb2379500597a7d5020'],2,2,4,944826,1,,,,2491
61b8a29b0704ccd81b520f2300f5d1bb261fea3e,0,Jens Geyer,2015-10-05 21:55:49+02:00,['5bb45d04fecf341e007f627dccda4299f1e50628'],2,2,4,944830,1,,,,2491
855cf7f089730a7df657f45e25afa0b6043a72c8,1,Jens Geyer,2015-10-08 21:12:57+02:00,['61b8a29b0704ccd81b520f2300f5d1bb261fea3e'],12,18,30,944860,9,,,,2491
f124b55e6d974b97a68b045d4dffc152e00040af,1,Jens Geyer,2015-10-08 22:42:50+02:00,['855cf7f089730a7df657f45e25afa0b6043a72c8'],0,4,4,944864,2,,,,2491
983bf7de419dca19dac755970218a7d09bea8553,1,Randy Abernethy,2015-10-09 12:28:57-07:00,['f124b55e6d974b97a68b045d4dffc152e00040af'],161,103,264,945128,15,1,1,0.117647059,2491
56e5b9b01b5a033306d583cd2aec07a0dda3c9f5,1,Jens Geyer,2015-10-09 22:01:55+02:00,['983bf7de419dca19dac755970218a7d09bea8553'],3050,7806,10856,955984,73,0.201606733,0.447207345,0.726472839,2511
8cd519f7a3b9436ae95049ee4299441306bdeb5c,0,Roger Meier,2015-10-11 00:18:02+02:00,['56e5b9b01b5a033306d583cd2aec07a0dda3c9f5'],5,35,40,956024,3,0.090909091,1,1,2511
64b8f6ca15fcb88145c447562258ebfab992dd10,0,Roger Meier,2015-10-11 00:23:31+02:00,['8cd519f7a3b9436ae95049ee4299441306bdeb5c'],3,30,33,956057,2,0,1,1,2511
30f465db92b95d6beedb8d5d056792a4e75f0158,0,Roger Meier,2015-10-11 00:40:37+02:00,['64b8f6ca15fcb88145c447562258ebfab992dd10'],1,23,24,956081,2,0,0,1,2511
dd08f6e43cf1d9eccf5e5de702106bbbbd9b2b07,0,Roger Meier,2015-10-11 00:47:27+02:00,['30f465db92b95d6beedb8d5d056792a4e75f0158'],12,49,61,956142,4,0,0,0.914285714,2511
5d93b04f9ee4b75dc9b82122fef2a759f88d9fdb,0,Roger Meier,2015-10-11 00:48:59+02:00,['dd08f6e43cf1d9eccf5e5de702106bbbbd9b2b07'],0,25,25,956167,2,0,0,1,2511
a175437f66fa1a0b36233e7dd40b061d471276ff,1,Roger Meier,2015-10-11 00:55:58+02:00,['5d93b04f9ee4b75dc9b82122fef2a759f88d9fdb'],19,24,43,956210,6,0,0,1,2511
d9d51208549d0fe630791847b2904410c418d829,0,Roger Meier,2015-10-11 09:13:37+02:00,['a175437f66fa1a0b36233e7dd40b061d471276ff'],2,7,9,956219,1,0,1,1,2511
ca8629e0bb3634ab476520cce5cc9a5615dfab7a,1,jfarrell,2015-10-11 21:31:52-04:00,['d9d51208549d0fe630791847b2904410c418d829'],1,1,2,956221,1,,,,2511
22508c3c9412af1f7d69e8436d4d09a208765716,0,jfarrell,2015-10-11 22:28:54-04:00,['ca8629e0bb3634ab476520cce5cc9a5615dfab7a'],0,437,437,956658,1,,,,2511
2d3eff5d387d9f8740dc5aec9ed77c2e05b4d284,0,Roger Meier,2015-10-13 23:27:00+02:00,['22508c3c9412af1f7d69e8436d4d09a208765716'],1,1,2,956660,1,,,,2511
673c44bc11250cf5ed891d7855e915de5ed70ed8,1,Jens Geyer,2015-10-13 23:58:50+02:00,['2d3eff5d387d9f8740dc5aec9ed77c2e05b4d284'],130,180,310,956970,1,0,0,0.75,2511
bb272dbcd5956f727a604f9643bc87b8fd5e1ed4,0,Jens Geyer,2015-10-14 00:17:28+02:00,['673c44bc11250cf5ed891d7855e915de5ed70ed8'],5,59,64,957034,1,,,,2511
9b9366145cd832c2219ffe884b01f9a7c9980b36,0,Jens Geyer,2015-10-14 00:34:05+02:00,['bb272dbcd5956f727a604f9643bc87b8fd5e1ed4'],4,4,8,957042,2,,,,2511
228b328f7bffe4d03bc22027d5c6af58251dc3d0,1,Jens Geyer,2015-10-14 00:40:23+02:00,['9b9366145cd832c2219ffe884b01f9a7c9980b36'],10,79,89,957131,6,0.18,0.18,0.88,2511
86da51d2aedb499f198c47c451929da687dea3f9,1,Jens Geyer,2015-10-14 14:34:03+02:00,['228b328f7bffe4d03bc22027d5c6af58251dc3d0'],14,40,54,957185,1,0.388888889,1,1,2511
a84e139215c93a2673a46fa862eb1c05d157e3d0,1,Konrad Grochowski,2015-10-16 11:36:36+02:00,['86da51d2aedb499f198c47c451929da687dea3f9'],8,116,124,957309,3,0.517241379,0.724137931,1,2511
145749c7a2692a29e2c7fc4088e336e37a2ff7e3,0,Jens Geyer,2015-10-16 19:21:22+02:00,['a84e139215c93a2673a46fa862eb1c05d157e3d0'],1,7,8,957317,1,0,1,0,2511
fa0796d33208eadafb6f42964c8ef29d7751bfc2,0,Jens Geyer,2015-10-16 21:35:34+02:00,['145749c7a2692a29e2c7fc4088e336e37a2ff7e3'],2,2,4,957321,1,,,,2511
f593dd3a96dddbcd4063690d20fee98d395bb360,0,Randy Abernethy,2015-10-18 08:04:16-07:00,['fa0796d33208eadafb6f42964c8ef29d7751bfc2'],4,24,28,957349,2,1,1,1,2511
f2ab1346c6dc2290ef9b3290e1712e7987c2d562,0,Jens Geyer,2015-10-20 21:41:47+02:00,['f593dd3a96dddbcd4063690d20fee98d395bb360'],7,60,67,957416,2,,,,2511
40c28d3310ff5f18c4af085592ac658f56b8daeb,1,Jens Geyer,2015-10-20 23:17:38+02:00,['f2ab1346c6dc2290ef9b3290e1712e7987c2d562'],204,231,435,957851,36,1,1,1,2511
b343feee0d048e214c93bd78560af9185531c094,0,Nobuaki Sukegawa,2015-10-21 23:39:54+09:00,['40c28d3310ff5f18c4af085592ac658f56b8daeb'],6,0,6,957857,2,,,,2511
c8abd34ae833f1f08c40de541e14fb53bfc6f6ea,0,Nobuaki Sukegawa,2015-10-24 22:48:22+09:00,['b343feee0d048e214c93bd78560af9185531c094'],1,1,2,957859,1,,,,2511
4eb24f8f1a96bb7e6a0e45de503532a145992d05,0,Nobuaki Sukegawa,2015-10-25 13:31:50+09:00,['c8abd34ae833f1f08c40de541e14fb53bfc6f6ea'],1,1,2,957861,1,,,,2511
83072a623447093458dccdf54ddfe789e68ef0e5,0,Nobuaki Sukegawa,2015-10-25 16:00:13+09:00,['4eb24f8f1a96bb7e6a0e45de503532a145992d05'],98,139,237,958098,1,,,,2511
bc464c4ce8c1048eed3b862cb885bb25386fdc28,0,Jens Geyer,2015-10-25 16:55:58+02:00,['83072a623447093458dccdf54ddfe789e68ef0e5'],0,2,2,958100,1,0,0,1,2511
6748993dcbd7e1b1a3cdce3b0cb3b80d24dd4a24,0,Jens Geyer,2015-10-27 02:23:09+02:00,['bc464c4ce8c1048eed3b862cb885bb25386fdc28'],3,3,6,958106,1,,,,2511
27378fa34e616a4dc40d943fea358eb29d1dcd56,1,Nobuaki Sukegawa,2015-10-29 00:41:52+09:00,['6748993dcbd7e1b1a3cdce3b0cb3b80d24dd4a24'],2,262,264,958370,7,,,,2515
11b515cd29292358305ace4ce20d7e626c7e7f42,0,Jens Geyer,2015-10-29 22:09:19+02:00,['27378fa34e616a4dc40d943fea358eb29d1dcd56'],2,48,50,958420,2,0.25,0.25,1,2515
54beb80ded9286aeda7da345cbd8303e010b45e8,0,Jens Geyer,2015-10-29 22:18:42+02:00,['11b515cd29292358305ace4ce20d7e626c7e7f42'],4,57,61,958481,2,0.195121951,0.195121951,1,2515
2bfd7df93e5e2c1195a5cb2bcde42820f24b642f,1,Jens Geyer,2015-10-29 22:40:58+02:00,['54beb80ded9286aeda7da345cbd8303e010b45e8'],99,414,513,958994,13,0.509677419,0.664516129,0.64516129,2519
867fafffa5ccd80c9842ebc759951a78b402668a,0,Jens Geyer,2015-10-29 22:51:33+02:00,['2bfd7df93e5e2c1195a5cb2bcde42820f24b642f'],3,3,6,959000,1,,,,2519
d6ca81b2cc7bed049a4f06242695f29549b49309,0,Jens Geyer,2015-10-29 23:01:37+02:00,['867fafffa5ccd80c9842ebc759951a78b402668a'],0,15,15,959015,2,0.857142857,0.857142857,0.857142857,2519
a6509f7b378ed6591d550134fdda18e4a436fe77,1,Jens Geyer,2015-10-30 21:45:36+02:00,['d6ca81b2cc7bed049a4f06242695f29549b49309'],9,33,42,959057,2,,,,2519
826ea998d5590247a00a3aea09026a9d7518d1f7,1,Nobuaki Sukegawa,2015-10-31 14:54:12+09:00,['a6509f7b378ed6591d550134fdda18e4a436fe77'],72,161,233,959290,21,,,,2519
a559f8d903074afa76b4e9255e0d883b7401bf95,1,Nobuaki Sukegawa,2015-11-01 18:03:40+09:00,['826ea998d5590247a00a3aea09026a9d7518d1f7'],434,1901,2335,961625,18,,,,2526
149ecc1a5fff2f68d413df730b97cc7272813077,1,Nobuaki Sukegawa,2015-11-01 18:04:02+09:00,['a559f8d903074afa76b4e9255e0d883b7401bf95'],2,6,8,961633,1,,,,2526
7bdba5c06a7aa40cf83352c214270a2f1f4dd572,0,Nobuaki Sukegawa,2015-11-01 18:07:15+09:00,['149ecc1a5fff2f68d413df730b97cc7272813077'],33,43,76,961709,3,,,,2526
7ab56e835c8e44198c4f6875a8b2d761ae31ee40,1,Nobuaki Sukegawa,2015-11-01 18:30:20+09:00,['7bdba5c06a7aa40cf83352c214270a2f1f4dd572'],0,9,9,961718,1,,,,2526
a7d6a970339ff11ed60dbb8b73e59b1ed6482acb,0,Nobuaki Sukegawa,2015-11-01 18:30:46+09:00,['7ab56e835c8e44198c4f6875a8b2d761ae31ee40'],15,196,211,961929,5,,,,2527
f58bca7adb780f40afe26e32629515d64f581773,1,Nobuaki Sukegawa,2015-11-01 18:30:46+09:00,['a7d6a970339ff11ed60dbb8b73e59b1ed6482acb'],1,6,7,961936,2,,,,2527
36c357a90eeda250d1c7eb1d419dbe9010e0d65f,0,Jens Geyer,2015-11-02 22:13:11+01:00,['f58bca7adb780f40afe26e32629515d64f581773'],4,4,8,961944,2,,,,2527
b31f0900b57b7473a8f84c7b74f73381dcff2818,1,Nobuaki Sukegawa,2015-11-03 22:02:55+09:00,['36c357a90eeda250d1c7eb1d419dbe9010e0d65f'],17,676,693,962637,9,,,,2529
792db4e92607a38a45eeb57f9561210cd4d4ef73,1,Nobuaki Sukegawa,2015-11-04 01:25:22+09:00,['b31f0900b57b7473a8f84c7b74f73381dcff2818'],26,1593,1619,964256,23,0.483823529,0.570588235,0.864705882,2535
d3f7d0e66ce0a1dc37f2eb0b90f303c2f5b5979e,1,Roger Meier,2015-11-03 21:11:40+01:00,['792db4e92607a38a45eeb57f9561210cd4d4ef73'],2,2,4,964260,2,,,,2535
f57b57ac0b5e890d7d8ebb75610e7fe279833909,0,Roger Meier,2015-11-03 23:28:43+01:00,['d3f7d0e66ce0a1dc37f2eb0b90f303c2f5b5979e'],1,1,2,964262,1,,,,2535
f0f607ffacee42d133277518e3eb4835d1607386,0,Roger Meier,2015-11-04 12:32:44+01:00,['f57b57ac0b5e890d7d8ebb75610e7fe279833909'],2,6,8,964270,1,0,0,1,2535
fe5330955f6e52c63ed76819e4b36b9f263a9218,0,Nobuaki Sukegawa,2015-11-04 23:22:53+09:00,['f0f607ffacee42d133277518e3eb4835d1607386'],13,77,90,964360,6,0.18,1,0.86,2535
53349926e00b02c80d3f3bc1e0eb2981d96ba5dd,0,Nobuaki Sukegawa,2015-11-05 00:10:27+09:00,['fe5330955f6e52c63ed76819e4b36b9f263a9218'],1,2,3,964363,1,0,0,1,2535
673c94137aa91e3efc2ee08bbd88f6ba1bbf3a2f,1,Konrad Grochowski,2015-11-05 20:13:05+01:00,['53349926e00b02c80d3f3bc1e0eb2981d96ba5dd'],5,49,54,964417,3,0.166666667,0.333333333,0.333333333,2536
7f4be5f188409cfe80059f501cc59ad40c6b969d,0,Konrad Grochowski,2015-11-05 20:23:11+01:00,['673c94137aa91e3efc2ee08bbd88f6ba1bbf3a2f'],136,131,267,964684,13,1,1,0,2536
49f4dc0cd8c87213a0f80ae1daba2d094a358ea7,0,Nobuaki Sukegawa,2015-11-06 21:21:01+09:00,['7f4be5f188409cfe80059f501cc59ad40c6b969d'],15,177,192,964876,7,,,,2538
760511f59b349c59982a64e249e6cf24c2b2f8f6,1,Nobuaki Sukegawa,2015-11-06 21:24:16+09:00,['49f4dc0cd8c87213a0f80ae1daba2d094a358ea7'],339,460,799,965675,40,0.375,0.541666667,0.902777778,2539
a185d7e78589a42e076379ae7165857e5e828e5c,1,Nobuaki Sukegawa,2015-11-06 21:24:24+09:00,['760511f59b349c59982a64e249e6cf24c2b2f8f6'],186,280,466,966141,11,0.131147541,0.131147541,1,2539
8a4d06febe8bc2e1bd84f955b1c2f0149665a0be,1,Nobuaki Sukegawa,2015-11-06 21:25:25+09:00,['a185d7e78589a42e076379ae7165857e5e828e5c'],74,101,175,966316,5,0.54,0.7,0.52,2539
11c3569720853d3339b82fc0231d54260ccf5fa8,0,Nobuaki Sukegawa,2015-11-08 23:59:40+09:00,['8a4d06febe8bc2e1bd84f955b1c2f0149665a0be'],3,3,6,966322,3,,0,,2539
d8ddb775e4330050e04cefa711f60250905978d3,1,Nobuaki Sukegawa,2015-11-09 00:02:18+09:00,['11c3569720853d3339b82fc0231d54260ccf5fa8'],6,42,48,966370,1,0.941176471,0.941176471,0.764705882,2539
5b15f8c55f8f26644f40a9ccbbf339f6f84dacd0,1,Nobuaki Sukegawa,2015-11-09 00:02:23+09:00,['d8ddb775e4330050e04cefa711f60250905978d3'],1,12,13,966383,2,0.666666667,1,1,2539
f264884901d0e2a1197ae1511ee0fa0b8ca0d2aa,0,Roger Meier,2015-11-08 17:48:47+01:00,['5b15f8c55f8f26644f40a9ccbbf339f6f84dacd0'],0,4,4,966387,1,,,,2539
7f01e2a8f869d8622bc56e7584cce98865fa8b0f,0,Nobuaki Sukegawa,2015-11-09 02:34:28+09:00,['f264884901d0e2a1197ae1511ee0fa0b8ca0d2aa'],1,62,63,966450,2,0.361111111,0.361111111,1,2540
317d515428eed7a821d81c49e080c9aefeb39d35,0,Nobuaki Sukegawa,2015-11-11 00:31:48+09:00,['7f01e2a8f869d8622bc56e7584cce98865fa8b0f'],1,0,1,966451,1,,,,2540
c04fb0069e814d761248f26a24142730d5e80501,0,Nobuaki Sukegawa,2015-11-11 00:32:55+09:00,['317d515428eed7a821d81c49e080c9aefeb39d35'],1,1,2,966453,1,,,,2540
90ea4f64c124404f346c66de47f84fc9ced63132,0,Nobuaki Sukegawa,2015-11-11 00:32:55+09:00,['c04fb0069e814d761248f26a24142730d5e80501'],2,62,64,966517,3,0.971428571,1,1,2540
86284da8495bcaeca9d9632374ada63cbf388ead,1,Jens Geyer,2015-11-11 01:33:39+01:00,['90ea4f64c124404f346c66de47f84fc9ced63132'],8,53,61,966578,1,0.242424242,0.727272727,1,2540
517aa1491b1e16c88d17d6d83dcc7ef83bc85164,0,Konrad Grochowski,2015-11-12 16:37:58+01:00,['86284da8495bcaeca9d9632374ada63cbf388ead'],10,15,25,966603,4,,,,2540
369d62e5e925654fa6d1ca3bfe5d73023456adb1,0,Nobuaki Sukegawa,2015-11-14 17:03:57+09:00,['517aa1491b1e16c88d17d6d83dcc7ef83bc85164'],21,32,53,966656,2,1,1,0,2540
c2d4c77c5aec372bd4f265d6bff6a55c05c6e7c1,1,Nobuaki Sukegawa,2015-11-14 17:06:30+09:00,['369d62e5e925654fa6d1ca3bfe5d73023456adb1'],2,2,4,966660,2,,,,2540
75d879ab47f24cfa12dbd2057afa6df5c12a9df5,0,Nobuaki Sukegawa,2015-11-14 17:06:52+09:00,['c2d4c77c5aec372bd4f265d6bff6a55c05c6e7c1'],1,1,2,966662,1,,,,2540
622ef03f1bcadea2deb25c5cc96dea80834c3f51,0,Roger Meier,2015-11-14 11:04:01+01:00,['75d879ab47f24cfa12dbd2057afa6df5c12a9df5'],1,2,3,966665,1,,,,2540
a6b120301a05ef6bfb77d5bd7df1784b78339a09,0,Jens Geyer,2015-11-14 13:37:46+01:00,['622ef03f1bcadea2deb25c5cc96dea80834c3f51'],0,51,51,966716,2,1,1,1,2541
cc193c1becb78b75fbbb178a6e2e0e5aaa0f5b24,1,Jens Geyer,2015-11-14 14:28:09+01:00,['a6b120301a05ef6bfb77d5bd7df1784b78339a09'],1,23,24,966740,4,0.545454545,0,1,2541
eeb51962fa47c4d48ab374ffa95c088b29108396,0,Jens Geyer,2015-11-14 14:28:10+01:00,['cc193c1becb78b75fbbb178a6e2e0e5aaa0f5b24'],19,29,48,966788,3,0.857142857,0.857142857,1,2541
d80d0b214372d22bd92801039cc5a2a09a227d4e,0,Jens Geyer,2015-11-14 15:26:09+01:00,['eeb51962fa47c4d48ab374ffa95c088b29108396'],1,1,2,966790,1,,,,2541
c7b3086665b5b10f7cbcf3adae850e45c9ed6c02,0,Roger Meier,2015-11-14 17:24:11+01:00,['d80d0b214372d22bd92801039cc5a2a09a227d4e'],9,10,19,966809,4,,,,2541
7388037fa17e1253b264bb0afea3c51aaa4b40d9,1,Jens Geyer,2015-11-14 18:57:17+01:00,['c7b3086665b5b10f7cbcf3adae850e45c9ed6c02'],143,33,176,966985,4,1,1,1,2541
f892674d1755cef3b358979fd2dd644f1db3cae3,0,Roger Meier,2015-11-15 01:50:38+01:00,['7388037fa17e1253b264bb0afea3c51aaa4b40d9'],1,0,1,966986,1,,,,2541
7f404fdef23dbbe5204d35bcb9261ff50939f31f,0,Nobuaki Sukegawa,2015-11-15 14:00:18+09:00,['f892674d1755cef3b358979fd2dd644f1db3cae3'],13,11,24,967010,2,0,0,1,2541
97a48988de6a7ac513311456a6f6d3ef7f587639,1,Nobuaki Sukegawa,2015-11-15 14:00:18+09:00,['7f404fdef23dbbe5204d35bcb9261ff50939f31f'],5,8,13,967023,1,,,,2541
bc7e480d0fc80501b597ed57b94395e1c85a2069,1,Nobuaki Sukegawa,2015-11-15 14:00:18+09:00,['97a48988de6a7ac513311456a6f6d3ef7f587639'],23,43,66,967089,5,0.7,0.7,0.45,2541
6defea5f7b22ed539ad136ddd3ca09fc8352fffd,0,Nobuaki Sukegawa,2015-11-15 14:00:18+09:00,['bc7e480d0fc80501b597ed57b94395e1c85a2069'],7,439,446,967535,5,0.696132597,0.872928177,1,2542
a8c74d5c521faa333e6b70445c08f94dec6b53c1,0,Nobuaki Sukegawa,2015-11-15 14:00:18+09:00,['6defea5f7b22ed539ad136ddd3ca09fc8352fffd'],34,11,45,967580,1,,,,2542
8551f3f53dee2a879de0aa511471f0190b1fe71c,0,Nobuaki Sukegawa,2015-11-15 16:33:55+09:00,['a8c74d5c521faa333e6b70445c08f94dec6b53c1'],5,9,14,967594,1,1,1,0,2542
341390c19a4f559ddf9f64e5189ec103890ed239,0,Jens Geyer,2015-11-17 22:14:40+01:00,['8551f3f53dee2a879de0aa511471f0190b1fe71c'],10,0,10,967604,1,1,1,1,2542
13ac77daf031443ebdfbee02bad528f53b6212eb,1,Jens Geyer,2015-11-17 22:44:26+01:00,['341390c19a4f559ddf9f64e5189ec103890ed239'],18,108,126,967730,2,0.387096774,1,1,2542
2faac5afac4c962d4ef1d339871db90941735118,0,Jens Geyer,2015-11-17 23:36:24+01:00,['13ac77daf031443ebdfbee02bad528f53b6212eb'],1,1,2,967732,1,,,,2542
bbb8f5c46b8e15511b7923c5e363000fed65ed34,0,Jens Geyer,2015-11-19 21:34:43+01:00,['2faac5afac4c962d4ef1d339871db90941735118'],2,13,15,967747,1,0.5,1,1,2542
8d8d6573f7d18150f6915484babbe82d6af60b58,0,Jens Geyer,2015-11-20 21:20:37+01:00,['bbb8f5c46b8e15511b7923c5e363000fed65ed34'],7,14,21,967768,1,1,1,1,2542
aad06deedd780d443312905fbd80a081fa8fb442,0,Jens Geyer,2015-11-21 15:03:32+01:00,['8d8d6573f7d18150f6915484babbe82d6af60b58'],6,23,29,967797,3,1,1,1,2542
314fea26fe4d85d17d785d97f1e814fb448b82b9,1,Roger Meier,2015-11-22 20:52:40+01:00,['aad06deedd780d443312905fbd80a081fa8fb442'],11,22,33,967830,1,0.875,0.875,0.875,2542
ca93936e781508e9f9c8e58c26a08809b037cc29,1,Nobuaki Sukegawa,2015-11-23 16:59:10+09:00,['314fea26fe4d85d17d785d97f1e814fb448b82b9'],71,230,301,968131,15,,,,2547
ae971ce917bf9b60ee8ae83b834dad1eb149a82f,1,Nobuaki Sukegawa,2015-11-23 17:07:10+09:00,['ca93936e781508e9f9c8e58c26a08809b037cc29'],29,379,408,968539,11,,,,2552
0ad6ee95e002f41dd628d4044f901468f43ffc32,1,Nobuaki Sukegawa,2015-11-23 17:09:27+09:00,['ae971ce917bf9b60ee8ae83b834dad1eb149a82f'],31,595,626,969165,8,0.181818182,0.446524064,0.967914439,2553
69826b21ec2e220254526063ae7fa2d3c118a6f4,0,Nobuaki Sukegawa,2015-11-23 17:09:27+09:00,['0ad6ee95e002f41dd628d4044f901468f43ffc32'],4,84,88,969253,1,0.154929577,0.154929577,1,2553
2de2700c34bde8d7576da148852c43a32c11e94a,0,Nobuaki Sukegawa,2015-11-23 21:24:00+09:00,['69826b21ec2e220254526063ae7fa2d3c118a6f4'],24,33,57,969310,4,0,0,0,2554
cacce2f1d503b7e98842308852237af53180fd87,0,Nobuaki Sukegawa,2015-11-23 21:24:24+09:00,['2de2700c34bde8d7576da148852c43a32c11e94a'],180,228,408,969718,6,0.284615385,0.284615385,0.646153846,2554
e8c71d8cc9d0138cd7f48616ce64b50ae0a1b932,1,Nobuaki Sukegawa,2015-11-23 22:45:25+09:00,['cacce2f1d503b7e98842308852237af53180fd87'],46,73,119,969837,8,,,,2554
e58ed1ad390dc15965acb2b898d60cf88364378b,0,Nobuaki Sukegawa,2015-11-25 22:53:26+09:00,['e8c71d8cc9d0138cd7f48616ce64b50ae0a1b932'],53,59,112,969949,1,,,,2554
547909933c25cbf0b8d2c91958dbd2972320513a,0,Nobuaki Sukegawa,2015-11-27 00:08:27+09:00,['e58ed1ad390dc15965acb2b898d60cf88364378b'],11,15,26,969975,1,,,,2554
ef3cf819e120cc46ef8e1b35baa07eae3a39126a,0,Nobuaki Sukegawa,2015-11-27 00:08:41+09:00,['547909933c25cbf0b8d2c91958dbd2972320513a'],1,1,2,969977,1,,,,2554
b9641e0949f5de5a3c8079758fdd638889614143,0,Roger Meier,2015-11-27 23:32:40+01:00,['ef3cf819e120cc46ef8e1b35baa07eae3a39126a'],1,1,2,969979,1,,,,2554
e841b3dac619a5e5d3523d059d48db1a12e41360,1,Roger Meier,2015-11-28 00:08:07+01:00,['b9641e0949f5de5a3c8079758fdd638889614143'],152,451,603,970582,9,0.408256881,0.188073394,0.555045872,2555
b0526d5243c18855940846a99e2ca5254b0828f2,0,Roger Meier,2015-11-28 00:58:31+01:00,['e841b3dac619a5e5d3523d059d48db1a12e41360'],5,35,40,970622,1,0,1,0.727272727,2555
a43063caac0762a28ba1fa09b3498ee97877374b,0,Roger Meier,2015-11-28 13:41:30+01:00,['b0526d5243c18855940846a99e2ca5254b0828f2'],0,1,1,970623,1,,,,2555
6dab9bbeb520159d96126a44bc849aa1bd9c4209,0,Nobuaki Sukegawa,2015-11-28 22:34:01+09:00,['a43063caac0762a28ba1fa09b3498ee97877374b'],2,2,4,970627,1,,,,2555
0399a9c099122911ef41ff73bce57da0fb0e843f,0,Roger Meier,2015-11-28 17:36:57+01:00,['6dab9bbeb520159d96126a44bc849aa1bd9c4209'],35,0,35,970662,1,,,,2555
9921300deeb5906cb9c7df33020d19abf9894910,0,Roger Meier,2015-11-28 18:12:01+01:00,['0399a9c099122911ef41ff73bce57da0fb0e843f'],1,0,1,970663,1,,,,2555
54a2e6452fbaed5a82e3b9a8504cf2850d4da191,0,Roger Meier,2015-11-29 16:58:15+01:00,['9921300deeb5906cb9c7df33020d19abf9894910'],0,4,4,970667,1,1,1,1,2555
d254409095b0635e713d20881240e948ebf433bc,0,Roger Meier,2015-11-29 18:00:50+01:00,['54a2e6452fbaed5a82e3b9a8504cf2850d4da191'],0,10,10,970677,1,,,,2555
ad6fd1b6d2aed845e07769a84531e5b69a647146,0,Jens Geyer,2015-11-30 21:40:01+01:00,['d254409095b0635e713d20881240e948ebf433bc'],2,6,8,970685,1,0,1,1,2555
56c1dde14504af833943bee7d4b216c889c97a35,1,Jens Geyer,2015-11-30 22:14:44+01:00,['ad6fd1b6d2aed845e07769a84531e5b69a647146'],2,2,4,970689,1,,,,2555
665844e60fa824016815fa3bed824a097799ae26,0,Roger Meier,2015-12-01 13:34:41+01:00,['56c1dde14504af833943bee7d4b216c889c97a35'],1,1,2,970691,1,,,,2555
73fae0fbb767805c63652a3305f1caa7b1288208,1,Nobuaki Sukegawa,2015-12-02 01:22:12+09:00,['665844e60fa824016815fa3bed824a097799ae26'],2,3,5,970696,2,,,,2555
aede97523d1c587c2ed5832cde60f8948c68bcd5,0,Nobuaki Sukegawa,2015-12-02 02:03:53+09:00,['73fae0fbb767805c63652a3305f1caa7b1288208'],0,890,890,971586,8,0.946188341,1,0.930493274,2562
f56b90772f5a60e08c88388af753a71d519591c3,1,Nobuaki Sukegawa,2015-12-02 02:03:59+09:00,['aede97523d1c587c2ed5832cde60f8948c68bcd5'],49,448,497,972083,7,0.169491525,0.410169492,0.966101695,2564
0d227b1a79f83baa9c3bd3d5d134792d3a8da386,0,Jens Geyer,2015-12-02 19:53:42+01:00,['f56b90772f5a60e08c88388af753a71d519591c3'],1,1,2,972085,1,,,,2564
3aa617a48341341feb767280eb87da6ea3d05417,1,Jens Geyer,2015-12-02 21:10:13+01:00,['0d227b1a79f83baa9c3bd3d5d134792d3a8da386'],3,10,13,972098,1,0,0.4,1,2564
620e7a893a32867b664de4d8b648c8f1811d9f6f,0,Jens Geyer,2015-12-02 21:41:58+01:00,['3aa617a48341341feb767280eb87da6ea3d05417'],5,8,13,972111,1,,,,2564
bc3829e8fdc4a39b7ba45b9dbc8317ff22bea004,1,Jens Geyer,2015-12-02 21:46:34+01:00,['620e7a893a32867b664de4d8b648c8f1811d9f6f'],1,1,2,972113,1,,,,2564
dd89dce84b73ca671c8e0b3cf597f1888e2a75dc,0,Jens Geyer,2015-12-02 21:50:11+01:00,['bc3829e8fdc4a39b7ba45b9dbc8317ff22bea004'],2,3,5,972118,2,,,,2564
70e6c29e3a0cce7e40a23c6646147ce312e7ab24,0,Nobuaki Sukegawa,2015-12-04 00:37:31+09:00,['dd89dce84b73ca671c8e0b3cf597f1888e2a75dc'],8,20,28,972146,1,0.363636364,0.818181818,0.909090909,2564
2e00c9998f1aa316c8d0168488887fb957845230,0,Nobuaki Sukegawa,2015-12-04 00:38:33+09:00,['70e6c29e3a0cce7e40a23c6646147ce312e7ab24'],44,35,79,972225,3,0.222222222,0,0.333333333,2564
362a5eda211e3f8093b739aeaaee93b118ace199,1,Nobuaki Sukegawa,2015-12-04 00:38:33+09:00,['2e00c9998f1aa316c8d0168488887fb957845230'],1,56,57,972282,5,0.233333333,0.9,0.9,2565
f08771ccead48b2eafa38930eb90f74f99e1c4af,1,Jens Geyer,2015-12-04 21:31:04+01:00,['362a5eda211e3f8093b739aeaaee93b118ace199'],2,3,5,972287,1,0,0,1,2565
1a32c3b93fb8fc5c48d7fe8ee22398b073d812d6,0,Nobuaki Sukegawa,2015-12-05 11:27:41+09:00,['f08771ccead48b2eafa38930eb90f74f99e1c4af'],2,2,4,972291,1,,,,2565
a6ab1f5e6d8c5f8c64d356d72993a423cc2bf588,1,Nobuaki Sukegawa,2015-12-05 11:28:27+09:00,['1a32c3b93fb8fc5c48d7fe8ee22398b073d812d6'],255,406,661,972952,23,0.1,0.1,0,2571
ba3fe86b0ab50fa5e934debe9c3bca185ca9b704,1,Nobuaki Sukegawa,2015-12-06 10:11:16+09:00,['a6ab1f5e6d8c5f8c64d356d72993a423cc2bf588'],209,391,600,973552,10,1,1,1,2571
9caf6d63c6d582c407a692cf9be923586006499c,0,Nobuaki Sukegawa,2015-12-06 10:11:19+09:00,['ba3fe86b0ab50fa5e934debe9c3bca185ca9b704'],3,41,44,973596,3,,,,2572
791ee36f7b5dbba1c74d7a4b1ddb43c43516e769,0,Roger Meier,2015-12-06 11:37:37+01:00,['9caf6d63c6d582c407a692cf9be923586006499c'],4,2,6,973602,1,,,,2572
8644617f7db706ac9bef3b286eb55e30a86a0464,1,Roger Meier,2015-12-06 21:26:58+01:00,['791ee36f7b5dbba1c74d7a4b1ddb43c43516e769'],0,50,50,973652,2,,,,2574
84cf363eeedf4cc9bb618bb2b1980696b9f6fc9b,0,Roger Meier,2015-12-07 23:14:13+01:00,['8644617f7db706ac9bef3b286eb55e30a86a0464'],0,10,10,973662,1,0.777777778,0.777777778,1,2574
3143bfbe15b42c758aa627ef402b21cbb1245851,0,Roger Meier,2015-12-08 20:11:20+01:00,['84cf363eeedf4cc9bb618bb2b1980696b9f6fc9b'],0,22,22,973684,1,1,1,1,2574
5eed3a161fc4750ac7db5651373c5c2ece709fe6,1,Jens Geyer,2015-12-08 21:05:52+01:00,['3143bfbe15b42c758aa627ef402b21cbb1245851'],5,13,18,973702,3,,,,2574
52de5cafbdec0feb9e0d16531b28f8f0654b8780,0,Jens Geyer,2015-12-08 23:03:17+01:00,['5eed3a161fc4750ac7db5651373c5c2ece709fe6'],7,1,8,973710,3,,,,2574
0156aaed107d6910935918c3044348579e92765c,1,Nobuaki Sukegawa,2015-12-09 23:21:45+09:00,['52de5cafbdec0feb9e0d16531b28f8f0654b8780'],2,1,3,973713,1,,,,2574
9d0f752abcd7b9435c245371d74a2086006a6417,1,Nobuaki Sukegawa,2015-12-11 00:18:01+09:00,['0156aaed107d6910935918c3044348579e92765c'],0,123,123,973836,2,1,1,0.727272727,2576
4f6138b7a2762f1937b49389f72b348736973e22,0,Nobuaki Sukegawa,2015-12-11 00:18:01+09:00,['9d0f752abcd7b9435c245371d74a2086006a6417'],22,24,46,973882,1,0,0,0,2576
7c7d679a127ed5157464b061a7f9bfd40ad2f1fa,1,Nobuaki Sukegawa,2015-12-11 00:18:01+09:00,['4f6138b7a2762f1937b49389f72b348736973e22'],20,291,311,974193,12,,,,2580
dfb6896436904d0fbe1f762de898a3c68c989aa9,0,Nobuaki Sukegawa,2015-12-11 00:19:09+09:00,['7c7d679a127ed5157464b061a7f9bfd40ad2f1fa'],5,21,26,974219,4,0,0,1,2580
d0e444c9d926eb4df2f09b831730b44b21c8f3de,0,Jens Geyer,2015-12-11 21:29:37+01:00,['dfb6896436904d0fbe1f762de898a3c68c989aa9'],2,0,2,974221,1,0,0,0,2580
eb5f117452b2a1ee1659389448f575f32312ae9f,0,Jens Geyer,2015-12-11 21:29:38+01:00,['d0e444c9d926eb4df2f09b831730b44b21c8f3de'],3,3,6,974227,2,,,,2580
f48e339cc99aab7f6206c360d4193dd9944ad156,0,Nobuaki Sukegawa,2015-12-13 14:07:17+09:00,['eb5f117452b2a1ee1659389448f575f32312ae9f'],6,8,14,974241,1,,,,2580
ef2b5285f3be08e52000a60d3de2e2f8a30f892b,0,Nobuaki Sukegawa,2015-12-13 14:07:27+09:00,['f48e339cc99aab7f6206c360d4193dd9944ad156'],30,208,238,974479,6,,,,2581
e68ccc23bebde961767e47e6751dcf764b8503f2,1,Nobuaki Sukegawa,2015-12-13 23:48:22+09:00,['ef2b5285f3be08e52000a60d3de2e2f8a30f892b'],34,145,179,974658,17,0,0,0,2581
176bf0c36d0be38300ec51ea78565a9f27f844f7,0,Jens Geyer,2015-12-17 22:20:26+01:00,['e68ccc23bebde961767e47e6751dcf764b8503f2'],2,4,6,974664,1,,,,2581
7be41c7ada9692e3c37fb8b4935991f6247320f6,0,Jens Geyer,2015-12-17 22:21:24+01:00,['176bf0c36d0be38300ec51ea78565a9f27f844f7'],1,1,2,974666,1,,,,2581
23d6746079d7b5fdb38214387c63f987e68a6d8f,1,Jens Geyer,2015-12-19 11:45:34+01:00,['7be41c7ada9692e3c37fb8b4935991f6247320f6'],2,20,22,974688,2,,,,2581
ae3775a6a5d7f2aeb192ade30d157aa54aa4e77f,1,Nobuaki Sukegawa,2015-12-24 02:11:13+09:00,['23d6746079d7b5fdb38214387c63f987e68a6d8f'],49,279,328,975016,8,,,,2585
9b35a7c021d06b9322e208e466a0f2aac1e95212,1,Nobuaki Sukegawa,2015-12-24 02:11:17+09:00,['ae3775a6a5d7f2aeb192ade30d157aa54aa4e77f'],200,325,525,975541,5,0.048387097,0.225806452,1,2585
dd02f552835615f566ee811f96515e23d63c352b,0,Nobuaki Sukegawa,2015-12-24 02:11:17+09:00,['9b35a7c021d06b9322e208e466a0f2aac1e95212'],4,10,14,975555,1,1,1,1,2585
39e505c150486cc2a9c8aaa6ff0a39711ecad567,0,Nobuaki Sukegawa,2015-12-24 02:11:17+09:00,['dd02f552835615f566ee811f96515e23d63c352b'],38,38,76,975631,4,1,0,1,2585
a873e1609724d51a89ac07f03c1e96531866e2ea,0,Nobuaki Sukegawa,2015-12-24 02:11:17+09:00,['39e505c150486cc2a9c8aaa6ff0a39711ecad567'],5,5,10,975641,1,,,,2585
1719bf41b8015cef892e18db7f5ed0e6c496139d,0,Nobuaki Sukegawa,2015-12-24 02:11:17+09:00,['a873e1609724d51a89ac07f03c1e96531866e2ea'],0,6,6,975647,2,,,,2585
6dde7f19254db71cf27df214a59d7156967237fc,1,Nobuaki Sukegawa,2015-12-24 02:11:17+09:00,['1719bf41b8015cef892e18db7f5ed0e6c496139d'],0,2,2,975649,1,,,,2585
7b8946941e5bcb1217711115fed3f6c77d73b5ef,0,Nobuaki Sukegawa,2016-01-02 22:54:16+09:00,['6dde7f19254db71cf27df214a59d7156967237fc'],106,99,205,975854,7,1,0.333333333,0.333333333,2585
b9c859a07bae89643c0953a14e490cf3db435957,1,Nobuaki Sukegawa,2016-01-02 22:54:16+09:00,['7b8946941e5bcb1217711115fed3f6c77d73b5ef'],19,19,38,975892,8,,,,2585
b78d781b2e55a066d53577402e42b4d509998978,0,Nobuaki Sukegawa,2016-01-02 22:54:16+09:00,['b9c859a07bae89643c0953a14e490cf3db435957'],15,25,40,975932,3,0,0,0,2585
ad8358664e6aa2de9094ca68c8b626b953b572c0,1,Nobuaki Sukegawa,2016-01-03 02:39:51+09:00,['b78d781b2e55a066d53577402e42b4d509998978'],153,653,806,976738,13,0.604316547,0.579136691,0.701438849,2587
117af5c3a3216c1bb21a38d395032c2016116300,0,Nobuaki Sukegawa,2016-01-03 02:40:38+09:00,['ad8358664e6aa2de9094ca68c8b626b953b572c0'],0,2,2,976740,1,,,,2587
56cf779591b05cb68f83c8b71897dca7ec6d487c,0,Nobuaki Sukegawa,2016-01-03 02:54:25+09:00,['117af5c3a3216c1bb21a38d395032c2016116300'],5,1,6,976746,1,,,,2587
bf8f7b425ee24269ae71c5431362d17a5ca475ef,0,Nobuaki Sukegawa,2016-01-03 02:55:03+09:00,['56cf779591b05cb68f83c8b71897dca7ec6d487c'],77,90,167,976913,6,0.153846154,0.846153846,0.846153846,2587
2aaae8a604c9a3f000926250a8446b7b850355c7,0,Nobuaki Sukegawa,2016-01-03 02:55:16+09:00,['bf8f7b425ee24269ae71c5431362d17a5ca475ef'],1,40,41,976954,2,0,1,0.620689655,2587
269473d4750a1e03ff0c85125bfa20b2f2475aa3,0,Nobuaki Sukegawa,2016-01-03 02:55:16+09:00,['2aaae8a604c9a3f000926250a8446b7b850355c7'],3,3,6,976960,1,,,,2587
7b69c1889e2b78c9c8767288043a7f253e00f54b,0,Nobuaki Sukegawa,2016-01-03 23:30:19+09:00,['269473d4750a1e03ff0c85125bfa20b2f2475aa3'],3,0,3,976963,1,,,,2587
1d8e745035354e67c794bec9e0b5663ee7cab902,0,Nobuaki Sukegawa,2016-01-05 03:02:35+09:00,['7b69c1889e2b78c9c8767288043a7f253e00f54b'],1,1,2,976965,1,,,,2587
33744b0524b7248dda9e9e544420d69c33d3a3aa,0,Nobuaki Sukegawa,2016-01-05 03:02:35+09:00,['1d8e745035354e67c794bec9e0b5663ee7cab902'],39,103,142,977107,10,1,1,1,2589
378b727f8ec6a7a218b9b3d63cc1b0ffdf251826,1,Nobuaki Sukegawa,2016-01-05 03:02:35+09:00,['33744b0524b7248dda9e9e544420d69c33d3a3aa'],118,255,373,977480,11,0,0,0.298701299,2593
fe3f33619ed268c1dcbea2523bed4b5f935d404b,0,Nobuaki Sukegawa,2016-01-06 04:35:12+09:00,['378b727f8ec6a7a218b9b3d63cc1b0ffdf251826'],3,18,21,977501,1,0.777777778,0.888888889,1,2593
796667b29f91682871cec310571e66b1259fffb0,0,Nobuaki Sukegawa,2016-01-06 04:35:12+09:00,['fe3f33619ed268c1dcbea2523bed4b5f935d404b'],50,216,266,977767,20,0.658227848,0.911392405,1,2593
4733db4e151794a7a6e1cbbb5396e5d1146f1f8e,0,Nobuaki Sukegawa,2016-01-06 04:35:12+09:00,['796667b29f91682871cec310571e66b1259fffb0'],2,15,17,977784,2,0.25,0.25,0.5,2593
a3dc3f80433044fc2f8fbc874ae0825d92ade416,0,jfarrell,2016-01-05 21:10:01-05:00,['4733db4e151794a7a6e1cbbb5396e5d1146f1f8e'],0,8,8,977792,2,,,,2593
3ab9f2b5eeffbc0a9810a306144cb3d53eb52f64,1,Nobuaki Sukegawa,2016-01-06 11:54:53+09:00,['a3dc3f80433044fc2f8fbc874ae0825d92ade416'],3,19,22,977814,1,0,1,1,2593
c91bd74934c4e466b14718a47608f79812008525,0,Nobuaki Sukegawa,2016-01-06 20:07:55+09:00,['3ab9f2b5eeffbc0a9810a306144cb3d53eb52f64'],1,1,2,977816,1,,,,2593
bbaf92837fa836c65acc4a0f874ef05e8129dc18,0,Roger Meier,2016-01-07 20:35:02+01:00,['c91bd74934c4e466b14718a47608f79812008525'],18,30,48,977864,1,,,,2593
496454a4b03bab1bfadd3f44fa0e4c703e559f3f,1,Roger Meier,2016-01-07 20:40:07+01:00,['bbaf92837fa836c65acc4a0f874ef05e8129dc18'],7,1039,1046,978910,3,0.307053942,0.413554633,0.478561549,2594
8733bf4c19a72b5409785760a547ab0780a7d6f5,0,Jens Geyer,2016-01-09 00:14:04+01:00,['496454a4b03bab1bfadd3f44fa0e4c703e559f3f'],1,1,2,978912,1,,,,2594
4fcc74478ff62da677215eddcbaacacab76c7e41,0,Jens Geyer,2016-01-09 00:21:35+01:00,['8733bf4c19a72b5409785760a547ab0780a7d6f5'],7,17,24,978936,1,0,0,0,2594
f6521c64f4622960fe3aec634d1a07cb06d0cab1,0,Jens Geyer,2016-01-09 00:43:40+01:00,['4fcc74478ff62da677215eddcbaacacab76c7e41'],2,37,39,978975,1,0,0,1,2594
de0b4b55433fe47925a99cf17e6b99e584a3733c,1,Jens Geyer,2016-01-10 11:54:04+01:00,['f6521c64f4622960fe3aec634d1a07cb06d0cab1'],1,1138,1139,980114,9,0.31092437,0.617647059,0.968487395,2599
447294f17642a34ab10dba68521f4f7554e55350,1,Roger Meier,2016-01-10 13:32:47+01:00,['de0b4b55433fe47925a99cf17e6b99e584a3733c'],0,214,214,980328,3,,,,2601
861447a3e1b4891744940f2647a178bbd5123fe6,0,Jens Geyer,2016-01-10 13:49:58+01:00,['447294f17642a34ab10dba68521f4f7554e55350'],175,0,175,980503,3,,,,2601
681e6042da98aebc99d06b07e65c892d5fbe2503,1,Roger Meier,2016-01-10 16:25:57+01:00,['861447a3e1b4891744940f2647a178bbd5123fe6'],17,45,62,980565,7,,,,2601
11eac4484ebe3b34efdd3b835607ab0db7a3e1a1,0,Roger Meier,2016-01-10 16:30:31+01:00,['681e6042da98aebc99d06b07e65c892d5fbe2503'],0,1,1,980566,1,,,,2601
c410494453199720a9482cbde832e4e88082de44,0,Roger Meier,2016-01-10 16:34:44+01:00,['11eac4484ebe3b34efdd3b835607ab0db7a3e1a1'],1,1,2,980568,1,,,,2601
65d8564e908476f191404164c4db29a0a4434da5,0,Roger Meier,2016-01-10 20:25:38+01:00,['c410494453199720a9482cbde832e4e88082de44'],1,1,2,980570,1,,,,2601
051ed3c80da3e26f331e82e5605e81ecf1300f04,0,Roger Meier,2016-01-10 21:17:51+01:00,['65d8564e908476f191404164c4db29a0a4434da5'],4,4,8,980578,1,,,,2601
1b4ebc393d32f954b738e6904d3cc21a84bd1d93,0,Nobuaki Sukegawa,2016-01-11 11:34:20+09:00,['051ed3c80da3e26f331e82e5605e81ecf1300f04'],8,0,8,980586,1,,,,2601
299255afbb1f0ba302d3e29a76e20c0f5984f31e,1,Nobuaki Sukegawa,2016-01-11 11:34:20+09:00,['1b4ebc393d32f954b738e6904d3cc21a84bd1d93'],109,55,164,980750,2,1,0,0.407407407,2601
03565bf467de14a8a229d419164c2b16c34c538e,1,Nobuaki Sukegawa,2016-01-11 11:34:22+09:00,['299255afbb1f0ba302d3e29a76e20c0f5984f31e'],4,6,10,980760,1,1,1,1,2601
397bd51af7cfad17a93324f0c43f8d3424627b36,0,Nobuaki Sukegawa,2016-01-11 11:35:10+09:00,['03565bf467de14a8a229d419164c2b16c34c538e'],0,11,11,980771,1,1,0,0.444444444,2601
a3b88a012e6452b665073b7fb9e211e86093efbf,1,Nobuaki Sukegawa,2016-01-11 11:41:14+09:00,['397bd51af7cfad17a93324f0c43f8d3424627b36'],43,57,100,980871,8,0.4,0.4,0.5,2601
85650612e15c79c79e470553d3779d18f755150c,1,Nobuaki Sukegawa,2016-01-11 11:41:56+09:00,['a3b88a012e6452b665073b7fb9e211e86093efbf'],44,293,337,981208,9,0.120689655,1,0.956896552,2604
1a42a054772dd3d8fa112b796112d5d873c8bbe3,1,Nobuaki Sukegawa,2016-01-12 20:15:06+09:00,['85650612e15c79c79e470553d3779d18f755150c'],0,8,8,981216,1,,,,2604
7e286b0d143be88adbd84f2e1cbfec66196a6a57,0,Nobuaki Sukegawa,2016-01-13 20:25:19+09:00,['1a42a054772dd3d8fa112b796112d5d873c8bbe3'],184,198,382,981598,6,0,1,1,2604
7b545b57200ab960894e873716862cafbf9321f0,1,Nobuaki Sukegawa,2016-01-13 20:25:23+09:00,['7e286b0d143be88adbd84f2e1cbfec66196a6a57'],52,140,192,981790,10,0.833333333,0.91025641,0.628205128,2604
fc07084ada3d788f31beb22ffc6eac73415b843d,0,Nobuaki Sukegawa,2016-01-13 20:25:26+09:00,['7b545b57200ab960894e873716862cafbf9321f0'],14,19,33,981823,3,1,0,0.571428571,2604
0bd810af87f511a454922c5849725b143cf8e35f,1,Jens Geyer,2016-01-14 19:23:48+01:00,['fc07084ada3d788f31beb22ffc6eac73415b843d'],4,4,8,981831,1,,,,2604
0c0649de7eae1b53fc3456a1024425fc36d745dc,1,Jens Geyer,2016-01-14 20:26:14+01:00,['0bd810af87f511a454922c5849725b143cf8e35f'],71,1565,1636,983467,29,0.401709402,0.455840456,0.98005698,2626
ba01d6b2c11968e3de1bb2fb15cc1c3658e6374e,1,Jens Geyer,2016-01-14 22:39:28+01:00,['0c0649de7eae1b53fc3456a1024425fc36d745dc'],29,33,62,983529,1,1,1,1,2626
9335167280ac2c8fbdb94a25465b38aa455f9d0c,0,Jens Geyer,2016-01-14 22:39:30+01:00,['ba01d6b2c11968e3de1bb2fb15cc1c3658e6374e'],17,5,22,983551,1,1,0.5,0.5,2626
b815e3786f6c3a213e8c539d15ff5f76b4f59373,0,Jens Geyer,2016-01-14 23:45:28+01:00,['9335167280ac2c8fbdb94a25465b38aa455f9d0c'],1,2,3,983554,1,0,1,0,2626
420ee1e7f877ee6e1e28abefa4c6eb41fcf3a2fe,0,Roger Meier,2016-01-16 12:45:19+01:00,['b815e3786f6c3a213e8c539d15ff5f76b4f59373'],1,3,4,983558,2,0,0,0.5,2626
8b5e2e7c8efaa12c63d0e40fe0b5d304c7721ba2,0,Roger Meier,2016-01-17 09:09:44+01:00,['420ee1e7f877ee6e1e28abefa4c6eb41fcf3a2fe'],0,3,3,983561,2,0.5,1,1,2626
8b0fe287a684415678edab4caeeff291adad81a8,1,Roger Meier,2016-01-17 20:29:00+01:00,['8b5e2e7c8efaa12c63d0e40fe0b5d304c7721ba2'],6,6,12,983573,2,,,,2626
b69621437d590584958ca2a925dbf70d05288161,0,Roger Meier,2016-01-17 20:58:00+01:00,['8b0fe287a684415678edab4caeeff291adad81a8'],0,2,2,983575,1,,,,2626
baa110126d48b999dd4dff700e1f26559667487d,1,Roger Meier,2016-01-17 21:06:44+01:00,['b69621437d590584958ca2a925dbf70d05288161'],1,1,2,983577,1,,,,2626
ffc2bb3dd7afc3214bddc0bcd656ea79f3ead427,0,Nobuaki Sukegawa,2016-01-19 02:48:07+09:00,['baa110126d48b999dd4dff700e1f26559667487d'],13,15,28,983605,2,,,,2626
2ba79440bf945bb565e159af543030d4b1b24131,1,Nobuaki Sukegawa,2016-01-19 02:48:07+09:00,['ffc2bb3dd7afc3214bddc0bcd656ea79f3ead427'],6,47,53,983658,4,0.666666667,0.666666667,0.6,2626
235d49f45bfdaab32e575c99cf0225e91a10cfa8,0,Nobuaki Sukegawa,2016-01-19 02:48:07+09:00,['2ba79440bf945bb565e159af543030d4b1b24131'],2,1,3,983661,1,,,,2626
9be7569ab473962648a9baf184248896022ffc92,0,Nobuaki Sukegawa,2016-01-19 02:48:07+09:00,['235d49f45bfdaab32e575c99cf0225e91a10cfa8'],9,0,9,983670,1,0,0,0,2626
643f1eeee41c975c77739ea6ad70e326b9065612,1,Nobuaki Sukegawa,2016-01-19 02:48:07+09:00,['9be7569ab473962648a9baf184248896022ffc92'],2,2,4,983674,1,,,,2626
9c4193d4fc0ed66f989c2e5987f09abfe2340c73,0,Nobuaki Sukegawa,2016-01-19 02:48:07+09:00,['643f1eeee41c975c77739ea6ad70e326b9065612'],2,2,4,983678,2,,,,2626
3506b66cc04d3a9f6860b8cd7f4275468b91ac31,0,Nobuaki Sukegawa,2016-01-19 02:48:07+09:00,['9c4193d4fc0ed66f989c2e5987f09abfe2340c73'],34,57,91,983769,1,0,1,1,2626
e917a278d836ad9cceba8ea5054346b22b3bbbb7,0,Nobuaki Sukegawa,2016-01-19 02:48:07+09:00,['3506b66cc04d3a9f6860b8cd7f4275468b91ac31'],10,19,29,983798,2,1,1,0.833333333,2626
6dde90be2e15ae84e84671274e034643a33d738f,1,Jens Geyer,2016-01-19 22:00:27+01:00,['e917a278d836ad9cceba8ea5054346b22b3bbbb7'],14,3057,3071,986869,13,0.193743693,0.787083754,0.513622603,2631
3fe3df2ac8af11351643db8684cbafa216f03f99,1,Jens Geyer,2016-01-19 22:00:48+01:00,['6dde90be2e15ae84e84671274e034643a33d738f'],7,102,109,986978,4,0.079365079,1,0.984126984,2631
217a44b9dcd3ae199571fe584cb13ad8528d6814,1,Jens Geyer,2016-01-19 22:35:40+01:00,['3fe3df2ac8af11351643db8684cbafa216f03f99'],18,60,78,987056,1,0,1,0.764705882,2631
71398bb25f06ce3d7c89b9cac1bbed66fe35ec1f,1,Nobuaki Sukegawa,2016-01-21 00:08:52+09:00,['217a44b9dcd3ae199571fe584cb13ad8528d6814'],14,2,16,987072,3,,,,2631
aff06ed3fa466a8e39948169999aa8982e11ea0b,0,Jens Geyer,2016-01-22 22:26:52+01:00,['71398bb25f06ce3d7c89b9cac1bbed66fe35ec1f'],1,4,5,987077,1,0,0,1,2631
607697054d94af8e7a15e14dc90297228bd7d2f3,1,Nobuaki Sukegawa,2016-01-23 21:50:36+09:00,['aff06ed3fa466a8e39948169999aa8982e11ea0b'],12,10,22,987099,1,,,,2631
a837085ecea66e4dcbd96ef906fea3a5273b91ca,0,Nobuaki Sukegawa,2016-01-24 00:13:44+09:00,['607697054d94af8e7a15e14dc90297228bd7d2f3'],18,5,23,987122,3,,,,2631
3d600bfec3938bcee0008592e25cb1489bc782fa,0,Nobuaki Sukegawa,2016-01-24 00:13:44+09:00,['a837085ecea66e4dcbd96ef906fea3a5273b91ca'],1,1,2,987124,1,,,,2631
bd165305fa398afb47ac46b924414f6c9afb9b1f,0,Nobuaki Sukegawa,2016-01-24 00:13:44+09:00,['3d600bfec3938bcee0008592e25cb1489bc782fa'],80,169,249,987373,11,1,1,1,2634
9890c28b7e0f99e0ef1be4a44e8f111d5085336c,1,Nobuaki Sukegawa,2016-01-24 00:13:44+09:00,['bd165305fa398afb47ac46b924414f6c9afb9b1f'],49,18,67,987440,5,0,0,0,2634
ccd998a04e8b82a56b1788aa13167e84aa2126d1,0,Nobuaki Sukegawa,2016-01-24 01:26:33+09:00,['9890c28b7e0f99e0ef1be4a44e8f111d5085336c'],0,7,7,987447,4,,,,2634
5e432ec37b3c9db3a4534f6acdea12c74d42455e,1,Nobuaki Sukegawa,2016-01-24 03:44:26+09:00,['ccd998a04e8b82a56b1788aa13167e84aa2126d1'],77,117,194,987641,5,0.594594595,0.675675676,0.621621622,2634
41e4847786a68219263b7450573a4fce5c92672b,0,Jens Geyer,2016-01-24 12:25:00+01:00,['5e432ec37b3c9db3a4534f6acdea12c74d42455e'],4,4,8,987649,1,,,,2634
45c8e4935740292b8253041195ed5913d1c796b1,0,Roger Meier,2016-01-25 22:26:39+01:00,['41e4847786a68219263b7450573a4fce5c92672b'],0,9,9,987658,1,,,,2634
108fab82424b094f63f6eee2138f07e96ea117c5,1,Jens Geyer,2016-01-28 23:03:24+01:00,['45c8e4935740292b8253041195ed5913d1c796b1'],2,10,12,987670,2,,,,2634
f8ca05528e04a24b9f843c82c6600e4de5e42291,1,Jens Geyer,2016-01-28 23:05:02+01:00,['108fab82424b094f63f6eee2138f07e96ea117c5'],25,102,127,987797,6,0.025641026,0.179487179,0.769230769,2635
3bf3ebfec390e45c1c5d42a654085360a76504b9,0,Jens Geyer,2016-01-28 23:05:03+01:00,['f8ca05528e04a24b9f843c82c6600e4de5e42291'],37,91,128,987925,4,0.888888889,0.888888889,1,2636
c1fda249f8ec125658392f9642f7773c582cbe20,0,Jens Geyer,2016-01-28 23:05:05+01:00,['3bf3ebfec390e45c1c5d42a654085360a76504b9'],0,102,102,988027,1,0.185714286,1,1,2636
a9346a308f1e8736447693d1dd8ecba54516e942,0,Jens Geyer,2016-01-28 23:05:06+01:00,['c1fda249f8ec125658392f9642f7773c582cbe20'],1,1,2,988029,1,,,,2636
710704328838e6c4e22e9638d729141be2d7daf8,1,Jens Geyer,2016-01-29 10:10:47+01:00,['a9346a308f1e8736447693d1dd8ecba54516e942'],3,33,36,988065,2,,,,2636
356f7aa998eb54e25d749df366df353c58b3470e,0,Jens Geyer,2016-01-30 11:37:08+01:00,['710704328838e6c4e22e9638d729141be2d7daf8'],3,3,6,988071,1,,,,2636
194959917c1b44e485ab47845eaa99aedb255817,1,Roger Meier,2016-01-31 12:11:17+01:00,['356f7aa998eb54e25d749df366df353c58b3470e'],1,1,2,988073,1,,,,2636
2eed686406812411199f30e64131548000bbb62a,0,Nobuaki Sukegawa,2016-02-01 21:23:25+09:00,['194959917c1b44e485ab47845eaa99aedb255817'],2,31,33,988106,2,,,,2636
bcd8e3268e6296813a9658cf7da4785e519088f7,1,Nobuaki Sukegawa,2016-02-01 21:24:34+09:00,['2eed686406812411199f30e64131548000bbb62a'],6,6,12,988118,1,,,,2636
95c628eade2cff60da14c4e3f132e91ff16c5bc2,0,Nobuaki Sukegawa,2016-02-01 21:24:39+09:00,['bcd8e3268e6296813a9658cf7da4785e519088f7'],41,91,132,988250,5,0.941176471,0,1,2636
1ea3ca589f8020526aeeb394185ea651c0e3a9f3,0,Nobuaki Sukegawa,2016-02-03 01:07:42+09:00,['95c628eade2cff60da14c4e3f132e91ff16c5bc2'],2,2,4,988254,1,,,,2636
f07b4a14dfc30a397d49b18c3f50230a08310bd1,1,Nobuaki Sukegawa,2016-02-03 01:07:43+09:00,['1ea3ca589f8020526aeeb394185ea651c0e3a9f3'],1,2,3,988257,1,,,,2636
d094e79de7e0bd61320f006c83c0de669363bce8,1,Nobuaki Sukegawa,2016-02-03 01:07:43+09:00,['f07b4a14dfc30a397d49b18c3f50230a08310bd1'],14,124,138,988395,8,0.5,1,1,2637
10308cb975ac090584068d0470b81e41555b2f35,1,Nobuaki Sukegawa,2016-02-04 14:28:24+09:00,['d094e79de7e0bd61320f006c83c0de669363bce8'],6193,6244,12437,1000832,60,1,0.5,1,2637
f7d497978d21233b087e3edc6eaa6a38b88ee461,1,Nobuaki Sukegawa,2016-02-04 14:28:24+09:00,['10308cb975ac090584068d0470b81e41555b2f35'],5,1,6,1000838,1,1,0,0,2637
5b44612d20e762e0774a19b7ef42a28f7fc0b481,0,Nobuaki Sukegawa,2016-02-04 14:28:24+09:00,['f7d497978d21233b087e3edc6eaa6a38b88ee461'],11,2,13,1000851,1,,,,2637
25536ad83a85cfda6d5388278e4e378f2d4df73e,1,Nobuaki Sukegawa,2016-02-04 22:20:00+09:00,['5b44612d20e762e0774a19b7ef42a28f7fc0b481'],62,124,186,1001037,9,0.40625,0.40625,0,2638
f39f7dbd26fe090f0fc6566c100ca7adc9ace714,1,Nobuaki Sukegawa,2016-02-04 22:20:00+09:00,['25536ad83a85cfda6d5388278e4e378f2d4df73e'],6,118,124,1001161,5,0,0.933333333,0.933333333,2640
3b89cc5305735306316f68df635e7f4c0e62d904,0,Nobuaki Sukegawa,2016-02-04 22:20:00+09:00,['f39f7dbd26fe090f0fc6566c100ca7adc9ace714'],17,5,22,1001183,3,,,,2640
cfebe7e2c6dfb42a8872bb831eaf3a2278d4fc73,0,Nobuaki Sukegawa,2016-02-04 22:20:00+09:00,['3b89cc5305735306316f68df635e7f4c0e62d904'],1,3,4,1001187,1,,,,2640
c1a78ba6d5ff0c015768a5b0969112895b4e7723,1,Nobuaki Sukegawa,2016-02-04 22:20:00+09:00,['cfebe7e2c6dfb42a8872bb831eaf3a2278d4fc73'],0,603,603,1001790,2,0.75443038,0.979746835,1,2641
1f647f01c4494222ff82008f555cc77c2868d434,0,Nobuaki Sukegawa,2016-02-04 22:20:00+09:00,['c1a78ba6d5ff0c015768a5b0969112895b4e7723'],2,2,4,1001794,2,0,1,1,2641
ebd71cedc3f7c641c76abc2ec13119465c5b02a6,0,Nobuaki Sukegawa,2016-02-04 22:20:01+09:00,['1f647f01c4494222ff82008f555cc77c2868d434'],37,37,74,1001868,4,0,1,1,2641
4708409c2d635f7754f197d06285b52e56ee8f22,1,Nobuaki Sukegawa,2016-02-05 20:48:07+09:00,['ebd71cedc3f7c641c76abc2ec13119465c5b02a6'],186,228,414,1002282,3,0.092307692,0.076923077,0.8,2641
d10eb082d02ecfc5206bce62961cd45e6c48656b,0,Roger Meier,2016-02-07 11:06:05+01:00,['4708409c2d635f7754f197d06285b52e56ee8f22'],1,1,2,1002284,1,,,,2641
144bbef3ddd3a66ff038e5ad271500aa06b63aae,1,Nobuaki Sukegawa,2016-02-11 20:06:46+09:00,['d10eb082d02ecfc5206bce62961cd45e6c48656b'],12,25,37,1002321,4,0.8,0.8,1,2641
355116eb1d7e903e6aba7b239db49951919e48c5,1,Nobuaki Sukegawa,2016-02-11 20:07:02+09:00,['144bbef3ddd3a66ff038e5ad271500aa06b63aae'],0,3,3,1002324,1,0,1,0,2641
ce1c8abfa4bab71e519cc6d811cb6e901be00600,1,Nobuaki Sukegawa,2016-02-11 20:07:11+09:00,['355116eb1d7e903e6aba7b239db49951919e48c5'],9,9,18,1002342,1,,,,2641
e71f20cd3ee9e812a064e492a7e692e2f2f98d35,1,Simon South,2016-02-11 06:56:31-05:00,['ce1c8abfa4bab71e519cc6d811cb6e901be00600'],0,538,538,1002880,8,0.329749104,1,0.734767025,2644
9ed45e9a416374775d8a4d1ae3b28b3680e525a5,0,Nobuaki Sukegawa,2016-02-13 02:26:54+09:00,['e71f20cd3ee9e812a064e492a7e692e2f2f98d35'],3,3,6,1002886,1,,,,2644
ac06704a0c62df9ca03782cb05b0f8cc05387a45,1,Nobuaki Sukegawa,2016-02-13 02:32:12+09:00,['9ed45e9a416374775d8a4d1ae3b28b3680e525a5'],108,132,240,1003126,1,1,1,1,2644
41e8cbf6866bf9b8ec6d5bbc157a1fb970d8c3cc,0,Nobuaki Sukegawa,2016-02-13 23:12:34+09:00,['ac06704a0c62df9ca03782cb05b0f8cc05387a45'],0,2,2,1003128,1,,,,2644
6525f6ae8786a2bcb596e471efb1d76ae74aabee,1,Nobuaki Sukegawa,2016-02-13 23:12:34+09:00,['41e8cbf6866bf9b8ec6d5bbc157a1fb970d8c3cc'],1474,2480,3954,1007082,28,1,1,1,2654
7af189a2366383538bb9aae394fd5f735976f1d5,1,Nobuaki Sukegawa,2016-02-13 23:12:34+09:00,['6525f6ae8786a2bcb596e471efb1d76ae74aabee'],79,258,337,1007419,18,0,0,0,2655
6a0ca7ff2750d45346d6d7faaf931de2b6254321,0,Nobuaki Sukegawa,2016-02-13 23:12:34+09:00,['7af189a2366383538bb9aae394fd5f735976f1d5'],37,44,81,1007500,2,1,0.9,0.9,2655
9f0d9619d20632e7f29d7a2edf802e79739fe110,0,Nobuaki Sukegawa,2016-02-13 23:12:34+09:00,['6a0ca7ff2750d45346d6d7faaf931de2b6254321'],4,5,9,1007509,1,0,1,1,2655
8d289472c01d042383232bec8b4415b7e36ec15b,0,Nobuaki Sukegawa,2016-02-13 23:12:34+09:00,['9f0d9619d20632e7f29d7a2edf802e79739fe110'],1,0,1,1007510,1,,,,2655
833236fc52294b4f4a9cf6a75118da3ae71ac006,1,Randy Abernethy,2016-02-13 17:30:20-08:00,['8d289472c01d042383232bec8b4415b7e36ec15b'],8,15,23,1007533,1,,,,2655
4733c4c53520259a002b9b173a7f5407499311c7,1,Jens Geyer,2016-02-14 11:10:42+01:00,['833236fc52294b4f4a9cf6a75118da3ae71ac006'],328,481,809,1008342,31,0,0,0,2655
d4722d9c48318d1077b16b557f685d0b1aab16d4,0,Jens Geyer,2016-02-14 13:50:07+01:00,['4733c4c53520259a002b9b173a7f5407499311c7'],2,2,4,1008346,1,,,,2655
b867b27c5d50800930e0f1f03db59c1f04ce748a,0,Nobuaki Sukegawa,2016-02-14 22:47:18+09:00,['d4722d9c48318d1077b16b557f685d0b1aab16d4'],14,18,32,1008378,1,0,1,1,2655
cab56006633f9a21da2c390998984660d0dde593,0,Nobuaki Sukegawa,2016-02-14 22:47:18+09:00,['b867b27c5d50800930e0f1f03db59c1f04ce748a'],6,6,12,1008390,1,1,1,1,2655
9bd3530b977dd422c3deff73c4577b55f9c3d23c,0,Nobuaki Sukegawa,2016-02-14 22:47:19+09:00,['cab56006633f9a21da2c390998984660d0dde593'],11,14,25,1008415,1,0,1,1,2655
919752ca2fa7e64f8854729aebbd91d4cbd50a57,0,Nobuaki Sukegawa,2016-02-14 22:47:19+09:00,['9bd3530b977dd422c3deff73c4577b55f9c3d23c'],3,2,5,1008420,1,,,,2655
949e242ec8099e616e464ee7dce8d14e516b2519,0,Nobuaki Sukegawa,2016-02-14 22:47:19+09:00,['919752ca2fa7e64f8854729aebbd91d4cbd50a57'],9,53,62,1008482,2,0.195121951,0.195121951,1,2655
8b411a0c8f9f6dc4fa7f6660b5b15fe27a76741d,0,Nobuaki Sukegawa,2016-02-14 22:47:19+09:00,['949e242ec8099e616e464ee7dce8d14e516b2519'],9,11,20,1008502,1,0,0,0,2655
66f50531405ac558d78725eaf01c95eb55621540,1,Nobuaki Sukegawa,2016-02-14 22:47:19+09:00,['8b411a0c8f9f6dc4fa7f6660b5b15fe27a76741d'],6,15,21,1008523,1,0,0,0,2655
ea5845a2f53de0f7891b5fc293897407d59824a1,1,Nobuaki Sukegawa,2016-02-14 22:47:19+09:00,['66f50531405ac558d78725eaf01c95eb55621540'],0,1,1,1008524,1,,,,2655
9c50e4aba9eb569c92999b8688e80ce3f5ca837e,1,Randy Abernethy,2016-02-14 17:44:07-08:00,['ea5845a2f53de0f7891b5fc293897407d59824a1'],9,7,16,1008540,1,,,,2655
01a8983e24c4bbf6cd9534d8b9b9219d04023f05,1,Jens Geyer,2016-02-16 01:09:50+01:00,['9c50e4aba9eb569c92999b8688e80ce3f5ca837e'],4,4,8,1008548,1,,,,2655
c295c822917cb594655f61337cc32fe188e9a86f,0,Randy Abernethy,2016-02-16 08:22:49-08:00,['01a8983e24c4bbf6cd9534d8b9b9219d04023f05'],2,4,6,1008554,1,,,,2655
1c8b5cb1528d91be98c3652baade99e406417e5f,1,Nobuaki Sukegawa,2016-02-17 23:21:51+09:00,['c295c822917cb594655f61337cc32fe188e9a86f'],48,41,89,1008643,2,1,1,0,2655
dc29eec5c6229d66054779f520da325e9ae913ff,0,Nobuaki Sukegawa,2016-02-17 23:21:51+09:00,['1c8b5cb1528d91be98c3652baade99e406417e5f'],34,0,34,1008677,2,0,0,0,2655
0433d171f6722c47944caee6b81e8ed8c57be60a,0,Nobuaki Sukegawa,2016-02-17 23:55:28+09:00,['dc29eec5c6229d66054779f520da325e9ae913ff'],10,11,21,1008698,2,1,1,1,2655
e1e09c7967aa7149ae291de9da744142e67a3806,0,Nobuaki Sukegawa,2016-02-19 01:06:05+09:00,['0433d171f6722c47944caee6b81e8ed8c57be60a'],19,19,38,1008736,4,0,1,1,2655
474ddbd06dbf45a56dc5c85a75f7587a67ec33cc,0,Nobuaki Sukegawa,2016-02-19 01:06:05+09:00,['e1e09c7967aa7149ae291de9da744142e67a3806'],13,41,54,1008790,4,0.25,1,0,2655
19a3a2771a8abbdf7da72466be292740d091820b,0,Nobuaki Sukegawa,2016-02-19 01:06:05+09:00,['474ddbd06dbf45a56dc5c85a75f7587a67ec33cc'],1,731,732,1009522,3,0.689655172,0.863883848,1,2656
b16a0a94fc9498102b5d12632d4501d368ee69ff,0,Nobuaki Sukegawa,2016-02-20 00:15:52+09:00,['19a3a2771a8abbdf7da72466be292740d091820b'],3,7,10,1009532,1,,,,2656
59310f5dd065681db9dc2ab13fda289d8fa41922,1,Nobuaki Sukegawa,2016-02-20 00:18:43+09:00,['b16a0a94fc9498102b5d12632d4501d368ee69ff'],31,56,87,1009619,3,0.181818182,0.181818182,0.151515152,2656
08d67d7163688a28e7bcae78339e1fe9710437a8,0,Nobuaki Sukegawa,2016-02-20 00:44:24+09:00,['59310f5dd065681db9dc2ab13fda289d8fa41922'],4,6,10,1009629,1,0,1,1,2656
23ffb312900bbbadf49dfee270391803e194a436,0,Nobuaki Sukegawa,2016-02-20 00:44:54+09:00,['08d67d7163688a28e7bcae78339e1fe9710437a8'],7,40,47,1009676,1,0.642857143,1,1,2656
7efa4fb9b10c9c42dcef1143918e308d9dfd6c58,0,Nobuaki Sukegawa,2016-02-20 00:45:35+09:00,['23ffb312900bbbadf49dfee270391803e194a436'],6,4,10,1009686,3,0,0,0,2656
37a122271f6036d1f2151cdb02201a0114c31df7,1,Nobuaki Sukegawa,2016-02-20 00:45:35+09:00,['7efa4fb9b10c9c42dcef1143918e308d9dfd6c58'],2,2,4,1009690,1,,,,2656
b72bb94a8212edc83864edc435896fdcda6e796c,0,Jens Geyer,2016-02-21 15:37:11+01:00,['37a122271f6036d1f2151cdb02201a0114c31df7'],6,10,16,1009706,1,0,0,1,2656
a2e74465d49f79cd50529b1a9abe5e7f1315e60c,0,Jens Geyer,2016-02-21 15:37:25+01:00,['b72bb94a8212edc83864edc435896fdcda6e796c'],0,9,9,1009715,1,0,0,1,2656
517aa157911684b583122163236f304ea9c1e799,0,Jens Geyer,2016-02-21 15:37:25+01:00,['a2e74465d49f79cd50529b1a9abe5e7f1315e60c'],0,9,9,1009724,1,0,0,1,2656
ea2bd9cb08bc1f1c6049335c99e33754a65ae318,0,Jens Geyer,2016-02-21 15:37:26+01:00,['517aa157911684b583122163236f304ea9c1e799'],0,8,8,1009732,1,0,0,1,2656
2303d978c0f93104ec358d9adecfe524dbcfa994,0,Nobuaki Sukegawa,2016-02-22 02:47:06+09:00,['ea2bd9cb08bc1f1c6049335c99e33754a65ae318'],3,3,6,1009738,1,,,,2656
33de26cf658450513ef5731ac55b635addb4d43d,0,Nobuaki Sukegawa,2016-02-22 02:48:00+09:00,['2303d978c0f93104ec358d9adecfe524dbcfa994'],10,6,16,1009754,2,,,,2656
a72ffbea4d05586d39b507e5cd6451086fc4f763,0,Nobuaki Sukegawa,2016-02-22 23:24:31+09:00,['33de26cf658450513ef5731ac55b635addb4d43d'],4,8,12,1009766,1,0,0,1,2656
f32bae7a89a47047fbed9a47b78d6b69d70a3764,1,Nobuaki Sukegawa,2016-02-22 23:25:32+09:00,['a72ffbea4d05586d39b507e5cd6451086fc4f763'],42,83,125,1009891,2,0,0,0,2657
55c4fc9115476b374504f3be389afde851e029ab,0,Nobuaki Sukegawa,2016-02-22 23:25:56+09:00,['f32bae7a89a47047fbed9a47b78d6b69d70a3764'],0,30,30,1009921,1,,,,2658
008283de6c93e300891cbeff0d1b3b683ad7c9ed,0,Nobuaki Sukegawa,2016-02-22 23:26:11+09:00,['55c4fc9115476b374504f3be389afde851e029ab'],11,12,23,1009944,2,,,,2658
a4e0c92fd466f5570957579da81195d97cb8e7de,1,Nobuaki Sukegawa,2016-02-22 23:26:27+09:00,['008283de6c93e300891cbeff0d1b3b683ad7c9ed'],1,1,2,1009946,1,,,,2658
dd2223c506c151eeabc10724995404f7f612bc4f,0,Nobuaki Sukegawa,2016-02-22 23:26:43+09:00,['a4e0c92fd466f5570957579da81195d97cb8e7de'],10,7,17,1009963,1,,,,2658
3e5b9c275e9f88cefc05c0e0d6da6e86c46ba88d,0,Nobuaki Sukegawa,2016-02-22 23:27:01+09:00,['dd2223c506c151eeabc10724995404f7f612bc4f'],1,1,2,1009965,1,,,,2658
3b4a93bba114cc7d460cd9be7f679783f9be000f,0,Nobuaki Sukegawa,2016-02-22 23:27:12+09:00,['3e5b9c275e9f88cefc05c0e0d6da6e86c46ba88d'],506,0,506,1010471,7,0.94,0.826666667,0.173333333,2658
a61e50540ef8cb9346ddd1d26aeebf857066fe6e,0,Jens Geyer,2016-02-23 16:33:38+01:00,['3b4a93bba114cc7d460cd9be7f679783f9be000f'],1,1,2,1010473,1,,,,2658
6bbc9e3a60014a3f5e0c26c842f7d345935bfe0d,0,Nobuaki Sukegawa,2016-02-27 16:55:55+09:00,['a61e50540ef8cb9346ddd1d26aeebf857066fe6e'],0,1,1,1010474,1,,,,2658
aa7d0d5f2a9e8b201e8d0f5a37f420b9846e4625,1,Nobuaki Sukegawa,2016-02-27 16:55:55+09:00,['6bbc9e3a60014a3f5e0c26c842f7d345935bfe0d'],22,42,64,1010538,4,,,,2658
3b4c5fadfda3dfeef7ee3901b5bb64563a0f1a0c,0,Nobuaki Sukegawa,2016-02-27 16:55:55+09:00,['aa7d0d5f2a9e8b201e8d0f5a37f420b9846e4625'],29,26,55,1010593,12,,,,2658
ce283d56647ed3ec7f0c574be86be2959dc5c04c,0,Nobuaki Sukegawa,2016-02-27 16:55:55+09:00,['3b4c5fadfda3dfeef7ee3901b5bb64563a0f1a0c'],2,7,9,1010602,1,1,1,1,2658
fa53a3ce94eeed38367d238b3f7818105f3d7ce9,0,Nobuaki Sukegawa,2016-02-27 16:55:55+09:00,['ce283d56647ed3ec7f0c574be86be2959dc5c04c'],1,2,3,1010605,1,,,,2658
f2952847e65c998b6f543f1cc63a4e173e10b66a,1,Nobuaki Sukegawa,2016-02-27 16:55:55+09:00,['fa53a3ce94eeed38367d238b3f7818105f3d7ce9'],10,7,17,1010622,2,,,,2658
e9b3234b28372f38cdf706b1c7f6940c41b1d828,0,Nobuaki Sukegawa,2016-02-27 16:55:55+09:00,['f2952847e65c998b6f543f1cc63a4e173e10b66a'],15,26,41,1010663,2,0,0,0,2658
402f6419f94b905d7a924334868c48a8b22948c6,0,Nobuaki Sukegawa,2016-02-27 17:17:27+09:00,['e9b3234b28372f38cdf706b1c7f6940c41b1d828'],11,28,39,1010702,4,,,,2658
937228e030569bf25ceb379c9491426709792701,1,Roger Meier,2016-02-27 10:31:46+01:00,['402f6419f94b905d7a924334868c48a8b22948c6'],0,2,2,1010704,1,0,0,1,2658
2655f4b5365c0a471531c45aed7a99da358b787e,0,Nobuaki Sukegawa,2016-02-28 11:35:32+09:00,['937228e030569bf25ceb379c9491426709792701'],1,1,2,1010706,1,,,,2658
103974ec550e7d1c5c75e35f1309095487b5b4e1,0,Nobuaki Sukegawa,2016-02-28 12:03:40+09:00,['2655f4b5365c0a471531c45aed7a99da358b787e'],22,23,45,1010751,1,0,0,0,2658
2c5ed27a25087f541312d35938056890c4784fc6,0,Nobuaki Sukegawa,2016-02-28 12:04:05+09:00,['103974ec550e7d1c5c75e35f1309095487b5b4e1'],5,5,10,1010761,4,,,,2658
d479e23a1d408ab73e416f547003c4f7d9975081,0,Nobuaki Sukegawa,2016-02-28 12:05:14+09:00,['2c5ed27a25087f541312d35938056890c4784fc6'],42,74,116,1010877,26,0.5,0,0,2664
b52d03d7a0c1ff2c1fe31c3999127d2daf98bc93,0,Mark Erickson,2016-02-29 13:24:16-06:00,['d479e23a1d408ab73e416f547003c4f7d9975081'],12,18,30,1010907,1,0.833333333,1,1,2664
b5f126f6d6908796944569cc4c5a5ae2c6614231,1,Mark Erickson,2016-02-29 15:27:59-06:00,['b52d03d7a0c1ff2c1fe31c3999127d2daf98bc93'],4,494,498,1011405,6,,,,2665
56c1c645f299c6570ad4c8469dbeb87fa22d8f11,1,Mark Erickson,2016-03-01 16:53:35-06:00,['b5f126f6d6908796944569cc4c5a5ae2c6614231'],6,12,18,1011423,3,,,,2665
50bb860acd3ea200be5261335c5ccb1300bacfae,0,Nobuaki Sukegawa,2016-03-02 23:44:22+09:00,['56c1c645f299c6570ad4c8469dbeb87fa22d8f11'],1,1,2,1011425,1,,,,2665
3dd4d8eca8c1d20819fb58fa863b83bd348cf411,0,Nobuaki Sukegawa,2016-03-02 23:44:22+09:00,['50bb860acd3ea200be5261335c5ccb1300bacfae'],2,2,4,1011429,1,,,,2665
f7a8d946a0b22d0acce1325d2607c38597b36a58,1,Nobuaki Sukegawa,2016-03-02 23:44:23+09:00,['3dd4d8eca8c1d20819fb58fa863b83bd348cf411'],25,32,57,1011486,4,1,0.428571429,0,2665
06e8fd4a08b0ec9eae505ab8618fe96b6a1faaf4,0,Nobuaki Sukegawa,2016-03-02 23:44:23+09:00,['f7a8d946a0b22d0acce1325d2607c38597b36a58'],14,19,33,1011519,1,0.923076923,0.923076923,0.923076923,2665
327d1345b6ef7a12c729891f2fef750bdfa8a82b,0,Nobuaki Sukegawa,2016-03-02 23:44:23+09:00,['06e8fd4a08b0ec9eae505ab8618fe96b6a1faaf4'],1,2,3,1011522,1,,,,2665
1425c5af9a75d14d92bbf72ffca08844447484e5,1,Nobuaki Sukegawa,2016-03-02 23:44:23+09:00,['327d1345b6ef7a12c729891f2fef750bdfa8a82b'],10,17,27,1011549,1,,,,2665
4d28b60873ff8c7c7f64da08c3500b860002c0fb,0,Nobuaki Sukegawa,2016-03-02 23:44:23+09:00,['1425c5af9a75d14d92bbf72ffca08844447484e5'],5,54,59,1011608,3,,,,2665
eee04d9cfcbbf43cf0743042308642e3b52bbbe2,0,Nobuaki Sukegawa,2016-03-02 23:44:23+09:00,['4d28b60873ff8c7c7f64da08c3500b860002c0fb'],10,24,34,1011642,2,,,,2665
6ec6860801bdc87236e636add071c4faa2ac7e4b,1,Nobuaki Sukegawa,2016-03-02 23:57:02+09:00,['eee04d9cfcbbf43cf0743042308642e3b52bbbe2'],2,3,5,1011647,1,,,,2665
2cc4764d0e4851b9024c53353235abe586a9835a,0,Nobuaki Sukegawa,2016-03-05 22:53:28+09:00,['6ec6860801bdc87236e636add071c4faa2ac7e4b'],1,5,6,1011653,1,,,,2665
1ccd81bfbc7dc09dc7a8a5e64f313935b799c833,1,Nobuaki Sukegawa,2016-03-05 22:53:28+09:00,['2cc4764d0e4851b9024c53353235abe586a9835a'],37,438,475,1012128,7,0.034375,1,0.909375,2665
d9b4425f68b8a239e6085f2700bfc2f95cdb2f46,1,Nobuaki Sukegawa,2016-03-05 22:53:48+09:00,['1ccd81bfbc7dc09dc7a8a5e64f313935b799c833'],4,7,11,1012139,3,,,,2665
5bac5ba8bff4bf3ed1b25ccb1d084efa0648c4c3,0,Nobuaki Sukegawa,2016-03-06 09:45:34+09:00,['d9b4425f68b8a239e6085f2700bfc2f95cdb2f46'],1,1,2,1012141,1,,,,2665
8b791b270efb1bf3576244d91a2836bf3c33cd32,1,Nobuaki Sukegawa,2016-03-06 09:45:42+09:00,['5bac5ba8bff4bf3ed1b25ccb1d084efa0648c4c3'],7,194,201,1012342,11,,,,2665
5fb1fda25a44f405c991cf8e024697bd0b06eb4f,1,Nobuaki Sukegawa,2016-03-06 09:45:48+09:00,['8b791b270efb1bf3576244d91a2836bf3c33cd32'],4,10,14,1012356,1,1,1,1,2665
ed23b2b4ce796602ac073ec07582b9a19f5f02e4,1,Nobuaki Sukegawa,2016-03-06 09:46:22+09:00,['5fb1fda25a44f405c991cf8e024697bd0b06eb4f'],10,13,23,1012379,5,,,,2665
c40018b28f40d5dfd41f9e3de1198d70ec0b6eca,1,Nobuaki Sukegawa,2016-03-06 09:46:33+09:00,['ed23b2b4ce796602ac073ec07582b9a19f5f02e4'],2,17,19,1012398,3,,,,2665
35b4465ab75c28c5adce8b2ba96137cfc5f99f72,0,Jens Geyer,2016-03-06 14:59:35+01:00,['c40018b28f40d5dfd41f9e3de1198d70ec0b6eca'],2,0,2,1012400,1,,,,2665
af9d2ac69e6638066db75654ba289bc7d98777a5,0,Roger Meier,2016-03-06 22:44:13+01:00,['35b4465ab75c28c5adce8b2ba96137cfc5f99f72'],1,1,2,1012402,1,,,,2665
775671aea41ea55427dd78d7ce68e282cc9b8487,0,Jens Geyer,2016-03-07 00:19:21+01:00,['af9d2ac69e6638066db75654ba289bc7d98777a5'],27,106,133,1012535,4,,,,2665
aef81d632f7605835e83d3610695fb5c3a281be8,1,Mark Erickson,2016-03-07 11:01:34-06:00,['775671aea41ea55427dd78d7ce68e282cc9b8487'],1,25,26,1012561,1,0,1,1,2665
8c8ae96eb8083c8cc93698094db1421369b414e1,0,Mark Erickson,2016-03-08 13:25:30-06:00,['aef81d632f7605835e83d3610695fb5c3a281be8'],38,35,73,1012634,1,1,1,0,2665
65b17466d5d7d6c7b762626e809918de904032e0,0,Jens Geyer,2016-03-09 00:09:54+01:00,['8c8ae96eb8083c8cc93698094db1421369b414e1'],1,1,2,1012636,1,,,,2665
356c9986586a1c677cc911aca22be37c73aaf792,0,Nobuaki Sukegawa,2016-03-09 10:36:12+09:00,['65b17466d5d7d6c7b762626e809918de904032e0'],0,1,1,1012637,1,,,,2665
6bb12771452b8c2fc656b0561486a51c31d1449d,1,Nobuaki Sukegawa,2016-03-09 10:36:43+09:00,['356c9986586a1c677cc911aca22be37c73aaf792'],58,79,137,1012774,4,,,,2665
f2b7a4805f321e53cdf64c7d2c0c9635dee74144,0,Nobuaki Sukegawa,2016-03-09 17:23:48+09:00,['6bb12771452b8c2fc656b0561486a51c31d1449d'],1,1,2,1012776,1,,,,2665
3fe8b0fe855ec9b7adfa3ac90e6c5dae53d79738,0,Nobuaki Sukegawa,2016-03-09 19:55:48+09:00,['f2b7a4805f321e53cdf64c7d2c0c9635dee74144'],1,1,2,1012778,1,,,,2665
c8744083264b8a33c633d3fb6141cf064972a606,0,Nobuaki Sukegawa,2016-03-09 19:55:56+09:00,['3fe8b0fe855ec9b7adfa3ac90e6c5dae53d79738'],13,8,21,1012799,2,0,0,1,2665
33331a32790726d78b50fa09d2b2f7238fc46f01,1,Nobuaki Sukegawa,2016-03-10 11:34:49+09:00,['c8744083264b8a33c633d3fb6141cf064972a606'],31,46,77,1012876,2,,,,2665
4938bab1846f87c60719def89551f0f0abb12bb4,1,Nobuaki Sukegawa,2016-03-10 11:35:55+09:00,['33331a32790726d78b50fa09d2b2f7238fc46f01'],0,1,1,1012877,1,,,,2665
6f6aa8a4060e3e8a0c1250fc571da97da3e4f330,1,Jens Geyer,2016-03-10 20:10:16+01:00,['4938bab1846f87c60719def89551f0f0abb12bb4'],87,78,165,1013042,2,,,,2665
30ed90e0650e30734c9d728c2935d461671a0dc9,0,Jens Geyer,2016-03-10 20:12:49+01:00,['6f6aa8a4060e3e8a0c1250fc571da97da3e4f330'],3,3,6,1013048,1,,,,2665
f5399b2f55575b23b74076ecf3402f378e1952eb,1,Roger Meier,2016-03-11 00:06:03+01:00,['30ed90e0650e30734c9d728c2935d461671a0dc9'],0,19,19,1013067,1,1,1,1,2665
5025a302c6dd877ff045f3db729805f76c785675,1,Jens Geyer,2016-03-11 23:23:50+01:00,['f5399b2f55575b23b74076ecf3402f378e1952eb'],12,32,44,1013111,2,0,0.705882353,0.882352941,2665
f9867ed19e2c6d71be45c4753164d3a1aa1989ec,0,Nobuaki Sukegawa,2016-03-13 08:35:57+09:00,['5025a302c6dd877ff045f3db729805f76c785675'],1,1,2,1013113,1,,,,2665
26e1b9471945386113db1ce180533b5775f2b9cc,1,Nobuaki Sukegawa,2016-03-13 09:00:30+09:00,['f9867ed19e2c6d71be45c4753164d3a1aa1989ec'],8,4,12,1013125,2,,,,2665
74f583cf60d7cc7e3cba8b11edc73869a18e4353,0,Nobuaki Sukegawa,2016-03-13 09:00:30+09:00,['26e1b9471945386113db1ce180533b5775f2b9cc'],2,2,4,1013129,1,,,,2665
e364081f821ecde15c22c7a28d7f76818b816614,0,Nobuaki Sukegawa,2016-03-13 18:19:01+09:00,['74f583cf60d7cc7e3cba8b11edc73869a18e4353'],15,0,15,1013144,1,,,,2665
1fa273be5089070532908f159a0ccc38d7f7150c,1,Nobuaki Sukegawa,2016-03-13 19:15:18+09:00,['e364081f821ecde15c22c7a28d7f76818b816614'],27,209,236,1013380,3,0.217105263,1,0.881578947,2665
ccce919abc500c204445b1858bb39b43a4449ee0,0,Jens Geyer,2016-03-15 00:33:05+02:00,['1fa273be5089070532908f159a0ccc38d7f7150c'],0,8,8,1013388,1,,,,2665
aadcf34cbf643b5eff1c771047a05a4c77be9d9e,0,Jens Geyer,2016-03-15 00:34:08+02:00,['ccce919abc500c204445b1858bb39b43a4449ee0'],1,2,3,1013391,1,,,,2665
1d20a370d25b7154104289bb337ab4375edf19b9,1,Jens Geyer,2016-03-16 09:59:47+02:00,['aadcf34cbf643b5eff1c771047a05a4c77be9d9e'],150,262,412,1013803,17,,,,2665
8e1fd869853e5b5d1aa97f69ac6b567b0e9c7ccd,0,Nobuaki Sukegawa,2016-03-17 01:26:16+09:00,['1d20a370d25b7154104289bb337ab4375edf19b9'],1,1,2,1013805,1,,,,2665
7f6ea4e7fe6fc15955438e00335398424cf0fca4,0,Nobuaki Sukegawa,2016-03-17 01:26:24+09:00,['8e1fd869853e5b5d1aa97f69ac6b567b0e9c7ccd'],1,2,3,1013808,1,,,,2665
55499b8802d13c41224b1b6922efa76eaa5da133,1,Jens Geyer,2016-03-17 09:50:59+02:00,['7f6ea4e7fe6fc15955438e00335398424cf0fca4'],13,15,28,1013836,1,0,0,1,2665
6505312e0ad23795f84161db190b5a426fff6b42,0,Nobuaki Sukegawa,2016-03-18 04:40:16+09:00,['55499b8802d13c41224b1b6922efa76eaa5da133'],1,1,2,1013838,1,,,,2665
b819260c653f6fd9602419ee2541060ecb930c4c,0,Nobuaki Sukegawa,2016-03-18 04:40:35+09:00,['6505312e0ad23795f84161db190b5a426fff6b42'],0,10,10,1013848,2,0,0,1,2665
e432c6b828d70ee4901f1ec3e04b0145da2ce54e,1,Nobuaki Sukegawa,2016-03-18 04:40:46+09:00,['b819260c653f6fd9602419ee2541060ecb930c4c'],7,196,203,1014051,5,0.484848485,0.803030303,1,2666
a4f96403210566bd1e76fee9b6e40412ff014e0a,0,Nobuaki Sukegawa,2016-03-18 15:25:59+09:00,['e432c6b828d70ee4901f1ec3e04b0145da2ce54e'],25,29,54,1014105,2,,,,2666
bd964c7f3460c308161cb6eb90583874a7d8d848,0,Nobuaki Sukegawa,2016-03-18 22:33:38+09:00,['a4f96403210566bd1e76fee9b6e40412ff014e0a'],191,275,466,1014571,7,1,0.972222222,0.944444444,2666
c3072227c06c570135741b625db612aaccff67b3,0,Nobuaki Sukegawa,2016-03-18 22:34:38+09:00,['bd964c7f3460c308161cb6eb90583874a7d8d848'],0,1,1,1014572,1,1,1,1,2666
a8765276d80fa86d258fa323cfd30bfcf22a0d67,1,Nobuaki Sukegawa,2016-03-18 22:35:39+09:00,['c3072227c06c570135741b625db612aaccff67b3'],59,96,155,1014727,10,0.152173913,0.565217391,1,2666
b3a42dd050db2657a589b7b73e3d121211649fe5,1,Nobuaki Sukegawa,2016-03-18 22:37:02+09:00,['a8765276d80fa86d258fa323cfd30bfcf22a0d67'],6,8,14,1014741,1,0,1,0,2666
1d4a4393c9a9396ec76c3ba674e0d6a65fe39cc1,0,Nobuaki Sukegawa,2016-03-18 22:37:02+09:00,['b3a42dd050db2657a589b7b73e3d121211649fe5'],0,19,19,1014760,2,0.923076923,1,1,2666
e134cbc6ff797c061332ecfae697e807832e1682,0,Nobuaki Sukegawa,2016-03-18 22:37:02+09:00,['1d4a4393c9a9396ec76c3ba674e0d6a65fe39cc1'],4,24,28,1014788,6,,,,2666
400ae6e76e07ec929125c1d78b11541eeb254de2,1,Nobuaki Sukegawa,2016-03-18 23:53:41+09:00,['e134cbc6ff797c061332ecfae697e807832e1682'],25,55,80,1014868,3,0.103448276,0,1,2666
0d12de3b27115dfd8246102320e97d77bc596945,0,Nobuaki Sukegawa,2016-03-19 00:49:35+09:00,['400ae6e76e07ec929125c1d78b11541eeb254de2'],0,75,75,1014943,1,0.040540541,0,0.945945946,2666
e831490db9ca3c0539ffadb55cbb20967c7c4fbd,0,Nobuaki Sukegawa,2016-03-19 01:25:10+09:00,['0d12de3b27115dfd8246102320e97d77bc596945'],4,2,6,1014949,1,1,1,0,2666
834f1b45c78df42e132889c72c4feafe9b8e2e07,0,Nobuaki Sukegawa,2016-03-19 22:31:40+09:00,['e831490db9ca3c0539ffadb55cbb20967c7c4fbd'],0,2,2,1014951,1,,,,2666
048ea0c8308ac3a2be3ee6e917684d422b9d4221,0,Nobuaki Sukegawa,2016-03-19 23:53:05+09:00,['834f1b45c78df42e132889c72c4feafe9b8e2e07'],0,1,1,1014952,1,,,,2666
73d16378c5654710192f216f8467676c154d8185,1,Nobuaki Sukegawa,2016-03-19 23:53:05+09:00,['048ea0c8308ac3a2be3ee6e917684d422b9d4221'],2,12,14,1014966,7,,,,2666
1d9fd75712896b69f3e4e877c5d76e2d710ad292,0,Nobuaki Sukegawa,2016-03-20 00:28:33+09:00,['73d16378c5654710192f216f8467676c154d8185'],2,2,4,1014970,1,,,,2666
1043d71c2efb0ffdc2ec526c4177b97a8a0ff4c6,1,Jens Geyer,2016-03-25 00:41:29+02:00,['1d9fd75712896b69f3e4e877c5d76e2d710ad292'],19,22,41,1015011,1,0,0,0,2666
06340a4664cd05cb78064a4216736c8aa4f782a8,0,Jens Geyer,2016-03-25 02:28:24+02:00,['1043d71c2efb0ffdc2ec526c4177b97a8a0ff4c6'],0,8,8,1015019,1,,,,2666
93bbdc8127cb6ebdd34350fbba1b3a0a4e8e4111,1,Nobuaki Sukegawa,2016-03-29 12:03:34+09:00,['06340a4664cd05cb78064a4216736c8aa4f782a8'],17,25,42,1015061,3,,,,2666
f43d0ca6e57c4c30ea742e5f80e086288e999ecb,1,Nobuaki Sukegawa,2016-03-29 12:03:34+09:00,['93bbdc8127cb6ebdd34350fbba1b3a0a4e8e4111'],11,62,73,1015134,4,,,,2666
eb344a81913234183bd5f4ab63a872ca165d308d,0,Nobuaki Sukegawa,2016-03-29 12:03:34+09:00,['f43d0ca6e57c4c30ea742e5f80e086288e999ecb'],38,38,76,1015210,4,,,,2666
abbc8d0ec19850f7ce1125a7f8b1fc9878aac052,0,Nobuaki Sukegawa,2016-03-29 12:03:34+09:00,['eb344a81913234183bd5f4ab63a872ca165d308d'],1,1,2,1015212,1,,,,2666
d42d8be78fff22fab9f524d4766b61bb9053fd69,0,Nobuaki Sukegawa,2016-03-29 12:03:34+09:00,['abbc8d0ec19850f7ce1125a7f8b1fc9878aac052'],2,2,4,1015216,2,,,,2666
f98d59fc822dd6d05c6cd48c5b86d716469a48fc,1,Nobuaki Sukegawa,2016-03-29 12:03:34+09:00,['d42d8be78fff22fab9f524d4766b61bb9053fd69'],9,7,16,1015232,6,0,0,0,2666
4ab9a88496413087df1ee3256472b19c5b4be500,0,Nobuaki Sukegawa,2016-03-29 12:03:34+09:00,['f98d59fc822dd6d05c6cd48c5b86d716469a48fc'],1,14,15,1015247,1,,,,2666
6657b8337d1aedfd2aed22a8cdcf4b96965ece26,0,Nobuaki Sukegawa,2016-03-29 12:03:34+09:00,['4ab9a88496413087df1ee3256472b19c5b4be500'],4,9,13,1015260,1,,,,2666
3bf5bf99334c2da212e5e3d14145a1783657877c,0,Nobuaki Sukegawa,2016-03-29 12:03:34+09:00,['6657b8337d1aedfd2aed22a8cdcf4b96965ece26'],1,3,4,1015264,1,,,,2666
fe9222a6ec20d23d9cfd3ec9c793887f7212b313,0,Jens Geyer,2016-03-30 22:43:56+02:00,['3bf5bf99334c2da212e5e3d14145a1783657877c'],2,38,40,1015304,1,,,,2666
cdc83335d60756c4bfb0d2c8af7933500c9e3c06,0,Jens Geyer,2016-04-01 20:53:37+02:00,['fe9222a6ec20d23d9cfd3ec9c793887f7212b313'],1,17,18,1015322,1,1,1,1,2666
9b39e1686bdc61263894b26cfa7a86967e2afa30,1,Jens Geyer,2016-04-06 00:58:59+02:00,['cdc83335d60756c4bfb0d2c8af7933500c9e3c06'],269,273,542,1015864,1,0,0,1,2666
717334816de896acc5dac3f787d64b52e033b38f,1,Jens Geyer,2016-04-06 00:59:00+02:00,['9b39e1686bdc61263894b26cfa7a86967e2afa30'],12,16,28,1015892,1,0,0,0,2666
51850abb7ed0a7304f60cbced853285c9b63f4cb,0,Jens Geyer,2016-04-06 22:38:55+02:00,['717334816de896acc5dac3f787d64b52e033b38f'],26,20,46,1015938,2,0,0,0,2666
ca714c4397ed78bd880f0dd76526e3817ecc08f0,1,Jens Geyer,2016-04-06 22:53:25+02:00,['51850abb7ed0a7304f60cbced853285c9b63f4cb'],37,36,73,1016011,12,0.035714286,0.035714286,0,2666
8b0b7e5eb419eaa47294fa0a70ab96b3a9a07d0b,0,Mark Erickson,2016-04-07 21:12:25-05:00,['ca714c4397ed78bd880f0dd76526e3817ecc08f0'],4,9,13,1016024,1,,,,2666
3aa461b97b3230d357543808f1facf9898818f71,0,Nobuaki Sukegawa,2016-04-10 18:18:10+09:00,['8b0b7e5eb419eaa47294fa0a70ab96b3a9a07d0b'],20,26,46,1016070,2,1,1,1,2666
0ea6c1d5d77f046f089f200c67cffb629f3fe11e,0,Randy Abernethy,2016-04-11 14:31:19-07:00,['3aa461b97b3230d357543808f1facf9898818f71'],18,2,20,1016090,1,0,0,0,2666
3ca89e60d231f1f466232599b7138536f401845b,0,Randy Abernethy,2016-04-13 06:24:57-07:00,['0ea6c1d5d77f046f089f200c67cffb629f3fe11e'],0,6,6,1016096,1,0.8,0.8,1,2666
4f5229e4a7cb49eb376021be586019d8dc325299,1,Jens Geyer,2016-04-14 23:20:16+02:00,['3ca89e60d231f1f466232599b7138536f401845b'],16,95,111,1016207,6,,,,2666
9f7f11e73ba2622397b3586468628032b1d26688,1,Jens Geyer,2016-04-14 23:20:52+02:00,['4f5229e4a7cb49eb376021be586019d8dc325299'],263,267,530,1016737,12,,,,2667
4b7abedb0463fb55a15b389fb9f12b77cf5194f8,0,Jens Geyer,2016-04-16 23:54:04+02:00,['9f7f11e73ba2622397b3586468628032b1d26688'],4,5,9,1016746,1,0,0,0,2667
5988f4800694d81e547d47596f737c0db551ef50,0,Jens Geyer,2016-04-19 23:36:26+02:00,['4b7abedb0463fb55a15b389fb9f12b77cf5194f8'],12,12,24,1016770,1,,,,2667
b89b5b9d03f322043f70c552b1a56b5fdb57ef84,1,Jens Geyer,2016-04-19 23:36:27+02:00,['5988f4800694d81e547d47596f737c0db551ef50'],4,23,27,1016797,1,,,,2667
dd074e714a07df9e48dc1d7d2c7528dc5e945b4c,0,Jens Geyer,2016-04-19 23:36:28+02:00,['b89b5b9d03f322043f70c552b1a56b5fdb57ef84'],7,13,20,1016817,1,,,,2667
bea9bbe7c6c72630ba7f9461ea70cb4a2e454548,1,Jens Geyer,2016-04-20 00:43:48+02:00,['dd074e714a07df9e48dc1d7d2c7528dc5e945b4c'],58,1850,1908,1018725,12,,,,2668
653f0de4813ed3cbff508a735ad77b03f4fb1c84,0,Jens Geyer,2016-04-20 12:47:58+02:00,['bea9bbe7c6c72630ba7f9461ea70cb4a2e454548'],16,22,38,1018763,1,,,,2668
8077883a71bb3a2d3fbc05e665d5020708b5cafc,0,Jens Geyer,2016-04-21 22:37:37+02:00,['653f0de4813ed3cbff508a735ad77b03f4fb1c84'],3,3,6,1018769,1,,,,2668
ae985dda55418c6524da5dd7e6a466fc8d1656a8,1,Jens Geyer,2016-04-21 22:54:14+02:00,['8077883a71bb3a2d3fbc05e665d5020708b5cafc'],1,1,2,1018771,1,,,,2668
e0e3240d6409a3a3f49225db114a3c6914fc682f,1,Jens Geyer,2016-04-21 22:58:53+02:00,['ae985dda55418c6524da5dd7e6a466fc8d1656a8'],164,294,458,1019229,11,1,1,0,2668
80542987f96febd5182072b6ce32ffcc1d43eab7,1,Jens Geyer,2016-04-22 21:32:35+02:00,['e0e3240d6409a3a3f49225db114a3c6914fc682f'],1,1,2,1019231,1,,,,2668
f457780facf8e4effe92af7c0192fbc6321d0a66,0,Jens Geyer,2016-04-22 22:01:53+02:00,['80542987f96febd5182072b6ce32ffcc1d43eab7'],2,2,4,1019235,1,,,,2668
e363a34e63e851f17061a912a77e75a8ed8474bc,0,Jens Geyer,2016-04-23 09:24:20+02:00,['f457780facf8e4effe92af7c0192fbc6321d0a66'],41,41,82,1019317,2,,,,2668
f5972c9682744014c9d825c3ccd9200e44449c6e,0,Jens Geyer,2016-04-29 23:29:23+02:00,['e363a34e63e851f17061a912a77e75a8ed8474bc'],0,10,10,1019327,1,0,0,1,2668
7c3eac3ee28facfea3593b4a78488d73eb6a7f4d,0,Jens Geyer,2016-04-29 23:29:24+02:00,['f5972c9682744014c9d825c3ccd9200e44449c6e'],0,1,1,1019328,1,,,,2668
eed661313f4da242d1b3c6e4166b993fd6efba6b,0,Jens Geyer,2016-04-29 23:29:26+02:00,['7c3eac3ee28facfea3593b4a78488d73eb6a7f4d'],1,1,2,1019330,1,,,,2668
b749c2603ef1935bc1fbba4f9c2935b12b1328e0,0,Jens Geyer,2016-04-29 23:29:27+02:00,['eed661313f4da242d1b3c6e4166b993fd6efba6b'],11,66,77,1019407,1,0.170731707,0.87804878,0.853658537,2668
ad3714ac3d7b9220d16f3a68503c261b8d22c8ee,0,Jens Geyer,2016-04-29 23:29:28+02:00,['b749c2603ef1935bc1fbba4f9c2935b12b1328e0'],1,1,2,1019409,1,,,,2668
ea0da97d44d1f9e367303c66cc55e825ed419260,0,Jens Geyer,2016-04-29 23:29:29+02:00,['ad3714ac3d7b9220d16f3a68503c261b8d22c8ee'],16,14,30,1019439,2,1,1,0,2668
6ee1a0bd263b0dc3b863285763342fb3ddc3ede4,0,Jens Geyer,2016-05-04 22:57:53+02:00,['ea0da97d44d1f9e367303c66cc55e825ed419260'],0,6,6,1019445,1,0,0,0,2668
7fadf57208c6c45b784027a38c1d36f78d0ee331,0,Nobuaki Sukegawa,2016-05-05 15:38:42+09:00,['6ee1a0bd263b0dc3b863285763342fb3ddc3ede4'],2,2,4,1019449,1,,,,2668
9b954e6a469fef18682314458e6fc4af2dd84add,0,Randy Abernethy,2016-05-05 19:01:04-07:00,['7fadf57208c6c45b784027a38c1d36f78d0ee331'],0,4,4,1019453,1,1,1,1,2668
d7f87aa5f2ceca288b9159b2d3e70497c330aa38,0,Randy Abernethy,2016-05-12 22:02:58-07:00,['9b954e6a469fef18682314458e6fc4af2dd84add'],8,5,13,1019466,1,0.5,0.5,0,2668
8cc9175ae871657dfd3f2f0ea186ded0c0dbcbd9,1,Nobuaki Sukegawa,2016-05-15 00:24:41+09:00,['d7f87aa5f2ceca288b9159b2d3e70497c330aa38'],36,41,77,1019543,2,0,1,0,2668
7be78ea0b351d86ce4063279cf33976ba70f4b85,1,Nobuaki Sukegawa,2016-05-15 00:25:04+09:00,['8cc9175ae871657dfd3f2f0ea186ded0c0dbcbd9'],168,163,331,1019874,5,,,,2668
9549b25c77587b29be4e0b5c258221a4ed85d37a,1,Nobuaki Sukegawa,2016-05-15 00:25:17+09:00,['7be78ea0b351d86ce4063279cf33976ba70f4b85'],6,8,14,1019888,1,,,,2668
8e2320339fe1c6cc2b5ea75c6a5940bda1e92fc9,0,Jens Geyer,2016-05-20 20:06:53+02:00,['9549b25c77587b29be4e0b5c258221a4ed85d37a'],7,19,26,1019914,1,0.571428571,0.857142857,0.857142857,2668
839b9320a813c53fe1143a5b518d4e1f522d49d2,0,Mark Erickson,2016-05-25 10:19:52-05:00,['8e2320339fe1c6cc2b5ea75c6a5940bda1e92fc9'],2,3,5,1019919,2,,,,2668
1fa95f53bbac168fe4e25ca6b02ebebd2d0affca,0,Mark Erickson,2016-05-25 21:23:51-05:00,['839b9320a813c53fe1143a5b518d4e1f522d49d2'],5,7,12,1019931,1,0,0.5,0.5,2668
5f06802c73647e1050df532bddfb49f1ccb3bc1b,1,Jens Geyer,2016-05-28 13:31:33+02:00,['1fa95f53bbac168fe4e25ca6b02ebebd2d0affca'],7,30,37,1019968,1,0,0,1,2668
26b36dc61e511f0086a25f4e3f2491cdc286444a,0,Jens Geyer,2016-05-28 23:22:51+02:00,['5f06802c73647e1050df532bddfb49f1ccb3bc1b'],13,18,31,1019999,2,,,,2668
39a09ac5e49481d39dd1bcb6757ffe182e3df20a,0,Jens Geyer,2016-05-29 00:43:13+02:00,['26b36dc61e511f0086a25f4e3f2491cdc286444a'],30,422,452,1020451,15,,,,2673
cee82ae3c771b12985aa74c673ab1daee15a46d6,0,Jens Geyer,2016-06-06 23:10:01+02:00,['39a09ac5e49481d39dd1bcb6757ffe182e3df20a'],19,7,26,1020477,1,0.428571429,0.142857143,0.142857143,2673
c8deed8cba62dce0ce816afef38f708ce49d0a61,0,Jens Geyer,2016-06-06 23:10:10+02:00,['cee82ae3c771b12985aa74c673ab1daee15a46d6'],153,165,318,1020795,4,0.571428571,0.857142857,0.857142857,2673
7407e2e2f3547037655d5d231cbc283e2e4a8923,0,Jens Geyer,2016-06-07 21:42:09+02:00,['c8deed8cba62dce0ce816afef38f708ce49d0a61'],165,153,318,1021113,4,0.428571429,0.142857143,0.142857143,2673
e1abc8b2f3aed139f43ee0f9d1eca95b7da4f312,1,Mark Erickson,2016-06-07 16:24:23-05:00,['7407e2e2f3547037655d5d231cbc283e2e4a8923'],33,591,624,1021737,15,,,,2677
4b7dbe3cf224351b84bb0b707cb661d8aa95e45c,1,Nobuaki Sukegawa,2016-06-09 04:04:18+09:00,['e1abc8b2f3aed139f43ee0f9d1eca95b7da4f312'],61,46,107,1021844,7,,,,2678
a52ea350d885d4e35d210d1ace621e476bfbbae1,0,Nobuaki Sukegawa,2016-06-12 16:12:30+09:00,['4b7dbe3cf224351b84bb0b707cb661d8aa95e45c'],4,4,8,1021852,1,,,,2678
61b170845f256b1977c6d8a8a5906ba998560a53,1,Jens Geyer,2016-06-14 21:56:00+02:00,['a52ea350d885d4e35d210d1ace621e476bfbbae1'],16,15,31,1021883,1,,,,2678
7ea4a87fc5c03c072a8d52cc499f1b83cfaa927b,0,Jens Geyer,2016-06-14 21:57:24+02:00,['61b170845f256b1977c6d8a8a5906ba998560a53'],153,163,316,1022199,4,0.714285714,1,1,2678
0b433de5d5c7454f5410ac7b3d1ac86a07d1beef,0,Jens Geyer,2016-06-16 22:00:56+02:00,['7ea4a87fc5c03c072a8d52cc499f1b83cfaa927b'],67,57,124,1022323,4,0,0,0,2678
0af1aa1bd6fb8779deef4f67130fd4dda70ffb9b,0,Jens Geyer,2016-06-16 22:09:33+02:00,['0b433de5d5c7454f5410ac7b3d1ac86a07d1beef'],1,3,4,1022327,1,,,,2678
0e9fed1e12ed066865e46c6903782b2ef95f4650,0,Jens Geyer,2016-06-16 22:15:12+02:00,['0af1aa1bd6fb8779deef4f67130fd4dda70ffb9b'],0,3,3,1022330,1,0,1,0,2678
e5fbedd29f9c4f4889530c26dae37f07a04b2189,1,Jens Geyer,2016-07-08 22:00:37+02:00,['0e9fed1e12ed066865e46c6903782b2ef95f4650'],57,67,124,1022454,4,1,1,1,2678
5a3f855b4e6882184f13c698855c877241144a12,1,Jens Geyer,2016-07-08 22:08:22+02:00,['e5fbedd29f9c4f4889530c26dae37f07a04b2189'],63,275,338,1022792,6,0.714285714,1,0.69047619,2678
4082ef80687cba6982d41ddadd00dee52e43d1bf,1,Jens Geyer,2016-07-15 23:04:38+02:00,['5a3f855b4e6882184f13c698855c877241144a12'],0,6,6,1022798,3,,,,2678
f3840767608b47b04476cde6ce30d9d70164ca3b,1,Jens Geyer,2016-07-15 23:33:23+02:00,['4082ef80687cba6982d41ddadd00dee52e43d1bf'],3,4,7,1022805,1,0,1,1,2678
4300b72b2dce36f1cccb71bcabe8f6c42e888ab3,0,Jens Geyer,2016-07-17 17:44:20+02:00,['f3840767608b47b04476cde6ce30d9d70164ca3b'],2,6,8,1022813,1,1,1,1,2678
b6983df867208bb31e0de95bdfe124b0c51826ae,0,Jens Geyer,2016-07-17 18:00:24+02:00,['4300b72b2dce36f1cccb71bcabe8f6c42e888ab3'],1,3,4,1022817,1,,,,2678
d150f8b41ef3a3f63fadcc595a99bc38628cd636,0,Nobuaki Sukegawa,2016-07-18 23:21:00+09:00,['b6983df867208bb31e0de95bdfe124b0c51826ae'],2,2,4,1022821,1,,,,2678
1654fe99aff4dc69c52ba361124ead1734cd9be8,0,Nobuaki Sukegawa,2016-07-18 23:21:14+09:00,['d150f8b41ef3a3f63fadcc595a99bc38628cd636'],5,6,11,1022832,1,,,,2678
5871d2c9fb06930f16ce4ddca313fc475dab2ed4,0,Nobuaki Sukegawa,2016-07-23 15:12:38+09:00,['1654fe99aff4dc69c52ba361124ead1734cd9be8'],12,11,23,1022855,3,0.666666667,0,0.666666667,2678
8ab38b6b955ceba6106c615287c04abecdfb3c77,1,Nobuaki Sukegawa,2016-07-23 15:12:42+09:00,['5871d2c9fb06930f16ce4ddca313fc475dab2ed4'],2,24,26,1022881,2,,,,2679
c09cb6fc5cf60868563563b5a28930f42e581b8a,1,Nobuaki Sukegawa,2016-07-23 16:52:53+09:00,['8ab38b6b955ceba6106c615287c04abecdfb3c77'],6,6,12,1022893,1,,,,2679
e1b8540a0af2cd66d3edf5c80b0198009143ba12,0,Nobuaki Sukegawa,2016-07-23 16:52:53+09:00,['c09cb6fc5cf60868563563b5a28930f42e581b8a'],8,5,13,1022906,2,,,,2679
47f9b9d7c8b449878cada56f20316bbfb7e12301,1,Jens Geyer,2016-07-23 15:15:18+02:00,['e1b8540a0af2cd66d3edf5c80b0198009143ba12'],2,6,8,1022914,1,1,1,1,2679
e5176241c325837967a07d6d20e0e9a789fbd107,1,Jens Geyer,2016-07-24 19:10:01+02:00,['47f9b9d7c8b449878cada56f20316bbfb7e12301'],7,10,17,1022931,1,0,0,1,2679
bcad91771b7f0bff28a1cac1981d7ef2b9bcef3c,1,Jens Geyer,2016-07-24 19:10:55+02:00,['e5176241c325837967a07d6d20e0e9a789fbd107'],4,5,9,1022940,1,,,,2679
2007783e874d524a46b818598a45078448ecc53e,0,Jens Geyer,2016-08-10 09:33:48+02:00,['bcad91771b7f0bff28a1cac1981d7ef2b9bcef3c'],1,10,11,1022951,1,0,0,0,2679
fd02a30e5874c9b3d4e79f0d32289e74351b3e67,0,Nobuaki Sukegawa,2016-08-20 18:34:57+09:00,['2007783e874d524a46b818598a45078448ecc53e'],1,1,2,1022953,1,,,,2679
77e5f3a3a37e8819f3a5154d4724ecd102fab587,1,Nobuaki Sukegawa,2016-08-20 18:37:53+09:00,['fd02a30e5874c9b3d4e79f0d32289e74351b3e67'],2,2,4,1022957,1,,,,2679
527637ac3c75df0a87253ddbf41edc3a27ddd802,0,Nobuaki Sukegawa,2016-08-20 18:40:41+09:00,['77e5f3a3a37e8819f3a5154d4724ecd102fab587'],49,30,79,1023036,1,1,1,1,2679
e4ba16495e8d8177eb85d6bfcc69089b38753e39,1,Nobuaki Sukegawa,2016-08-20 18:40:45+09:00,['527637ac3c75df0a87253ddbf41edc3a27ddd802'],34,28,62,1023098,1,1,1,0,2679
aa4312ef5ff8ae4965cc779fe73d2375aba0c2dc,0,Mark Erickson,2016-08-31 15:30:35-05:00,['e4ba16495e8d8177eb85d6bfcc69089b38753e39'],1,45,46,1023144,1,0,0,1,2679
7b0cb9a63aff78c03e6ff2cd1d266b408a22df7f,0,Nobuaki Sukegawa,2016-09-03 15:57:47+09:00,['aa4312ef5ff8ae4965cc779fe73d2375aba0c2dc'],251,374,625,1023769,1,0.224489796,0.071428571,0.030612245,2679
d1ceba449d3c6bb431386abc11495f21f9824238,0,Nobuaki Sukegawa,2016-09-03 15:58:37+09:00,['7b0cb9a63aff78c03e6ff2cd1d266b408a22df7f'],2,31,33,1023802,3,,,,2680
c2256fc751f61bb364e9e5f0fe3b5747adf4970c,0,Nobuaki Sukegawa,2016-09-03 17:20:06+09:00,['d1ceba449d3c6bb431386abc11495f21f9824238'],4,4,8,1023810,2,,,,2680
88c5ee71db1cc25c37a1c66e5dde0d5ce6f55096,1,Nobuaki Sukegawa,2016-09-04 18:49:18+09:00,['c2256fc751f61bb364e9e5f0fe3b5747adf4970c'],212,239,451,1024261,18,1,0,0,2683
080041c3855fdcdd372240e6a4c4deb5e2da16a9,0,Nobuaki Sukegawa,2016-09-04 18:49:19+09:00,['88c5ee71db1cc25c37a1c66e5dde0d5ce6f55096'],16,4,20,1024281,2,,,,2683
21b6d9295a7f10852810a93679fdaf4c28fe72dd,0,Nobuaki Sukegawa,2016-09-04 18:49:20+09:00,['080041c3855fdcdd372240e6a4c4deb5e2da16a9'],12,13,25,1024306,1,,,,2683
bf9fa905d22d2714670b5d492a319daf26f5a32c,1,Nobuaki Sukegawa,2016-09-04 18:49:21+09:00,['21b6d9295a7f10852810a93679fdaf4c28fe72dd'],52,54,106,1024412,15,0,1,1,2683
d4eecda6b2f8b3b27a191605a054aa3bf79a4684,0,Nobuaki Sukegawa,2016-09-04 18:49:22+09:00,['bf9fa905d22d2714670b5d492a319daf26f5a32c'],6,6,12,1024424,1,,,,2683
d2b4f248368be36ff24c5a54fa4f8cfb86b7ab36,1,Nobuaki Sukegawa,2016-09-04 18:49:23+09:00,['d4eecda6b2f8b3b27a191605a054aa3bf79a4684'],20,39,59,1024483,2,0,0,1,2683
93fb7eadd093e561e3c7122dc9eb084ca033047d,1,Nobuaki Sukegawa,2016-09-04 21:13:32+09:00,['d2b4f248368be36ff24c5a54fa4f8cfb86b7ab36'],36,59,95,1024578,10,,,,2684
2c64bddc0085de94b01d00bc0e98615562f631d7,0,Nobuaki Sukegawa,2016-09-04 21:13:40+09:00,['93fb7eadd093e561e3c7122dc9eb084ca033047d'],10,23,33,1024611,3,,,,2684
ddc53c32486cc23dfa63ed4e5abb19923b8d13e6,0,Nobuaki Sukegawa,2016-09-04 22:54:04+09:00,['2c64bddc0085de94b01d00bc0e98615562f631d7'],0,1,1,1024612,1,,,,2684
205dc19556eac3c0ab2d1965c4636b78f8922fae,0,jfarrell,2016-09-15 23:38:58-04:00,['ddc53c32486cc23dfa63ed4e5abb19923b8d13e6'],2,2,4,1024616,2,,,,2684
54f49f863567fa6fdae41d210df87ce6cec4014b,0,Jens Geyer,2016-09-19 22:37:19+02:00,['205dc19556eac3c0ab2d1965c4636b78f8922fae'],0,3,3,1024619,1,0,0,1,2684
311c98455a9cb9070e9dad86a28f9c3ecbdf0a01,0,jfarrell,2016-09-20 13:30:16-04:00,['54f49f863567fa6fdae41d210df87ce6cec4014b'],11,237,248,1024867,4,0.657534247,0.657534247,0.794520548,2686
04e6f62c8fc68a1e846544c45943aad76934ce56,0,jfarrell,2016-09-20 15:27:54-04:00,['311c98455a9cb9070e9dad86a28f9c3ecbdf0a01'],4,164,168,1025035,4,0.679245283,1,0.849056604,2689
3f5fa5fa43e5d83f6b3ab7d441ffaa7e578340c6,1,Jens Geyer,2016-09-21 22:21:34+02:00,['04e6f62c8fc68a1e846544c45943aad76934ce56'],0,720,720,1025755,3,,,,2692
5767901e791f80924ceee71b3981d8a330dcb875,0,Jens Geyer,2016-09-21 22:21:36+02:00,['3f5fa5fa43e5d83f6b3ab7d441ffaa7e578340c6'],0,8,8,1025763,4,,,,2692
be3acfda2ffc39d355b6197d567cd8d6ad93f0c6,0,Nobuaki Sukegawa,2016-09-26 01:25:38+09:00,['5767901e791f80924ceee71b3981d8a330dcb875'],1,1,2,1025765,1,,,,2692
1e3cf9b9fdcf9a7b7ffc18a2e6148465b154e66b,1,Nobuaki Sukegawa,2016-09-26 01:41:53+09:00,['be3acfda2ffc39d355b6197d567cd8d6ad93f0c6'],1,1,2,1025767,1,,,,2692
11da87e6f30c237869a09e28ab44fe4a59db270e,1,Nobuaki Sukegawa,2016-09-26 01:42:01+09:00,['1e3cf9b9fdcf9a7b7ffc18a2e6148465b154e66b'],169,2701,2870,1028637,63,0.616650532,0.884801549,0.930300097,2709
052abc39c60c54f9901993e76a81036b482ed6ba,1,Nobuaki Sukegawa,2016-09-26 01:42:02+09:00,['11da87e6f30c237869a09e28ab44fe4a59db270e'],859,960,1819,1030456,83,,,,2709
a400c690eb4dc79b0dd89d7f159931487c856dae,0,Nobuaki Sukegawa,2016-09-26 01:42:02+09:00,['052abc39c60c54f9901993e76a81036b482ed6ba'],5,77,82,1030538,3,0,1,1,2709
eacbd65f1d5aaae6cd2a4cdac89ffbba049f3558,0,Nobuaki Sukegawa,2016-09-26 01:42:02+09:00,['a400c690eb4dc79b0dd89d7f159931487c856dae'],0,16,16,1030554,2,1,1,1,2709
dd9885e3225180cc12cdfb7bfddc4b3cdbd405fe,1,Nobuaki Sukegawa,2016-09-26 01:42:02+09:00,['eacbd65f1d5aaae6cd2a4cdac89ffbba049f3558'],7,25,32,1030586,4,0.266666667,0.333333333,0,2709
22ec64f88ab29e0b8b1249c32bcf0568bc02cebd,1,Nobuaki Sukegawa,2016-09-26 01:42:02+09:00,['dd9885e3225180cc12cdfb7bfddc4b3cdbd405fe'],1,2,3,1030589,1,,,,2709
346e23149573dc00da5eb7f415057b0266230010,0,Nobuaki Sukegawa,2016-09-26 01:42:03+09:00,['22ec64f88ab29e0b8b1249c32bcf0568bc02cebd'],2,5,7,1030596,1,1,1,1,2709
900569c442742a1cb727111574dff26a7401d8c3,0,Nobuaki Sukegawa,2016-09-26 02:40:51+09:00,['346e23149573dc00da5eb7f415057b0266230010'],1,2,3,1030599,1,0,1,0,2709
1ac0a80aa07421a4b7a857d801038b7991833f7f,1,Jens Geyer,2016-09-26 21:20:01+02:00,['900569c442742a1cb727111574dff26a7401d8c3'],2,41,43,1030642,1,0.352941176,0.352941176,0.529411765,2709
2df9c20dc76c044e502861a2111b90cbdcbbb957,1,Jens Geyer,2016-09-26 22:05:19+02:00,['1ac0a80aa07421a4b7a857d801038b7991833f7f'],4,6,10,1030652,1,1,1,1,2709
042ce7e7c894ac99489d2cd1a3d139e8d630bbdb,0,Nobuaki Sukegawa,2016-09-29 02:44:46+09:00,['2df9c20dc76c044e502861a2111b90cbdcbbb957'],1,1,2,1030654,1,,,,2709
8ccf5a645c8e34e0abb6f31b216dbf77f0ac2a43,1,Nobuaki Sukegawa,2016-09-29 02:44:59+09:00,['042ce7e7c894ac99489d2cd1a3d139e8d630bbdb'],4,44,48,1030702,2,0,0,1,2710
e349c345d3c3380657f7d0d388cda676f2014c3d,1,Jens Geyer,2016-09-29 20:46:26+02:00,['8ccf5a645c8e34e0abb6f31b216dbf77f0ac2a43'],1,17,18,1030720,1,0,0,0,2710
4d39ac5240ec5f25faebfefa26e30389a1cf417f,1,Nobuaki Sukegawa,2016-10-01 23:39:46+09:00,['e349c345d3c3380657f7d0d388cda676f2014c3d'],7,37,44,1030764,4,,,,2710
4bbfe6120e71b81df7f23dcc246990c29eb27859,0,Nobuaki Sukegawa,2016-10-01 23:40:03+09:00,['4d39ac5240ec5f25faebfefa26e30389a1cf417f'],0,5,5,1030769,1,0,1,1,2710
3129549feb1647a42c5e29f4ac171583937139fa,0,Nobuaki Sukegawa,2016-10-01 23:40:56+09:00,['4bbfe6120e71b81df7f23dcc246990c29eb27859'],2,2,4,1030773,1,,,,2710
d8c6a84866f7afb3ef9bb8f1d74fe1984b873d98,1,Nobuaki Sukegawa,2016-10-03 00:57:41+09:00,['3129549feb1647a42c5e29f4ac171583937139fa'],145,123,268,1031041,8,,,,2710
b413703eef78a3557ca6a1df073ad1eaecb4a936,0,Nobuaki Sukegawa,2016-10-03 00:57:41+09:00,['d8c6a84866f7afb3ef9bb8f1d74fe1984b873d98'],3,26,29,1031070,1,0,0,1,2710
b0dadbde6aad1f5a09d47e3d1f2c713c76cd915f,0,Nobuaki Sukegawa,2016-10-03 01:04:31+09:00,['b413703eef78a3557ca6a1df073ad1eaecb4a936'],8,8,16,1031086,1,,,,2710
d1c0d331992014f36b221ea707943cbaa3bfb3a3,0,tpcwang,2016-10-04 09:34:37-07:00,['b0dadbde6aad1f5a09d47e3d1f2c713c76cd915f'],1,2,3,1031089,1,0,0,0,2710
548403eeab40ca8c8217fce2dade26876b41b152,0,Jens Geyer,2016-10-07 18:57:29+02:00,['d1c0d331992014f36b221ea707943cbaa3bfb3a3'],21,24,45,1031134,1,0,0.333333333,1,2710
d6bcb265bb45917ddefac155ae71cf17ea60f9bc,0,Jens Geyer,2016-10-07 19:03:40+02:00,['548403eeab40ca8c8217fce2dade26876b41b152'],2,4,6,1031140,2,0,0,1,2710
3fa1940486b14ab94587ab580f2357fa65e51ba7,0,jfarrell,2016-10-12 12:17:29-04:00,['d6bcb265bb45917ddefac155ae71cf17ea60f9bc'],3,42,45,1031185,1,0,0.36,0.68,2710
36200904e78f11dd0ca2d751a9b35bb54790267b,0,Jens Geyer,2016-10-13 22:59:20+02:00,['3fa1940486b14ab94587ab580f2357fa65e51ba7'],42,45,87,1031272,9,1,0,0,2710
af81cf0c6180cda4791e023a37ad134247fa7794,0,Jens Geyer,2016-10-13 23:02:53+02:00,['36200904e78f11dd0ca2d751a9b35bb54790267b'],24,25,49,1031321,2,0.5,0.125,1,2710
015fe5272cdcfc14063384ad9cc2d083cd5e2b09,1,Jens Geyer,2016-10-17 23:00:11+02:00,['af81cf0c6180cda4791e023a37ad134247fa7794'],6,4,10,1031331,1,1,0.5,0,2710
59cb6661bcee265d39ad524154472ebe27760f1e,0,Nobuaki Sukegawa,2016-10-19 22:53:32+09:00,['015fe5272cdcfc14063384ad9cc2d083cd5e2b09'],0,4,4,1031335,2,,,,2710
74c99ba38b02288daf05229cdf34e60261d2d01e,1,Jens Geyer,2016-10-31 18:53:02+01:00,['59cb6661bcee265d39ad524154472ebe27760f1e'],10,10,20,1031355,1,,,,2710
f793c2b3aab06af37b59a7fd96ef22c339a7b957,0,Jim King,2016-11-10 15:08:21-05:00,['74c99ba38b02288daf05229cdf34e60261d2d01e'],18,16,34,1031389,1,1,1,0,2710
94d4f3ee69d5a992f861c39f7d0c9bbd2d9af7a6,0,Jim King,2016-11-10 16:31:28-05:00,['f793c2b3aab06af37b59a7fd96ef22c339a7b957'],0,3,3,1031392,1,,,,2710
fd832242bba9d4eaba71c7c08e8eed440b106f98,0,Jens Geyer,2016-11-10 22:56:47+01:00,['94d4f3ee69d5a992f861c39f7d0c9bbd2d9af7a6'],6,2,8,1031400,1,,,,2710
ea5ea8b4c85ffced36a88b93b35a4671478921ab,0,"James E. King, III",2016-11-12 15:12:33-05:00,['fd832242bba9d4eaba71c7c08e8eed440b106f98'],7,14,21,1031421,1,0,1,0,2710
df89913b8a952a46bc91264e0d96df9c69969efb,1,"James E. King, III",2016-11-12 15:16:30-05:00,['ea5ea8b4c85ffced36a88b93b35a4671478921ab'],624,805,1429,1032850,23,0,0,1,2710
c544975d910534b753dc1c4480c09042f8ba07af,1,"James E. King, III",2016-11-13 12:00:37-05:00,['df89913b8a952a46bc91264e0d96df9c69969efb'],4,3,7,1032857,2,,,,2710
c9877fb3b40b99c47ab634f15bc7d1cb0acb1053,1,"James E. King, III",2016-11-14 10:20:52-05:00,['c544975d910534b753dc1c4480c09042f8ba07af'],5,15,20,1032877,2,,,,2710
7656793d0de87bded5e4d8c91173b066f3f5daa8,0,"James E. King, III",2016-11-14 10:30:05-05:00,['c9877fb3b40b99c47ab634f15bc7d1cb0acb1053'],1,2,3,1032880,1,0,0,1,2710
220d5f8422ffeecf94f4b46a9dc3c004fd251766,0,"James E. King, III",2016-11-14 11:19:56-05:00,['7656793d0de87bded5e4d8c91173b066f3f5daa8'],24,32,56,1032936,1,0,0,1,2710
4337983d157dd7041c17340107682f26d2c0c795,0,"James E. King, III",2016-11-14 12:39:33-05:00,['220d5f8422ffeecf94f4b46a9dc3c004fd251766'],16,5,21,1032957,2,0,0,0,2710
b7a213c818ec87b703913d8163363554d15f5f99,0,Jens Geyer,2016-11-17 21:21:08+01:00,['4337983d157dd7041c17340107682f26d2c0c795'],9,14,23,1032980,1,0,1,0,2710
2a89bd94ac4ba8c645cad1e0c01606fdac6dc30b,1,Jens Geyer,2016-11-17 21:36:06+01:00,['b7a213c818ec87b703913d8163363554d15f5f99'],1,1,2,1032982,1,,,,2710
84d6af4cf903571319e0ebddd7beb12bc93fb752,0,Jens Geyer,2016-11-19 16:56:31+01:00,['2a89bd94ac4ba8c645cad1e0c01606fdac6dc30b'],3,16,19,1033001,3,0,1,1,2710
7ab125a253e5aebbf2a0ed9a0a1602a4b879eca7,0,Jens Geyer,2016-12-03 01:00:52+01:00,['84d6af4cf903571319e0ebddd7beb12bc93fb752'],179,244,423,1033424,5,1,0,0,2711
c3a3f653b66b7cccf61c936dc349de27b8a18899,0,Jens Geyer,2016-12-10 01:54:54+01:00,['7ab125a253e5aebbf2a0ed9a0a1602a4b879eca7'],0,15,15,1033439,1,,,,2711
60611917cf309d2a25b9cd8f8b5631784b07323d,0,Jens Geyer,2016-12-11 21:31:22+01:00,['c3a3f653b66b7cccf61c936dc349de27b8a18899'],0,8,8,1033447,1,,,,2711
0d9b713b173f35ce02552b2f4372899440a99b25,0,Mark Erickson,2016-12-13 22:20:03-06:00,['60611917cf309d2a25b9cd8f8b5631784b07323d'],18,42,60,1033507,14,,,,2716
71e678a9d4afaeddd7ac7ab8700ce04097c75676,0,Jens Geyer,2016-12-17 19:51:35+01:00,['0d9b713b173f35ce02552b2f4372899440a99b25'],0,5,5,1033512,1,,,,2716
485e0c4a03c2ec852a64c4552a8918e93663056f,0,Jens Geyer,2016-12-17 19:51:36+01:00,['71e678a9d4afaeddd7ac7ab8700ce04097c75676'],2,3,5,1033517,1,,,,2716
f39d4c8535472db962930fb22d733a4f32ed6fc1,0,Jens Geyer,2016-12-17 19:52:36+01:00,['485e0c4a03c2ec852a64c4552a8918e93663056f'],30,103,133,1033650,2,0,0,1,2716
842b14f42fb6243afb46704987b3b5c7ffd433c5,1,jfarrell,2016-12-19 14:39:43-05:00,['f39d4c8535472db962930fb22d733a4f32ed6fc1'],1,1,2,1033652,1,,,,2716
0c27352179e0463bde1f68757f2d77e3c222f530,1,jfarrell,2016-12-19 14:57:54-05:00,['842b14f42fb6243afb46704987b3b5c7ffd433c5'],5,7,12,1033664,2,,,,2716
db3a92ebcffea09fc456bf76754b78fe8466fe59,0,Jens Geyer,2016-12-21 21:08:24+01:00,['0c27352179e0463bde1f68757f2d77e3c222f530'],5,3,8,1033672,1,,,,2716
b2a4d4ae21c789b689dd162deb819665567f481c,1,jfarrell,2016-12-21 15:36:22-05:00,['0c27352179e0463bde1f68757f2d77e3c222f530'],158,750,908,1034580,46,,,,2716
30a8b65dcec88d0710143ca2b94f71915a8549c5,1,Simon South,2016-12-22 06:29:17-05:00,['db3a92ebcffea09fc456bf76754b78fe8466fe59'],19,70,89,1034669,4,0,0.979591837,0.857142857,2716
366e89ead7df34b4132c2accb59dc14fce564883,0,Jens Geyer,2016-12-22 18:27:27+01:00,['30a8b65dcec88d0710143ca2b94f71915a8549c5'],5,5,10,1034679,1,,,,2716
19066b75d014487d5ba6731910edd524aac6aaf6,0,Jens Geyer,2016-12-26 11:33:03+01:00,['366e89ead7df34b4132c2accb59dc14fce564883'],19,19,38,1034717,7,,,,2716
fa133629a265284eeae2bfead4ea2cd6839bf1ff,0,Jens Geyer,2016-12-26 11:35:43+01:00,['19066b75d014487d5ba6731910edd524aac6aaf6'],3,3,6,1034723,3,,,,2716
476cf694ee80f6d2d6aaa5e46bbda8f915863a49,0,Jens Geyer,2016-12-28 00:55:04+01:00,['fa133629a265284eeae2bfead4ea2cd6839bf1ff'],1,1,2,1034725,1,,,,2716
60ac165aeb6b86ae10bb554b107c273bfcde7a83,1,Jens Geyer,2016-12-28 15:13:36+01:00,['476cf694ee80f6d2d6aaa5e46bbda8f915863a49'],1,1,2,1034727,1,,,,2716
540e346d6ec3be9893ff1f29ef89e000c314edf4,0,Jens Geyer,2016-12-28 15:13:48+01:00,['60ac165aeb6b86ae10bb554b107c273bfcde7a83'],54,44,98,1034825,2,,,,2716
d8bb0e3b9ff7e6cecfc85c01a81280dc3d046430,0,Jens Geyer,2017-01-02 10:43:37+01:00,['540e346d6ec3be9893ff1f29ef89e000c314edf4'],25,10,35,1034860,1,1,0,0,2716
3c55440230f3645816913d9c53b42dcc16b70f95,1,Mark Erickson,2017-01-04 10:11:06-06:00,['d8bb0e3b9ff7e6cecfc85c01a81280dc3d046430'],0,3,3,1034863,3,,,,2716
b587a12a116cc394b62d9af2bbcecd50cfb18ce3,1,Jens Geyer,2017-01-04 19:40:30+01:00,['3c55440230f3645816913d9c53b42dcc16b70f95'],0,15076,15076,1049939,111,0.376337763,0.574503117,0.762201576,2813
fac3f69725f507872e6d68afea5debd020ce2580,1,"James E. King, III",2017-01-04 23:38:53-05:00,['b587a12a116cc394b62d9af2bbcecd50cfb18ce3'],1,1,2,1049941,1,,,,2813
59fab5adb499866ac174d2a8edc3808619b2ed58,0,Jens Geyer,2017-01-10 21:28:05+01:00,['fac3f69725f507872e6d68afea5debd020ce2580'],2,8,10,1049951,1,0,0,0,2813
1ca09d0e02f0af3f008183974fc4846ce34993b8,0,Jens Geyer,2017-01-10 22:52:06+01:00,['59fab5adb499866ac174d2a8edc3808619b2ed58'],53,29,82,1050033,2,,,,2813
4f710aa4f47e051d41c863aa7aa9239dab5b9636,0,Jens Geyer,2017-01-10 23:02:00+01:00,['1ca09d0e02f0af3f008183974fc4846ce34993b8'],1,1,2,1050035,1,,,,2813
5f723cd53980f395a92c438790a127cbd5699d90,0,Jens Geyer,2017-01-11 20:50:38+01:00,['4f710aa4f47e051d41c863aa7aa9239dab5b9636'],2,9,11,1050046,5,0,0,0.333333333,2813
e0ccbd6e62e14f32d7c5fe0f9cec6eff3259b863,1,"James E. King, III",2017-01-17 13:14:33-05:00,['5f723cd53980f395a92c438790a127cbd5699d90'],0,3,3,1050049,2,,,,2813
7edc8faefd391ce11eca3023a35cc54bcb2eb1af,1,"James E. King, III",2017-01-20 10:12:06-05:00,['e0ccbd6e62e14f32d7c5fe0f9cec6eff3259b863'],102,248,350,1050399,33,0,0.714285714,1,2814
4194562c60efd101f278c2aa76ce53a53e5382a8,0,Jens Geyer,2017-01-22 13:23:28+01:00,['7edc8faefd391ce11eca3023a35cc54bcb2eb1af'],3,3,6,1050405,1,,,,2814
330b3f814a33ab8a740fca4da29106bd7e219b1d,0,"James E. King, III",2017-01-23 08:52:04-05:00,['4194562c60efd101f278c2aa76ce53a53e5382a8'],35,53,88,1050493,4,,,,2814
55f976e0decefb284b0f0a459745dd57f038ab4f,0,"James E. King, III",2017-01-23 09:06:27-05:00,['330b3f814a33ab8a740fca4da29106bd7e219b1d'],1,1,2,1050495,1,,,,2814
b62247e0ea23139a9922a1de965357907319e937,0,Jens Geyer,2017-01-25 00:04:45+01:00,['55f976e0decefb284b0f0a459745dd57f038ab4f'],116,445,561,1051056,13,0.415300546,0.650273224,0.918032787,2816
3d6e2a507159e51d486e4e2674a1dca5fc227279,1,"James E. King, III",2017-01-24 23:31:54-05:00,['b62247e0ea23139a9922a1de965357907319e937'],0,15,15,1051071,1,1,1,1,2816
6fe7fa1b7ed72215a59e93c680a209a99530fada,0,"James E. King, III",2017-01-25 09:43:24-05:00,['3d6e2a507159e51d486e4e2674a1dca5fc227279'],2,5,7,1051078,1,,,,2816
8b96bfbf1eb058d3c378535e90c1e90280224bb4,1,Jens Geyer,2017-01-26 01:34:16+01:00,['6fe7fa1b7ed72215a59e93c680a209a99530fada'],3,12142,12145,1063223,52,0.368083004,0.78458498,0.885540184,2857
cf254894026988c7aa1e9742117c091f902cc838,0,"James E. King, III",2017-01-25 20:34:04-05:00,['8b96bfbf1eb058d3c378535e90c1e90280224bb4'],13,13,26,1063249,4,,,,2857
71eba643ddc10bd2a9f614348567bfc1f63d8d06,0,"James E. King, III",2017-01-25 20:41:06-05:00,['cf254894026988c7aa1e9742117c091f902cc838'],16,10,26,1063275,4,,,,2857
f3490c5f8e2e871f75ea540126f9fb233cf71601,0,"James E. King, III",2017-01-27 09:43:18-05:00,['71eba643ddc10bd2a9f614348567bfc1f63d8d06'],6,18,24,1063299,2,,,,2858
96be8c8d9408548966b3fb2895a8b84ac1045a37,0,"James E. King, III",2017-01-27 11:45:57-05:00,['f3490c5f8e2e871f75ea540126f9fb233cf71601'],1,14,15,1063314,1,,,,2858
988b3e9bde9ef687dd09311c9842c8a5bf24e608,0,"James E. King, III",2017-01-27 23:33:19-05:00,['96be8c8d9408548966b3fb2895a8b84ac1045a37'],0,1,1,1063315,1,0,1,1,2858
de3e17ad39a57163a42ab89d559356f4cee27c4a,0,"James E. King, III",2017-01-27 23:36:31-05:00,['988b3e9bde9ef687dd09311c9842c8a5bf24e608'],9,48,57,1063372,4,0.178571429,1,1,2858
b88a25a47fcf1f63a85ce2d11a8e6579085997a9,0,"James E. King, III",2017-01-27 23:47:16-05:00,['de3e17ad39a57163a42ab89d559356f4cee27c4a'],1,0,1,1063373,1,,,,2858
8656670fe27408f81d35b10c5edabfaebfbd17fe,1,"James E. King, III",2017-01-28 16:00:09-05:00,['b88a25a47fcf1f63a85ce2d11a8e6579085997a9'],1,1,2,1063375,1,,,,2858
8d377fa6befb6ef9fd2364b5cc2972406e2a92a3,0,"James E. King, III",2017-01-28 18:27:26-05:00,['8656670fe27408f81d35b10c5edabfaebfbd17fe'],2,0,2,1063377,1,,,,2858
feea47852c50f502139952b7fa96cc71c45690bf,0,Jens Geyer,2017-01-31 21:22:06+01:00,['8d377fa6befb6ef9fd2364b5cc2972406e2a92a3'],347,405,752,1064129,8,1,1,1,2859
34bd992bc3104517062482ec837d4b49d33963ef,0,Jens Geyer,2017-01-31 21:31:58+01:00,['feea47852c50f502139952b7fa96cc71c45690bf'],1,0,1,1064130,1,1,0,0,2859
2d6060d882069ed3e3d6302aa63ea7eb4bb155ad,1,"James E. King, III",2017-01-31 16:17:53-05:00,['34bd992bc3104517062482ec837d4b49d33963ef'],0,66,66,1064196,2,,,,2860
de9c330b24c9190078eefb68c864d2a41a4dee07,0,"James E. King, III",2017-02-01 07:16:28-05:00,['2d6060d882069ed3e3d6302aa63ea7eb4bb155ad'],2,3,5,1064201,1,1,1,1,2860
a3d6be906b339ce4e55e8fb8d98ff11480792949,0,"James E. King, III",2017-02-04 00:23:55-05:00,['de9c330b24c9190078eefb68c864d2a41a4dee07'],1,1,2,1064203,1,,,,2860
3a8bbbd4a68fb28f2b33a7ee9e81ba3dd4a929a5,1,"James E. King, III",2017-02-06 12:57:21-05:00,['a3d6be906b339ce4e55e8fb8d98ff11480792949'],4,4,8,1064211,2,,,,2860
bdd0b73a89f518917d23b35129226b89631e39fa,0,"James E. King, III",2017-02-08 12:27:57-05:00,['3a8bbbd4a68fb28f2b33a7ee9e81ba3dd4a929a5'],6,10,16,1064227,1,,,,2860
bd257f1b9058c1ea7fc12b0a312fe7fa3de86a7e,0,"James E. King, III",2017-02-08 13:05:33-05:00,['bdd0b73a89f518917d23b35129226b89631e39fa'],1,2,3,1064230,1,,,,2860
9019b280eacf0c2cf02d7671a59a9f099b82aa88,0,"James E. King, III",2017-02-08 20:53:09-05:00,['bd257f1b9058c1ea7fc12b0a312fe7fa3de86a7e'],24,10,34,1064264,2,,,,2860
d1482fe3e202be8ca6e428048e0512dc37b127ab,1,"James E. King, III",2017-02-09 07:53:44-05:00,['9019b280eacf0c2cf02d7671a59a9f099b82aa88'],1,9,10,1064274,1,0,1,1,2860
f5350585721aad1f89c0516c8db0743e3456712d,0,"James E. King, III",2017-02-09 10:03:03-05:00,['d1482fe3e202be8ca6e428048e0512dc37b127ab'],4,0,4,1064278,1,1,1,0,2860
3590f1e7ca49c3eea879008d510023edf30b6408,0,"James E. King, III",2017-02-09 15:12:47-05:00,['f5350585721aad1f89c0516c8db0743e3456712d'],3,21,24,1064302,1,1,1,0.833333333,2860
e1832c354391deb0e0ce94a62ff32e8ce1c83fd3,1,"James E. King, III",2017-02-10 13:03:10-05:00,['3590f1e7ca49c3eea879008d510023edf30b6408'],15,38,53,1064355,5,,,,2860
bff044667caf8a8c2b0dd30ed11b328ff2902cf5,0,"James E. King, III",2017-02-11 01:18:03-05:00,['e1832c354391deb0e0ce94a62ff32e8ce1c83fd3'],5,5,10,1064365,2,,,,2860
4626fd889da53462023d42d99d1d82e13a6e890f,1,Nobuaki Sukegawa,2017-02-12 21:11:36+09:00,['bff044667caf8a8c2b0dd30ed11b328ff2902cf5'],58,79,137,1064502,3,0,0,0.32,2860
e8ba7877baec6f9871a88db8d3885361a2260ab2,0,Nobuaki Sukegawa,2017-02-12 21:14:48+09:00,['4626fd889da53462023d42d99d1d82e13a6e890f'],5,10,15,1064517,3,0,1,1,2860
36628a28e975e4d680fff66eec3e66c06ca86bf2,1,"James E. King, III",2017-02-13 15:25:41-05:00,['e8ba7877baec6f9871a88db8d3885361a2260ab2'],30,1752,1782,1066299,14,0.283229814,0.718012422,0.752795031,2864
b4c190b6ea960c20a420089b1431042e435c73e9,0,"James E. King, III",2017-02-13 16:39:59-05:00,['36628a28e975e4d680fff66eec3e66c06ca86bf2'],15,163,178,1066477,6,0.416666667,0.305555556,0.916666667,2865
0a660ee285e4a4cbac8f702168c40fd4ef5495d1,0,"James E. King, III",2017-02-13 18:25:56-05:00,['b4c190b6ea960c20a420089b1431042e435c73e9'],2,2,4,1066481,2,,,,2865
ec50ae0ed59c06658da11d2ed54e1681a4ef5a3a,0,"James E. King, III",2017-02-14 16:12:11-05:00,['0a660ee285e4a4cbac8f702168c40fd4ef5495d1'],0,19,19,1066500,2,,,,2865
ab8ff1abf74320f23bb692ca9ae83062503b2518,0,"James E. King, III",2017-02-15 14:12:37-05:00,['ec50ae0ed59c06658da11d2ed54e1681a4ef5a3a'],150,3,153,1066653,4,0.790322581,0.790322581,0,2865
b28160b9c38b7febc3843cf69c6abc12c4d79df5,0,"James E. King, III",2017-02-15 14:23:44-05:00,['ab8ff1abf74320f23bb692ca9ae83062503b2518'],1897,98,1995,1068648,8,,,,2870
377719c2d85f6f92df7a40e34a84129406f6deb4,0,"James E. King, III",2017-02-15 14:33:20-05:00,['b28160b9c38b7febc3843cf69c6abc12c4d79df5'],100,132,232,1068880,9,,,,2870
736075d2ac9ff4a449a3446320c270d864f8e616,0,"James E. King, III",2017-02-18 13:55:30-05:00,['377719c2d85f6f92df7a40e34a84129406f6deb4'],4,4,8,1068888,1,,,,2870
400b346db2510fffa06c0ced11105e3618ce5367,0,"James E. King, III",2017-02-18 13:58:21-05:00,['736075d2ac9ff4a449a3446320c270d864f8e616'],3,101,104,1068992,3,0.923076923,0.333333333,1,2871
655b9b6ef86c45b423a194abee2a9cd057a16a74,0,"James E. King, III",2017-02-18 14:30:46-05:00,['400b346db2510fffa06c0ced11105e3618ce5367'],2,80,82,1069074,3,0.381818182,1,1,2871
4d651ab06aad566d6eaf67c67133befa0117b12f,0,"James E. King, III",2017-02-19 22:19:55-05:00,['655b9b6ef86c45b423a194abee2a9cd057a16a74'],0,927,927,1070001,10,,,,2881
239233afb6fd5bd2fb81743e88303c9ac17d7edb,0,"James E. King, III",2017-02-20 08:04:12-05:00,['4d651ab06aad566d6eaf67c67133befa0117b12f'],2,3,5,1070006,1,,,,2881
06190874c8ba8f3a0c7ae83a59965d56c205e080,1,"James E. King, III",2017-02-20 08:52:11-05:00,['239233afb6fd5bd2fb81743e88303c9ac17d7edb'],26,205,231,1070237,17,0.666666667,0.476190476,0.523809524,2883
bc0082e02357de2f30b997188bdfa94d703331f4,1,"James E. King, III",2017-02-20 14:04:17-05:00,['06190874c8ba8f3a0c7ae83a59965d56c205e080'],32,1103,1135,1071372,9,0.653379549,0.965337955,0.421143847,2887
43fb34df2871b69c2f34dc3bb353e65cbc9f8692,1,Jens Geyer,2017-02-21 22:32:49+01:00,['bc0082e02357de2f30b997188bdfa94d703331f4'],27,48,75,1071447,9,0.585365854,0.585365854,0.731707317,2887
8615fee798be60dc94adaaa6b31b1db8566a2ead,0,"James E. King, III",2017-02-21 21:29:17-05:00,['43fb34df2871b69c2f34dc3bb353e65cbc9f8692'],7,3,10,1071457,1,,,,2887
4361ecc3a18063f45049cc781779d4943b20e9ae,0,"James E. King, III",2017-02-22 11:24:41-05:00,['8615fee798be60dc94adaaa6b31b1db8566a2ead'],1,3,4,1071461,1,1,1,1,2887
37aac3bb58b9a7413b25e5eba4fb95fc8796cd3c,1,"James E. King, III",2017-02-22 12:46:04-05:00,['4361ecc3a18063f45049cc781779d4943b20e9ae'],440,561,1001,1072462,14,0,0.035714286,0.875,2887
e66b8fcde3922ab9244908d9ca27d5084536e168,1,"James E. King, III",2017-02-23 11:43:45-05:00,['37aac3bb58b9a7413b25e5eba4fb95fc8796cd3c'],3,50,53,1072515,2,0.5,0.5,0.5,2887
e2bc9727500584e055ce603bf95f00165c657ec2,0,"James E. King, III",2017-02-24 10:28:27-05:00,['e66b8fcde3922ab9244908d9ca27d5084536e168'],1,0,1,1072516,1,0,0,0,2887
5038466e5e57b17b881684bae0e541408aafac0e,0,"James E. King, III",2017-02-27 23:38:44-05:00,['e2bc9727500584e055ce603bf95f00165c657ec2'],10,33,43,1072559,2,0.684210526,0,0.894736842,2887
36d1b0dea566c0dea06e321421e32a6cad0abb32,1,"James E. King, III",2017-02-27 23:44:35-05:00,['5038466e5e57b17b881684bae0e541408aafac0e'],30,61,91,1072650,2,0.727272727,0.772727273,1,2887
c89e172289129a0a700a20f11f4a157b7da789d2,0,"James E. King, III",2017-02-28 12:25:28-05:00,['36d1b0dea566c0dea06e321421e32a6cad0abb32'],37,53,90,1072740,1,1,0.666666667,0.666666667,2887
431732d39e89f1661dc7dddffedb2c5c1e019cc7,0,Jens Geyer,2017-03-04 14:13:59+01:00,['c89e172289129a0a700a20f11f4a157b7da789d2'],11,7,18,1072758,1,1,1,1,2887
b79396f799fe88d2dae48573f61257aac5b2c09b,0,"James E. King, III",2017-03-06 19:09:06-05:00,['431732d39e89f1661dc7dddffedb2c5c1e019cc7'],196,214,410,1073168,2,1,0,0.333333333,2887
9b1544dc21f2d952b91c44e4636e1b9da937002c,0,"James E. King, III",2017-03-10 06:14:18-05:00,['b79396f799fe88d2dae48573f61257aac5b2c09b'],1,13,14,1073182,2,,,,2887
07f59971bd11df619709444275298061ee69f707,1,"James E. King, III",2017-03-10 06:18:33-05:00,['9b1544dc21f2d952b91c44e4636e1b9da937002c'],153,1006,1159,1074341,42,1,1,0,2909
6582757752e62efea3f9786dddf0260efaa1f450,0,"James E. King, III",2017-03-10 06:24:31-05:00,['07f59971bd11df619709444275298061ee69f707'],0,1,1,1074342,1,,,,2910
e576b26e39e5b34df1fa81cec039a0066a280f65,0,"James E. King, III",2017-03-22 14:42:52-04:00,['6582757752e62efea3f9786dddf0260efaa1f450'],14,34,48,1074390,1,0.111111111,1,0,2910
75386db8c0eaba39ec5ad374cba27e039d2493e2,0,"James E. King, III",2017-03-22 15:03:37-04:00,['e576b26e39e5b34df1fa81cec039a0066a280f65'],1,1,2,1074392,1,,,,2910
bf9b6970ba3e30d0a13eca358335508b3f788e33,1,"James E. King, III",2017-03-22 15:07:23-04:00,['75386db8c0eaba39ec5ad374cba27e039d2493e2'],1,1,2,1074394,1,,,,2910
847fae9388048aa9e09d5ed042e34f5452638248,0,"James E. King, III",2017-03-22 15:17:30-04:00,['bf9b6970ba3e30d0a13eca358335508b3f788e33'],1,5,6,1074400,1,,,,2910
6c08ac72c6ce9faf66bf28ee75cbb87413daa6aa,0,"James E. King, III",2017-03-22 20:33:20-04:00,['847fae9388048aa9e09d5ed042e34f5452638248'],0,3,3,1074403,1,0,0,1,2910
147c2849af9c28f2ce347b4005e022ac13db9dd8,1,"James E. King, III",2017-03-25 08:16:18-04:00,['6c08ac72c6ce9faf66bf28ee75cbb87413daa6aa'],10,51,61,1074464,7,,,,2911
971d077807d4497ff841519103577de52fbcd3a1,1,Jens Geyer,2017-03-26 19:54:50+02:00,['147c2849af9c28f2ce347b4005e022ac13db9dd8'],83,79,162,1074626,19,1,1,0,2911
9f71e00b0068d8d5ab571d41c11f087a6e8167e1,0,"James E. King, III",2017-03-27 08:52:12-04:00,['971d077807d4497ff841519103577de52fbcd3a1'],1,1,2,1074628,1,,,,2911
9a8d576c8828d25fc6fb2d5797402590b7edc737,0,"James E. King, III",2017-03-27 15:39:00-04:00,['9f71e00b0068d8d5ab571d41c11f087a6e8167e1'],2,2,4,1074632,2,,,,2911
7470995ce4bb480a86beaf1d8babce95c6f4b8c7,0,Jens Geyer,2017-03-27 22:50:16+02:00,['9a8d576c8828d25fc6fb2d5797402590b7edc737'],6,22,28,1074660,5,0,0.333333333,1,2911
1360270eb8e03402d48322514eaa58342e5b25d0,1,"James E. King, III",2017-03-30 16:42:11-04:00,['7470995ce4bb480a86beaf1d8babce95c6f4b8c7'],11,91,102,1074762,3,0,0.421052632,0.894736842,2911
177c37ce8516e21b8093fbd7c8047037f794a5f8,0,"James E. King, III",2017-03-30 17:09:04-04:00,['1360270eb8e03402d48322514eaa58342e5b25d0'],431,565,996,1075758,28,1,1,1,2913
1187060183b1f1a17b34b6f14734649b4299745d,0,"James E. King, III",2017-03-30 17:25:10-04:00,['177c37ce8516e21b8093fbd7c8047037f794a5f8'],1,1,2,1075760,1,,,,2913
c063b30ecd56e920aa136e789a968068996e74ec,0,"James E. King, III",2017-03-30 17:28:58-04:00,['1187060183b1f1a17b34b6f14734649b4299745d'],34,37,71,1075831,3,0,0,0,2913
7bc943196d90a1480d1631c330b03ae6ee479ce8,0,"James E. King, III",2017-03-31 21:25:20-04:00,['c063b30ecd56e920aa136e789a968068996e74ec'],6,16,22,1075853,2,,,,2913
bede86a032789ea9d8ed7a7d9c684d3fc86ade5c,0,"James E. King, III",2017-04-01 10:14:16-04:00,['7bc943196d90a1480d1631c330b03ae6ee479ce8'],15,0,15,1075868,1,1,1,0,2913
2c0badd660501d8b9059b0a8ae97f41f0dc37e92,0,"James E. King, III",2017-04-01 10:38:13-04:00,['bede86a032789ea9d8ed7a7d9c684d3fc86ade5c'],1,1,2,1075870,1,,,,2913
5c3de6d3d28b94650486d8ae337af56c94e9e442,0,"James E. King, III",2017-04-01 10:46:25-04:00,['2c0badd660501d8b9059b0a8ae97f41f0dc37e92'],8,12,20,1075890,1,0,1,1,2913
117a5cca77c3994a62e0287f703232af44a48d9f,1,"James E. King, III",2017-04-01 10:51:48-04:00,['5c3de6d3d28b94650486d8ae337af56c94e9e442'],53,79,132,1076022,10,1,1,1,2913
fcf44767929dca4c3b722e1fc3303e7ce51a28e4,1,"James E. King, III",2017-04-01 10:56:21-04:00,['117a5cca77c3994a62e0287f703232af44a48d9f'],1,1,2,1076024,1,,,,2913
f65db706b39ceb4898d6c78fe8a7a37501e02c13,1,"James E. King, III",2017-04-01 11:15:54-04:00,['fcf44767929dca4c3b722e1fc3303e7ce51a28e4'],15,145,160,1076184,4,0.965517241,0.965517241,1,2914
d5536d1ea0300d5643600608492ae51b35538cbf,0,"James E. King, III",2017-04-01 11:21:12-04:00,['f65db706b39ceb4898d6c78fe8a7a37501e02c13'],1,0,1,1076185,1,1,1,0,2914
c6ded922c586cad7f66b57a123fec520e5c36a5e,0,"James E. King, III",2017-04-01 23:26:54-04:00,['d5536d1ea0300d5643600608492ae51b35538cbf'],4,2,6,1076191,1,0,0,0,2914
90b6304901d8501d54544439d1b7272f5c6de224,0,Jens Geyer,2017-04-02 16:06:08+02:00,['c6ded922c586cad7f66b57a123fec520e5c36a5e'],6,6,12,1076203,1,,,,2914
df3223c85db910e55bc1d5237c145ddcde93e664,0,"James E. King, III",2017-04-02 23:14:29-04:00,['90b6304901d8501d54544439d1b7272f5c6de224'],26,165,191,1076394,4,0.490566038,1,1,2914
d4fa706dcab91f85153f4243eaa28eb604df1290,0,"James E. King, III",2017-04-02 23:24:54-04:00,['df3223c85db910e55bc1d5237c145ddcde93e664'],4,7,11,1076405,1,0,0,1,2914
bf42d55189d9d8160a061cc3a7020324111942bb,0,"James E. King, III",2017-04-02 23:30:04-04:00,['d4fa706dcab91f85153f4243eaa28eb604df1290'],4,1,5,1076410,1,0,0,0,2914
7e7a1a7c1027d30294da24e5d3f299ff90313c34,0,"James E. King, III",2017-04-02 23:37:14-04:00,['bf42d55189d9d8160a061cc3a7020324111942bb'],2,0,2,1076412,1,1,1,0,2914
00d4252392d9159202cd6ffc4b3294f85265310f,0,"James E. King, III",2017-04-04 09:32:45-04:00,['7e7a1a7c1027d30294da24e5d3f299ff90313c34'],50,190,240,1076652,10,0.683333333,0.966666667,1,2915
7f5a8c28bc58011abef0cede10915c2071efbe41,0,"James E. King, III",2017-04-04 09:36:38-04:00,['00d4252392d9159202cd6ffc4b3294f85265310f'],24,56,80,1076732,4,1,0,0,2915
43e959bc5c4e68d0c2545a09ad4fc1c226885a22,1,"James E. King, III",2017-04-05 08:58:38-04:00,['7f5a8c28bc58011abef0cede10915c2071efbe41'],30,80,110,1076842,7,,,,2915
257dceff5ebeb083ecf5527d80e37aa9706e2d75,0,"James E. King, III",2017-04-05 19:29:24-04:00,['43e959bc5c4e68d0c2545a09ad4fc1c226885a22'],0,2,2,1076844,1,0.5,0.5,1,2915
4eb23472b76759843b802bb222d308d408475ab0,1,"James E. King, III",2017-04-05 19:32:27-04:00,['257dceff5ebeb083ecf5527d80e37aa9706e2d75'],35,7,42,1076886,1,,,,2915
33df4eb77a70a25a37060efd5e5aad049ed39062,1,"James E. King, III",2017-04-06 08:45:17-04:00,['4eb23472b76759843b802bb222d308d408475ab0'],37,60,97,1076983,6,,,,2915
d6de19925913ac3b7e5a38167e2362cd2a91a506,0,"James E. King, III",2017-04-06 09:22:22-04:00,['33df4eb77a70a25a37060efd5e5aad049ed39062'],0,587,587,1077570,1,,,,2915
3641b54352f1c810ba3f60176d51472bfafdc6e0,0,"James E. King, III",2017-04-06 17:49:05-04:00,['d6de19925913ac3b7e5a38167e2362cd2a91a506'],3,3,6,1077576,1,,,,2915
b909a3897b72fee7f1d9957df5d6702e5f06b442,1,"James E. King, III",2017-04-06 19:12:28-04:00,['3641b54352f1c810ba3f60176d51472bfafdc6e0'],496,496,992,1078568,11,,,,2915
f74943cf6e9384e91a1085daf80c78b148f8ebe5,0,"James E. King, III",2017-04-06 21:04:56-04:00,['b909a3897b72fee7f1d9957df5d6702e5f06b442'],2,2,4,1078572,2,,,,2915
ee17ff95e591192b704a9a15bf962945e66f64ab,0,"James E. King, III",2017-04-07 00:25:42-04:00,['f74943cf6e9384e91a1085daf80c78b148f8ebe5'],2,2,4,1078576,1,,,,2915
92e1c409c74632ea302eea48b1507e1121769a46,0,"James E. King, III",2017-04-07 09:24:41-04:00,['ee17ff95e591192b704a9a15bf962945e66f64ab'],12,67,79,1078655,3,1,1,1,2915
3db41faf4e607e52960c6265161ac8808a24c113,0,"James E. King, III",2017-04-08 00:31:35-04:00,['92e1c409c74632ea302eea48b1507e1121769a46'],2,2,4,1078659,1,,,,2915
2d65c2365f19f637bc732222e71d78727bf0b709,0,"James E. King, III",2017-04-10 08:55:19-04:00,['3db41faf4e607e52960c6265161ac8808a24c113'],0,6,6,1078665,1,,,,2915
a105450fd1f85ca40423b7f81e9c49386444d429,0,"James E. King, III",2017-04-18 09:11:06-04:00,['2d65c2365f19f637bc732222e71d78727bf0b709'],5,5,10,1078675,2,,,,2915
3311a9b2375276441234218f4351c6a8f66a6bc2,0,"James E. King, III",2017-04-19 12:38:14-04:00,['a105450fd1f85ca40423b7f81e9c49386444d429'],0,58,58,1078733,5,0,1,0.947368421,2917
9db23b7be330f47037b4e3e5e374eda5e38b0dfd,0,Jens Geyer,2017-04-27 00:29:52+02:00,['3311a9b2375276441234218f4351c6a8f66a6bc2'],3,7,10,1078743,1,1,1,0,2917
0e22c362b967bd3765ee3da349faa789904a0707,1,"James E. King, III",2017-04-27 08:46:02-04:00,['9db23b7be330f47037b4e3e5e374eda5e38b0dfd'],1874,3209,5083,1083826,29,1,1,1,2919
177b5691b6f822aed11258758c89fe99a5ef89a4,0,"James E. King, III",2017-04-27 09:53:07-04:00,['0e22c362b967bd3765ee3da349faa789904a0707'],1,1,2,1083828,1,,,,2919
19baeefd8c38d62085891d7956349601f79448b3,0,"James E. King, III",2017-04-27 14:09:31-04:00,['177b5691b6f822aed11258758c89fe99a5ef89a4'],3,4,7,1083835,1,,,,2919
c54a90d12d7ca05de88dfaa5d569dbb96dd83317,0,Jens Geyer,2017-05-06 00:58:05+02:00,['19baeefd8c38d62085891d7956349601f79448b3'],4,12,16,1083851,2,0,0,1,2919
224c334e50a553504385dd001dadf31f7346b30a,0,Jens Geyer,2017-05-08 16:53:15+02:00,['c54a90d12d7ca05de88dfaa5d569dbb96dd83317'],4,10,14,1083865,1,0,1,0,2919
3966a56a877bf5df8fba8ad3076153a8261b901a,0,Jens Geyer,2017-05-11 01:26:22+02:00,['224c334e50a553504385dd001dadf31f7346b30a'],1,1,2,1083867,1,,,,2919
bc1344d55fa450289f98b1a1d0d15c7fcb7d37e1,1,Jens Geyer,2017-05-11 01:35:33+02:00,['3966a56a877bf5df8fba8ad3076153a8261b901a'],217,609,826,1084693,16,0.017857143,0,0.428571429,2919
5862099f371388b0d1c0cc8beb43efb17e017a99,0,Jens Geyer,2017-05-13 00:01:05+02:00,['bc1344d55fa450289f98b1a1d0d15c7fcb7d37e1'],21,240,261,1084954,6,0.116959064,0.269005848,0.532163743,2919
9a745aa4a9ac1098f0ea584d0f4e85ca1f04c964,0,Jens Geyer,2017-05-13 00:28:32+02:00,['5862099f371388b0d1c0cc8beb43efb17e017a99'],1,10,11,1084965,1,0.857142857,1,1,2919
b67cad46e43c2a88e6f9cc986a9f0c3b6b300971,0,Jens Geyer,2017-05-13 13:58:02+02:00,['9a745aa4a9ac1098f0ea584d0f4e85ca1f04c964'],2,31,33,1084998,1,1,1,1,2919
d1380d52999e3c47e978879059f5017d01b257f3,0,Jens Geyer,2017-05-14 12:57:11+02:00,['b67cad46e43c2a88e6f9cc986a9f0c3b6b300971'],15,63,78,1085076,1,0.75,0,0.194444444,2919
a576896398f03d1854f128479d31659446c51027,1,Jens Geyer,2017-05-18 23:24:52+02:00,['d1380d52999e3c47e978879059f5017d01b257f3'],2,14,16,1085092,1,0.125,0.25,1,2919
e41e47c2b4b2407bac525d203b281c63fb253978,0,Jens Geyer,2017-05-18 23:39:09+02:00,['a576896398f03d1854f128479d31659446c51027'],1,1,2,1085094,1,,,,2919
888b577ea678df7b486843b86a18cebd93002ba8,0,Jens Geyer,2017-05-27 11:26:19+02:00,['e41e47c2b4b2407bac525d203b281c63fb253978'],4,4,8,1085102,2,,,,2919
5608e43ec8c1fb77460c7ab3b27bbda251d29be9,0,Jens Geyer,2017-05-27 11:26:20+02:00,['888b577ea678df7b486843b86a18cebd93002ba8'],7,16,23,1085125,1,0,1,1,2919
c71bdf85c9b643587c48804d29e063303f27fee5,1,Jens Geyer,2017-05-27 21:10:32+02:00,['5608e43ec8c1fb77460c7ab3b27bbda251d29be9'],4,7,11,1085136,2,,,,2919
72ca60debae1d9fb35d9f0085118873669006d7f,0,Jens Geyer,2017-05-28 10:20:39+02:00,['c71bdf85c9b643587c48804d29e063303f27fee5'],1,2,3,1085139,1,,,,2919
695115952de6ef5603a30081e2a6762bd2a57ba6,0,Jens Geyer,2017-05-31 09:07:26+02:00,['72ca60debae1d9fb35d9f0085118873669006d7f'],2,43,45,1085184,1,0.594594595,0,1,2919
197b0629935b9b240915485dd3ed631b19b74d7d,0,Jens Geyer,2017-05-31 11:44:34+02:00,['695115952de6ef5603a30081e2a6762bd2a57ba6'],10,46,56,1085240,3,0.764705882,0.764705882,1,2920
2b1b32c2836c21ce012d39ebc02c8488d67d4cef,1,Jens Geyer,2017-05-31 22:56:52+02:00,['197b0629935b9b240915485dd3ed631b19b74d7d'],1,3,4,1085244,1,0,0,0,2920
8da0e720bb8e7550220cf1b360f3fb8aa37b9ded,1,Jens Geyer,2017-06-05 14:22:06+02:00,['2b1b32c2836c21ce012d39ebc02c8488d67d4cef'],139,325,464,1085708,21,0.830769231,0.805128205,0.969230769,2920
48ea3cde081b6343ceda2f1e3811887c1d11859b,1,Jens Geyer,2017-06-06 13:59:53+02:00,['8da0e720bb8e7550220cf1b360f3fb8aa37b9ded'],0,3,3,1085711,1,0,0,1,2920
b8ee72de5bf9318d50846852082325d0f932682b,0,Jens Geyer,2017-06-07 22:45:54+02:00,['48ea3cde081b6343ceda2f1e3811887c1d11859b'],0,5,5,1085716,1,1,1,1,2920
c55fdb95340417a4ba2dda41e9e872a4bcc63459,0,Jens Geyer,2017-06-17 17:59:46+02:00,['b8ee72de5bf9318d50846852082325d0f932682b'],11,30,41,1085757,1,0,0,1,2920
2b1975a4ceb250fe82b1735f46bc116de8c3ce9a,0,Jens Geyer,2017-06-26 23:20:22+02:00,['c55fdb95340417a4ba2dda41e9e872a4bcc63459'],4,4,8,1085765,1,,,,2920
4aaa92ece8503a6da9bc6701604f69acf2b99d07,0,Jens Geyer,2017-06-26 23:21:15+02:00,['2b1975a4ceb250fe82b1735f46bc116de8c3ce9a'],2,4,6,1085771,1,,,,2920
c0e353500d0fabe873ad950e5db3317dafd44544,0,Jens Geyer,2017-07-01 15:51:14+02:00,['4aaa92ece8503a6da9bc6701604f69acf2b99d07'],1,77,78,1085849,2,0,0,1,2920
b771cbedd6e7af4b2886eabea4bbc47aa860449a,1,Jens Geyer,2017-07-01 16:00:02+02:00,['c0e353500d0fabe873ad950e5db3317dafd44544'],3,100,103,1085952,2,1,1,1,2921
c1794358bbf755f7bccacefb6a325804aa195d65,1,Jens Geyer,2017-07-01 16:01:12+02:00,['b771cbedd6e7af4b2886eabea4bbc47aa860449a'],20,56,76,1086028,2,1,1,1,2921
c0a7050c0ab0200345d97d34fe1f83846701bf76,1,Jens Geyer,2017-07-01 16:05:10+02:00,['c1794358bbf755f7bccacefb6a325804aa195d65'],5,18,23,1086051,3,1,1,1,2921
5b4c6bfc627ddbd56d1e98d4b818bec8cd8a5efd,1,Jens Geyer,2017-07-01 17:23:56+02:00,['c0a7050c0ab0200345d97d34fe1f83846701bf76'],46,455,501,1086552,14,0.410138249,0.493087558,0.847926267,2924
49e5103920e75a149d02c7d487496c8c79154a6c,0,Jens Geyer,2017-07-05 21:59:07+02:00,['5b4c6bfc627ddbd56d1e98d4b818bec8cd8a5efd'],0,2,2,1086554,1,0,1,1,2924
c34653f75106fbe20293ddfd5b07f74772891a6d,0,Jens Geyer,2017-07-06 22:59:10+02:00,['49e5103920e75a149d02c7d487496c8c79154a6c'],45,257,302,1086856,7,0.87628866,0.958762887,0.927835052,2925
b56ead31153dae3d0e6a7a3e296dc2ca0c468586,0,Jens Geyer,2017-07-07 20:51:00+02:00,['c34653f75106fbe20293ddfd5b07f74772891a6d'],3,3,6,1086862,1,,,,2925
5e9209ff0f740d9b39450f01dd30fd266d3e80f5,0,Jens Geyer,2017-07-08 15:35:42+02:00,['b56ead31153dae3d0e6a7a3e296dc2ca0c468586'],4,8,12,1086874,1,0,1,1,2925
0dd823580c78a79ae9696eb9b3650e400fff140f,0,Jens Geyer,2017-07-11 23:10:05+02:00,['5e9209ff0f740d9b39450f01dd30fd266d3e80f5'],39,23,62,1086936,1,0.842105263,0.789473684,0,2925
c0d384a38c2b43ee47cef86b1cd054e3f84dc909,1,Jens Geyer,2017-07-22 19:42:48+02:00,['0dd823580c78a79ae9696eb9b3650e400fff140f'],683,1520,2203,1089139,45,0.893617021,1,0.140425532,2940
5c302e02c40be558a21f3a82b53e527f7bec2ff2,1,Jens Geyer,2017-07-25 00:17:30+02:00,['c0d384a38c2b43ee47cef86b1cd054e3f84dc909'],114,294,408,1089547,18,0,1,1,2946
f790445d7c9c460b7daf5f46664124348899832b,1,Jens Geyer,2017-07-26 22:16:09+02:00,['5c302e02c40be558a21f3a82b53e527f7bec2ff2'],8,35,43,1089590,2,,,,2946
ed9e75f6256208fe2b1e39ff069b29ae73e8a937,0,Jens Geyer,2017-07-27 23:02:02+02:00,['f790445d7c9c460b7daf5f46664124348899832b'],2,0,2,1089592,1,,,,2946
3ba4ecf3e0a4e2b4fde0cc6e48f672d95d732ba5,0,Jens Geyer,2017-07-30 12:00:06+02:00,['ed9e75f6256208fe2b1e39ff069b29ae73e8a937'],2,2,4,1089596,1,,,,2946
ec2a252136cb864a9edb22ef895bd62ff29c53e1,0,Jens Geyer,2017-08-01 00:38:55+02:00,['3ba4ecf3e0a4e2b4fde0cc6e48f672d95d732ba5'],9,40,49,1089645,4,0,0,0,2947
0eda909573cc7d8550c285035652e8b883ebc8f7,1,Jens Geyer,2017-08-02 22:20:42+02:00,['ec2a252136cb864a9edb22ef895bd62ff29c53e1'],45,142,187,1089832,2,0.078431373,0.568627451,0.294117647,2947
e544a89924114ef11ba9af28ca7ad36583e54297,1,Jens Geyer,2017-08-05 14:04:21+02:00,['0eda909573cc7d8550c285035652e8b883ebc8f7'],17,126,143,1089975,6,,,,2949
808d143245f4f5c30600fab31cf9db854cbf5b48,1,Randy Abernethy,2017-08-06 16:36:36-07:00,['e544a89924114ef11ba9af28ca7ad36583e54297'],303,1581,1884,1091859,23,0.480836237,0.569686411,1,2955
0a8c34ceedf0f9272fb6d3519596ddf90cffcac2,0,Jens Geyer,2017-08-09 14:58:31+02:00,['808d143245f4f5c30600fab31cf9db854cbf5b48'],4,4,8,1091867,1,,,,2955
82ae9575cdc112088771fc7b876f75e1e4d85ebb,1,"James E. King, III",2017-08-10 13:27:21-04:00,['0a8c34ceedf0f9272fb6d3519596ddf90cffcac2'],1672,1762,3434,1095301,153,0,1,1,2956
2f03618a6c0a938813ca36e6a2fcd9f517a64ee0,0,"James E. King, III",2017-08-10 15:39:09-04:00,['82ae9575cdc112088771fc7b876f75e1e4d85ebb'],1,1,2,1095303,1,,,,2956
3f07967a791a0c15c36e832ebf183169f08067ce,0,"James E. King, III",2017-08-10 23:12:51-04:00,['2f03618a6c0a938813ca36e6a2fcd9f517a64ee0'],0,1,1,1095304,1,,,,2956
a718ad48378ebcf16fd64adebac7c6988136abbd,0,"James E. King, III",2017-08-10 23:21:30-04:00,['3f07967a791a0c15c36e832ebf183169f08067ce'],2,2,4,1095308,3,,,,2956
237a394add04ce02cc274836c0ec1c7260fdaadd,1,"James E. King, III",2017-08-12 16:15:59-07:00,['a718ad48378ebcf16fd64adebac7c6988136abbd'],11,27,38,1095346,3,0.909090909,0.909090909,1,2956
c60b69b37653a8a78728a8203cecb033faaf1962,0,"James E. King, III",2017-08-12 16:19:04-07:00,['237a394add04ce02cc274836c0ec1c7260fdaadd'],1,1,2,1095348,1,,,,2956
de112fbb0d7f2139ef107211e82e03b574f890d0,0,"James E. King, III",2017-08-12 16:23:06-07:00,['c60b69b37653a8a78728a8203cecb033faaf1962'],5,14,19,1095367,1,0,0,1,2956
20116c6c0c5e3db2b65bdfd974b64c3d741adb8b,1,"James E. King, III",2017-08-12 20:03:19-07:00,['de112fbb0d7f2139ef107211e82e03b574f890d0'],1,18,19,1095386,2,0.666666667,0.666666667,1,2956
ec64f23d236d7874e3b28ae86c833f57c7aa3389,1,"James E. King, III",2017-08-12 20:11:26-07:00,['20116c6c0c5e3db2b65bdfd974b64c3d741adb8b'],2,28,30,1095416,2,0,0.4,1,2956
b66b66ff52f2837adffc4ff931eabab5ae2809f1,1,"James E. King, III",2017-08-31 18:08:29-07:00,['ec64f23d236d7874e3b28ae86c833f57c7aa3389'],2,251,253,1095669,3,,,,2957
f454369198500a90388a4a6f73970e961949c186,0,"James E. King, III",2017-09-01 05:23:29-07:00,['b66b66ff52f2837adffc4ff931eabab5ae2809f1'],3,5,8,1095677,1,,,,2957
d7142b7e4fe114c13d8235a7c47f58947f916bff,1,"James E. King, III",2017-09-04 18:09:34-07:00,['f454369198500a90388a4a6f73970e961949c186'],1004,1803,2807,1098484,29,0,0,0.074626866,2960
722f8e95065aa19a1c5d9846f698d52e6d4d82fc,0,"James E. King, III",2017-09-04 18:22:03-07:00,['d7142b7e4fe114c13d8235a7c47f58947f916bff'],11,11,22,1098506,2,1,0,0,2960
113614b2e5fa60c0666212131155a05a97844691,0,"James E. King, III",2017-09-04 18:28:29-07:00,['722f8e95065aa19a1c5d9846f698d52e6d4d82fc'],1,1,2,1098508,1,,,,2960
9235bec082127e84bf1b0353a0764c9060aca6d2,0,"James E. King, III",2017-09-04 21:46:24-07:00,['113614b2e5fa60c0666212131155a05a97844691'],5,5,10,1098518,1,,,,2960
78b71851fc7ee797a80bbe925bc8cbff77cf339c,0,"James E. King, III",2017-09-05 13:19:39-07:00,['9235bec082127e84bf1b0353a0764c9060aca6d2'],2,4,6,1098524,1,0,0,1,2960
fcb2f5a8f4048cda9b72b76ec067d174e2690896,0,"James E. King, III",2017-09-05 13:43:46-07:00,['78b71851fc7ee797a80bbe925bc8cbff77cf339c'],13,13,26,1098550,3,,,,2960
1b20b18ec0a4d8eeb7f40566df5ef45a50d697c8,0,"James E. King, III",2017-09-05 20:00:38-07:00,['fcb2f5a8f4048cda9b72b76ec067d174e2690896'],2,16,18,1098568,2,1,1,1,2960
d862c2fd7b379a52f0fe9e63220a785f4c2bcc20,0,"James E. King, III",2017-09-05 21:33:42-07:00,['1b20b18ec0a4d8eeb7f40566df5ef45a50d697c8'],1,1,2,1098570,1,,,,2960
e9ede89c1c5a80ca782e965c1e2105d28872bed4,0,"James E. King, III",2017-09-06 21:19:42-07:00,['d862c2fd7b379a52f0fe9e63220a785f4c2bcc20'],13,25,38,1098608,1,0,0.333333333,0.333333333,2960
7d211b8d2dccf7788142d60e1f37e51f9f5391e6,0,"James E. King, III",2017-09-07 10:13:29-07:00,['e9ede89c1c5a80ca782e965c1e2105d28872bed4'],71,180,251,1098859,14,1,1,1,2960
811f73a66104647e89fdc864eb07b152f1cfa208,0,"James E. King, III",2017-09-07 10:20:17-07:00,['7d211b8d2dccf7788142d60e1f37e51f9f5391e6'],0,2,2,1098861,1,,,,2960
05c672b4d046a720b8de26eaea99f40c3342ed05,0,"James E. King, III",2017-09-07 10:31:35-07:00,['811f73a66104647e89fdc864eb07b152f1cfa208'],0,2,2,1098863,1,0,0,0,2960
f8e62fbe73409086a60cc19577dd80d1d38d345a,0,"James E. King, III",2017-09-07 10:53:36-07:00,['05c672b4d046a720b8de26eaea99f40c3342ed05'],6,5,11,1098874,2,,,,2960
17c3ad9c8a17c2375d2820859d8a85c02255a376,1,Jens Geyer,2017-09-07 22:14:00+02:00,['f8e62fbe73409086a60cc19577dd80d1d38d345a'],844,538,1382,1100256,14,,,,2960
a62efa4109c34c88d48f529a044e89ce854daa16,1,Jens Geyer,2017-09-07 22:25:50+02:00,['17c3ad9c8a17c2375d2820859d8a85c02255a376'],1,1,2,1100258,1,,,,2960
a76e6c7920f682c0da08e9f83df6758a68bc98d0,0,Jens Geyer,2017-09-08 23:55:01+02:00,['a62efa4109c34c88d48f529a044e89ce854daa16'],7,17,24,1100282,2,,,,2960
078281dcd3ff0d122711453f28ff8e62f44d11b6,1,Jens Geyer,2017-09-08 23:55:02+02:00,['a76e6c7920f682c0da08e9f83df6758a68bc98d0'],21,67,88,1100370,3,,,,2960
cc2d558e2de1cae2bee2276bf83c39acc3b5987e,0,"James E. King, III",2017-09-08 20:23:50-07:00,['078281dcd3ff0d122711453f28ff8e62f44d11b6'],1,95,96,1100466,3,0,0.833333333,1,2960
cf892d46f6c1b295d99705709364c42ae2dc0158,1,Jens Geyer,2017-09-09 10:11:10+02:00,['cc2d558e2de1cae2bee2276bf83c39acc3b5987e'],1,23,24,1100490,1,,,,2960
1744cdcb674a20c554ae9f23cb95c0c8eff63b90,0,"James E. King, III",2017-09-09 07:50:54-07:00,['cf892d46f6c1b295d99705709364c42ae2dc0158'],59,3,62,1100552,33,,,,2960
81cdcd3dd727908902ad3344fdd2261baf3a1d00,1,"James E. King, III",2017-09-13 19:36:00+00:00,['1744cdcb674a20c554ae9f23cb95c0c8eff63b90'],68,20,88,1100640,4,,,,2960
f26ce765d1fae325cd8db2734cd997f380fa60f9,1,"James E. King, III",2017-09-13 22:10:10-07:00,['81cdcd3dd727908902ad3344fdd2261baf3a1d00'],2,2,4,1100644,1,,,,2960
4c30c15924bfbc7c9e6bfc0e82630e97980e556e,0,"James E. King, III",2017-09-14 07:17:06-07:00,['f26ce765d1fae325cd8db2734cd997f380fa60f9'],11,13,24,1100668,1,,,,2960
04d983c14e4a7669e4bd2143ab546a301b36d279,0,Jens Geyer,2017-09-19 22:02:43+02:00,['4c30c15924bfbc7c9e6bfc0e82630e97980e556e'],0,2,2,1100670,1,0,1,1,2960
699b5bc47a90c47cf8954c4e8900af44990d1f0f,0,"James E. King, III",2017-09-21 07:02:51-07:00,['04d983c14e4a7669e4bd2143ab546a301b36d279'],18,31,49,1100719,8,,,,2960
faa2a3e3040fa5f329033900e7e654cdee10d272,0,"James E. King, III",2017-09-21 07:06:32-07:00,['699b5bc47a90c47cf8954c4e8900af44990d1f0f'],1,1,2,1100721,1,,,,2960
5310616b10b35ebd30cae74b282bc751e9982f9d,0,"James E. King, III",2017-09-21 07:08:04-07:00,['faa2a3e3040fa5f329033900e7e654cdee10d272'],2,2,4,1100725,2,,,,2960
cbd975924538ae76dee7aae366fd746bc1e5538e,0,"James E. King, III",2017-09-21 08:18:17-07:00,['5310616b10b35ebd30cae74b282bc751e9982f9d'],1,1,2,1100727,1,,,,2960
acbb616192381674c32b3d4ebb2abf4942e4416a,1,"James E. King, III",2017-09-21 08:25:44-07:00,['cbd975924538ae76dee7aae366fd746bc1e5538e'],29,32,61,1100788,2,0,0,1,2960
ac61a4211204ec2785362fc325b500d805ae2bba,1,"James E. King, III",2017-09-21 09:09:20-07:00,['acbb616192381674c32b3d4ebb2abf4942e4416a'],2,9,11,1100799,1,0,0.5,0.5,2960
12fcb0d30ed1f45b09a31616cd867e9926bf5a05,0,"James E. King, III",2017-09-21 09:20:46-07:00,['ac61a4211204ec2785362fc325b500d805ae2bba'],1,1,2,1100801,1,,,,2960
69603709edfcbdca829a275f2acc553fb898fdde,1,"James E. King, III",2017-09-21 09:54:47-07:00,['12fcb0d30ed1f45b09a31616cd867e9926bf5a05'],12,143,155,1100956,4,0.246376812,0.84057971,1,2960
8506121b3eaeca998ab562bd76ef8a1fbf2f36a4,0,"James E. King, III",2017-09-21 10:03:00-07:00,['69603709edfcbdca829a275f2acc553fb898fdde'],3,20,23,1100979,1,0,0,0.571428571,2960
9ffb41d94c1c48c3b2a0ce8bdbd03d8b8f97195b,0,"James E. King, III",2017-09-21 12:48:48-07:00,['8506121b3eaeca998ab562bd76ef8a1fbf2f36a4'],39,115,154,1101133,2,0,0.351851852,1,2960
d3cda9c2f3930b11eeda52ca32bc8f1b08f9c147,1,"James E. King, III",2017-09-21 13:57:09-07:00,['9ffb41d94c1c48c3b2a0ce8bdbd03d8b8f97195b'],16,246,262,1101395,5,0.325396825,0.476190476,0.634920635,2962
28eb9d98efcdf64182f5ffc9b33cfd23b0cb28e1,0,"James E. King, III",2017-09-21 14:55:50-07:00,['d3cda9c2f3930b11eeda52ca32bc8f1b08f9c147'],0,3,3,1101398,1,1,1,1,2962
2d8b17890cf67032e9cb0da21eea940a265261ff,0,"James E. King, III",2017-09-22 05:30:22-07:00,['28eb9d98efcdf64182f5ffc9b33cfd23b0cb28e1'],1,2,3,1101401,1,,,,2962
9462edb06eab38a180eb83277d08d377402775d5,0,"James E. King, III",2017-09-22 08:00:47-07:00,['2d8b17890cf67032e9cb0da21eea940a265261ff'],6,13,19,1101420,3,,,,2963
4a6bff1c5bd7eabe71966454d90dddeb48ed4d37,0,"James E. King, III",2017-09-22 10:11:06-07:00,['9462edb06eab38a180eb83277d08d377402775d5'],0,4,4,1101424,1,0,1,1,2963
d3013f3fb5d83e201723cd97cab49d8203037c0d,0,"James E. King, III",2017-09-22 15:15:30-07:00,['4a6bff1c5bd7eabe71966454d90dddeb48ed4d37'],0,9,9,1101433,2,1,1,1,2963
aded00b617d46a43f8da045e914574bf471d2473,1,"James E. King, III",2017-09-22 15:17:25-07:00,['d3013f3fb5d83e201723cd97cab49d8203037c0d'],10,74,84,1101517,3,0.975609756,1,0.975609756,2963
c8e0207053a26f206d6515313747b7e1999a01d5,0,"James E. King, III",2017-09-23 06:11:34-07:00,['aded00b617d46a43f8da045e914574bf471d2473'],31,86,117,1101634,8,0.647058824,1,1,2963
eb7b76d32c425f19d49d056d972cd20a9661a6d1,0,"James E. King, III",2017-09-23 20:35:29-07:00,['c8e0207053a26f206d6515313747b7e1999a01d5'],1,2,3,1101637,1,,,,2963
9ce1fd9aee00e15abcd81b671594881ee9e1e5c3,1,"James E. King, III",2017-09-24 05:59:35-07:00,['eb7b76d32c425f19d49d056d972cd20a9661a6d1'],1,4,5,1101642,2,0,0,0.666666667,2963
4bd3682c79bcbd793f066bfab4d9bb1c1437b722,0,"James E. King, III",2017-09-24 06:04:15-07:00,['9ce1fd9aee00e15abcd81b671594881ee9e1e5c3'],21,17,38,1101680,3,1,1,1,2963
a17ef79e8f737b16349ed2155f938bf612303bc3,0,"James E. King, III",2017-09-24 20:32:56-07:00,['4bd3682c79bcbd793f066bfab4d9bb1c1437b722'],8,13,21,1101701,1,0,0,1,2963
48ba736a5800c0abc3b136ec478cf856f856ffcc,1,"James E. King, III",2017-09-24 20:35:01-07:00,['a17ef79e8f737b16349ed2155f938bf612303bc3'],10,23,33,1101734,2,0.733333333,0.733333333,1,2963
2d1fe88db3f02c0a3a8f9cc2ad2f5f7881a0eae3,0,"James E. King, III",2017-09-25 17:11:33-07:00,['48ba736a5800c0abc3b136ec478cf856f856ffcc'],2,6,8,1101742,2,,,,2963
d7720f43632f004df09686faa2f238bcc7f1f706,0,"James E. King, III",2017-09-26 06:42:14-07:00,['2d1fe88db3f02c0a3a8f9cc2ad2f5f7881a0eae3'],0,10,10,1101752,1,,,,2963
65efdff10b28fffec8557942d8a0251587d0d3ab,0,"James E. King, III",2017-09-26 06:48:54-07:00,['d7720f43632f004df09686faa2f238bcc7f1f706'],64,75,139,1101891,4,,,,2963
e8fbd8c3d559a26242e3fece09dda82551cd1a28,0,"James E. King, III",2017-09-26 06:59:34-07:00,['65efdff10b28fffec8557942d8a0251587d0d3ab'],34,76,110,1102001,1,,,,2963
39310dad793ca69b4b7217a3b54430e682e5e2a4,0,"James E. King, III",2017-09-27 12:46:19-07:00,['e8fbd8c3d559a26242e3fece09dda82551cd1a28'],2,46,48,1102049,2,1,1,1,2963
9f9e30b51e3912c0b63258badf5501d3cb2550be,0,"James E. King, III",2017-10-06 05:22:13-07:00,['39310dad793ca69b4b7217a3b54430e682e5e2a4'],5,23,28,1102077,1,0,0,1,2963
b62873686f631e157accd5d5c925421e1ea3f932,1,"James E. King, III",2017-10-10 08:35:48-07:00,['9f9e30b51e3912c0b63258badf5501d3cb2550be'],621,361,982,1103059,46,0,0,1,2970
8b8a8efea13d1c97f856053af0a5c0e6a8a76354,0,"James E. King, III",2017-10-10 08:46:46-07:00,['b62873686f631e157accd5d5c925421e1ea3f932'],6,5,11,1103070,1,0,0,1,2970
0ad20bdbfe9abcbb0cc5332ff95651b5c975da91,1,"James E. King, III",2017-10-19 11:29:04-04:00,['8b8a8efea13d1c97f856053af0a5c0e6a8a76354'],498,1726,2224,1105294,66,0.375,0.75,0.5,2982
44701e82ad351d7472101ad81aa13e775ffb7384,0,Jens Geyer,2017-10-19 23:16:32+02:00,['0ad20bdbfe9abcbb0cc5332ff95651b5c975da91'],1,1,2,1105296,1,,,,2982
54ce558ba80905d124b82727d196f6d58964b74c,0,"James E. King, III",2017-10-20 08:33:38-04:00,['44701e82ad351d7472101ad81aa13e775ffb7384'],2,2,4,1105300,1,,,,2982
cd5be7be702bac300a658184fa0b496debdfee72,0,"James E. King, III",2017-10-23 14:13:46-04:00,['54ce558ba80905d124b82727d196f6d58964b74c'],60,38,98,1105398,5,,,,2982
ba5e065aaa0e1f9a3d0174a5c287fff09ad2f3a7,0,"James E. King, III",2017-10-23 14:49:13-04:00,['cd5be7be702bac300a658184fa0b496debdfee72'],7,21,28,1105426,1,1,0.7,1,2982
e7611d0f3ed1704711f58ff45f331db6748dfbb5,0,"James E. King, III",2017-10-23 16:44:45-04:00,['ba5e065aaa0e1f9a3d0174a5c287fff09ad2f3a7'],2,2,4,1105430,1,,,0,2982
a39ba7f2946c08fa59dd0928e9c608a70ca52529,0,"James E. King, III",2017-10-25 08:40:51-04:00,['e7611d0f3ed1704711f58ff45f331db6748dfbb5'],0,1,1,1105431,1,1,1,1,2982
1df2d9b801553a1addc1df112bedde09527dbfdd,1,"James E. King, III",2017-10-25 08:56:40-04:00,['a39ba7f2946c08fa59dd0928e9c608a70ca52529'],0,90,90,1105521,3,0,0,0.955882353,2982
9dff0efc1e099a67e386c95bddc4079daf2b7141,1,"James E. King, III",2017-10-25 08:57:04-04:00,['1df2d9b801553a1addc1df112bedde09527dbfdd'],1698,596,2294,1107815,5,0.751879699,0.64160401,0.454887218,2982
254e86b0103be51c6af9cc50220ee8c144234239,0,"James E. King, III",2017-10-25 09:02:51-04:00,['9dff0efc1e099a67e386c95bddc4079daf2b7141'],0,1,1,1107816,1,,,,2982
350fe7531feecf7df5208fa19d25730c6ce0a30d,1,"James E. King, III",2017-10-26 11:37:02-04:00,['254e86b0103be51c6af9cc50220ee8c144234239'],11,25,36,1107852,6,,,,2982
e54945551f7fcd7d7decc959871f370b489f7fa0,0,"James E. King, III",2017-10-26 12:02:20-04:00,['350fe7531feecf7df5208fa19d25730c6ce0a30d'],0,2,2,1107854,1,,,,2982
d4df91709b724174aaf8a957f3edac3573be354e,1,Jens Geyer,2017-10-26 20:36:28+02:00,['e54945551f7fcd7d7decc959871f370b489f7fa0'],136,207,343,1108197,6,0.388888889,0.388888889,0.222222222,2982
43f4bf2fdd13c7466e3fea690d436c6a9540f303,1,"James E. King, III",2017-10-28 16:44:09-04:00,['d4df91709b724174aaf8a957f3edac3573be354e'],943,941,1884,1110081,21,1,1,0.428571429,2982
5a4f7382d2c37231693890be11c6faaec495194a,0,"James E. King, III",2017-10-28 17:54:17-04:00,['43f4bf2fdd13c7466e3fea690d436c6a9540f303'],3,6,9,1110090,1,1,1,1,2982
375bfee701d3caa74074f8afb3d6940e52c45c88,1,"James E. King, III",2017-10-28 17:54:58-04:00,['5a4f7382d2c37231693890be11c6faaec495194a'],11,193,204,1110294,11,,,,2982
533405e3f85f2925aa1028fc3534e988e5debd32,0,"James E. King, III",2017-10-29 07:05:47-04:00,['375bfee701d3caa74074f8afb3d6940e52c45c88'],82,92,174,1110468,14,1,0,0,2982
619218cd7f3e7c5e433aed4734f3108bc8492b00,0,"James E. King, III",2017-10-29 10:15:10-04:00,['533405e3f85f2925aa1028fc3534e988e5debd32'],111,109,220,1110688,5,,,,2982
ac11cf88f852789d699415ec0c2c0e26bfd71ec2,1,Jens Geyer,2017-10-29 17:52:48+01:00,['619218cd7f3e7c5e433aed4734f3108bc8492b00'],0,5,5,1110693,1,,,,2982
a533ea1615e9df935e77b99440cf264c6b417e3e,0,"James E. King, III",2017-10-30 15:12:16-04:00,['ac11cf88f852789d699415ec0c2c0e26bfd71ec2'],2,10,12,1110705,2,,,,2982
847ecf3c1de8b297d6a29305b9f7871fcf609c36,0,"James E. King, III",2017-11-02 05:53:09-07:00,['a533ea1615e9df935e77b99440cf264c6b417e3e'],3,8,11,1110716,1,1,1,1,2982
4f77ab8e296d64c57e6ea1c6e3f0f152bc7d6a3a,1,"James E. King, III",2017-11-03 18:21:40-07:00,['847ecf3c1de8b297d6a29305b9f7871fcf609c36'],291,545,836,1111552,15,0,0.733695652,0.668478261,2985
cfb0130a75987e73c86a4e9269f23c3d7d0cb54c,0,"James E. King, III",2017-11-11 09:40:02-05:00,['4f77ab8e296d64c57e6ea1c6e3f0f152bc7d6a3a'],7,62,69,1111621,2,,,,2985
388738d3317797b6856c40a0c46768bd2f831967,0,"James E. King, III",2017-11-11 09:47:01-05:00,['cfb0130a75987e73c86a4e9269f23c3d7d0cb54c'],0,6,6,1111627,1,,,,2985
ad2ea3daa9907433251148a4b719f5a51a060213,0,"James E. King, III",2017-11-11 09:49:13-05:00,['388738d3317797b6856c40a0c46768bd2f831967'],1,3,4,1111631,1,,,,2985
95d5fb3a1e38125b9eabcbe9cda1a6c7bbe3e93d,0,"James E. King, III",2017-11-11 09:51:14-05:00,['ad2ea3daa9907433251148a4b719f5a51a060213'],3,3,6,1111637,1,,,,2985
87ad2bcaaa5a9fe224ad7a9826b676ca9721ddd1,1,"James E. King, III",2017-11-18 21:10:18-05:00,['95d5fb3a1e38125b9eabcbe9cda1a6c7bbe3e93d'],797,1896,2693,1114330,24,0.183887916,0.623467601,0.495621716,2991
58402ff6a71f00f9d61a9676bdabd3e5bbe9ea3f,1,"James E. King, III",2017-11-18 21:10:40-05:00,['87ad2bcaaa5a9fe224ad7a9826b676ca9721ddd1'],241,431,672,1115002,23,0,0,0,2991
6e883f9d2307b00ca76aa28c286f28d8741a8197,1,"James E. King, III",2017-11-20 07:26:52-05:00,['58402ff6a71f00f9d61a9676bdabd3e5bbe9ea3f'],15,17,32,1115034,3,,,,2991
39eaae6675f01ff844b35c04ebd50090dc413624,1,"James E. King, III",2017-11-20 07:27:03-05:00,['6e883f9d2307b00ca76aa28c286f28d8741a8197'],113,133,246,1115280,9,1,1,0,2991
cde4d4181a252323d87e7ac086ce495cd1227c5c,0,"James E. King, III",2017-11-20 07:34:01-05:00,['39eaae6675f01ff844b35c04ebd50090dc413624'],2,3,5,1115285,1,0,0,1,2991
20e16bc6a41c6faead040aed7f3c00b9d2e7f842,1,"James E. King, III",2017-11-21 14:20:26-05:00,['cde4d4181a252323d87e7ac086ce495cd1227c5c'],16,107,123,1115408,7,0,1,1,2991
44426c90955ee1324be58d228e654b309d7c5bba,0,"James E. King, III",2017-11-29 21:29:48-05:00,['20e16bc6a41c6faead040aed7f3c00b9d2e7f842'],8,8,16,1115424,4,,,,2991
35f987d45b2d4e03f3047a923f40fbb54c9e67eb,0,"James E. King, III",2017-11-29 21:37:18-05:00,['44426c90955ee1324be58d228e654b309d7c5bba'],6,6,12,1115436,1,,,,2991
1ce7a5b459c47d6c960850a8a97eacc53a851452,0,"James E. King, III",2017-11-30 12:32:17-05:00,['35f987d45b2d4e03f3047a923f40fbb54c9e67eb'],0,1,1,1115437,1,,,,2991
6f8264037c138b5042cbdbe8a444c2cff6065ee6,1,"James E. King, III",2017-11-30 12:36:11-05:00,['1ce7a5b459c47d6c960850a8a97eacc53a851452'],53,75,128,1115565,2,0.08,0.08,1,2991
66c3dbf2dec91718922e815c50a55900b78a58e1,0,"James E. King, III",2017-11-30 12:36:33-05:00,['6f8264037c138b5042cbdbe8a444c2cff6065ee6'],29,48,77,1115642,2,0.15,0.15,1,2991
af562863781ee9a4e0f314470701f1ab2e3fbe33,0,"James E. King, III",2017-11-30 12:36:52-05:00,['66c3dbf2dec91718922e815c50a55900b78a58e1'],23,27,50,1115692,1,0,0,1,2991
1541f0a74d6b1f85b9658f8f65a46ed19b57f657,0,"James E. King, III",2017-11-30 12:41:35-05:00,['af562863781ee9a4e0f314470701f1ab2e3fbe33'],1,1,2,1115694,1,,,,2991
026c9d032c4a298ecb9edbcdfb52590facb442f3,0,"James E. King, III",2017-11-30 12:43:26-05:00,['1541f0a74d6b1f85b9658f8f65a46ed19b57f657'],18,27,45,1115739,2,0,0,0,2991
214746619a6e44d8b3cc7394f3303e7bdf78c442,0,Jens Geyer,2017-11-30 20:46:39+01:00,['026c9d032c4a298ecb9edbcdfb52590facb442f3'],5,13,18,1115757,5,,,,2991
3c420072ab5388c2c00d15ada72aec5b061c4d4d,1,"James E. King, III",2017-11-30 16:15:25-05:00,['214746619a6e44d8b3cc7394f3303e7bdf78c442'],141,690,831,1116588,15,,0,,2993
152d1bef44853601d88d51e616387accfbc675a3,0,Jens Geyer,2017-12-01 09:08:00+01:00,['3c420072ab5388c2c00d15ada72aec5b061c4d4d'],7,23,30,1116618,1,,,,2993
f3a2974dfe63b3a551b422868f3990112bda5bd8,1,Jens Geyer,2017-12-01 23:01:41+01:00,['152d1bef44853601d88d51e616387accfbc675a3'],37,78,115,1116733,15,,,,2993
1c7bf3ebc43b8f2f2a800f6ed43643d001e12040,0,Jens Geyer,2017-12-01 23:13:19+01:00,['214746619a6e44d8b3cc7394f3303e7bdf78c442'],37,78,115,1116848,15,,,,2993
1310dc1eb4014457a667a7287d1fa113432c7a54,1,Jens Geyer,2017-12-01 23:13:19+01:00,['1c7bf3ebc43b8f2f2a800f6ed43643d001e12040'],76,404,480,1117328,60,,,,2993
d30a7d15991f38a9245ae3c3817df166dc260bbf,0,Jens Geyer,2017-12-02 17:17:48+01:00,['f3a2974dfe63b3a551b422868f3990112bda5bd8'],5,4,9,1117337,1,,,,2993
fc0ff81ee7d4aa95a041c826dd5a83239ef98780,0,Jens Geyer,2017-12-03 17:45:33+01:00,['1310dc1eb4014457a667a7287d1fa113432c7a54'],141,690,831,1118168,15,,0,,2995
327ebb6c2b6df8bf075da02ef45a2a034e9b79ba,0,Jens Geyer,2017-12-03 18:27:58+01:00,['fc0ff81ee7d4aa95a041c826dd5a83239ef98780'],14,1,15,1118183,1,,,,2995
05a08ce9c177ffbe8c395fdc9e8f5a4c5daef02c,0,"James E. King, III",2017-12-04 11:03:38-05:00,['d30a7d15991f38a9245ae3c3817df166dc260bbf'],2,2,4,1118187,1,,,,2995
2590988c02ac6c500266a802d3fe1bd25057e04b,0,"James E. King, III",2017-12-09 12:25:00-05:00,['05a08ce9c177ffbe8c395fdc9e8f5a4c5daef02c'],0,1,1,1118188,1,,,,2995
c4af63385f06f501e012712c747379eb33f273af,0,"James E. King, III",2017-12-09 16:53:57-05:00,['2590988c02ac6c500266a802d3fe1bd25057e04b'],4,7,11,1118199,2,,,,2995
8101f00b0966deebd36a6ba658aa59d718453345,1,"James E. King, III",2017-12-09 17:02:12-05:00,['c4af63385f06f501e012712c747379eb33f273af'],1,86,87,1118286,4,,,,2997
cea50758b9e5165b14508c3ded3834480e97f2b8,0,"James E. King, III",2017-12-12 18:42:45-05:00,['8101f00b0966deebd36a6ba658aa59d718453345'],4,15,19,1118305,1,,,,2997
14f5d500b9ae0fb6654aec9009a8bc34a8bb6dfb,1,Jens Geyer,2017-12-14 00:00:03+01:00,['cea50758b9e5165b14508c3ded3834480e97f2b8'],61,172,233,1118538,2,0.115384615,0.423076923,0.711538462,2997
041c3c777db9639b0a9195bc6aa1f935501fd506,0,"James E. King, III",2017-12-14 08:49:40-05:00,['14f5d500b9ae0fb6654aec9009a8bc34a8bb6dfb'],0,8,8,1118546,2,0,0.5,1,2997
0a84eae1db28abb5e3ee730e8fa40a154c6e1097,1,"James E. King, III",2017-12-28 07:57:36-05:00,['041c3c777db9639b0a9195bc6aa1f935501fd506'],10,5,15,1118561,2,0,0,0,2997
e669b8726b78f71b81a20c921f44ed24702c3b85,0,"James E. King, III",2018-01-04 09:11:16-05:00,['0a84eae1db28abb5e3ee730e8fa40a154c6e1097'],231,0,231,1118792,1,,,,2997
8fdd610ba7bea0f248e7dba3b4d4adea987499b7,1,"James E. King, III",2018-01-04 09:15:24-05:00,['e669b8726b78f71b81a20c921f44ed24702c3b85'],16,536,552,1119344,6,0.698254364,0.802992519,0.985037406,2999
c72d8dcb42d701db0f67a519c705561806273b7a,0,"James E. King, III",2018-01-04 09:17:55-05:00,['8fdd610ba7bea0f248e7dba3b4d4adea987499b7'],12,6,18,1119362,1,,,,2999
dda41f37cf629293f9a781b9a2b408dc9b0a5d99,0,"James E. King, III",2018-01-04 09:28:19-05:00,['c72d8dcb42d701db0f67a519c705561806273b7a'],1,1,2,1119364,1,,,,2999
1b855d47aab32dc89e6e4271e8ac8872b049e1ba,0,"James E. King, III",2018-01-04 09:38:41-05:00,['dda41f37cf629293f9a781b9a2b408dc9b0a5d99'],0,2,2,1119366,1,,,,2999
d3355af2600cad80734066a57c03dc9b59064d85,0,"James E. King, III",2018-01-10 21:09:39-05:00,['1b855d47aab32dc89e6e4271e8ac8872b049e1ba'],0,11,11,1119377,1,1,1,1,2999
d066fa850a43859d829ff2f4a1678404cc44596d,0,"James E. King, III",2018-01-10 21:13:07-05:00,['d3355af2600cad80734066a57c03dc9b59064d85'],14,1,15,1119392,2,1,1,0,2999
080e43ee8e279753c919e08d3aab62a8c5ed4b99,0,"James E. King, III",2018-01-10 21:17:19-05:00,['d066fa850a43859d829ff2f4a1678404cc44596d'],6,14,20,1119412,1,0,0,1,2999
91c74b6019115606284b57c48e13da41206db876,1,"James E. King, III",2018-01-10 21:21:03-05:00,['080e43ee8e279753c919e08d3aab62a8c5ed4b99'],1,75,76,1119488,2,0.136986301,0.136986301,1,2999
ad08a8b168d95b30ca6b81ff4e6eeb62b24ce9c6,0,"James E. King, III",2018-01-10 23:40:18-05:00,['91c74b6019115606284b57c48e13da41206db876'],26,319,345,1119833,6,0.417391304,0.556521739,1,3001
6ae4023052d9a6751a2de8bbea21ec392ceb4e62,0,"James E. King, III",2018-01-10 23:45:56-05:00,['ad08a8b168d95b30ca6b81ff4e6eeb62b24ce9c6'],16,111,127,1119960,7,1,1,1,3003
19a6493ff03ee335cabe109ea6831366f3d7a701,0,"James E. King, III",2018-01-10 23:49:29-05:00,['6ae4023052d9a6751a2de8bbea21ec392ceb4e62'],11,19,30,1119990,3,1,0,1,3003
a15060acd81d72fa364a7aab327aa8c41d02958f,0,"James E. King, III",2018-01-11 09:37:37-05:00,['19a6493ff03ee335cabe109ea6831366f3d7a701'],67,88,155,1120145,15,,,,3004
cf7ba4ca32a4a4a95cc30173827000c1f8d74fcc,0,"James E. King, III",2018-01-12 08:06:59-05:00,['a15060acd81d72fa364a7aab327aa8c41d02958f'],34,59,93,1120238,4,0,1,1,3004
31d5b7be27dc6010ded49ab943b51a87f1298967,1,"James E. King, III",2018-01-12 15:04:03-05:00,['cf7ba4ca32a4a4a95cc30173827000c1f8d74fcc'],32,46,78,1120316,3,,,,3004
85827154b44184397c11a302ed175cfa4d3dec09,1,Jens Geyer,2018-01-13 21:36:46+01:00,['31d5b7be27dc6010ded49ab943b51a87f1298967'],51,54,105,1120421,2,,,,3004
1d5113ed7596f9480905fce37b1a53395c3b29b9,0,Jens Geyer,2018-01-14 11:53:29+01:00,['85827154b44184397c11a302ed175cfa4d3dec09'],83,116,199,1120620,2,0,0,1,3004
9a32f8af3a02c994fc7f0f281b30caaeda20768d,1,James E. King III,2018-01-14 08:36:18-05:00,['1d5113ed7596f9480905fce37b1a53395c3b29b9'],2,2,4,1120624,2,,,,3004
54993296c413ad0ba295148af5a905d11d671ce9,1,James E. King III,2018-01-14 08:39:32-05:00,['9a32f8af3a02c994fc7f0f281b30caaeda20768d'],1795,15983,17778,1138402,90,0.351154313,0.974483597,0.964763062,3036
b56fc700d6ff3086c4704c5c4cae3c8ec2a06228,1,James E. King III,2018-01-14 08:41:10-05:00,['54993296c413ad0ba295148af5a905d11d671ce9'],44,30,74,1138476,3,,,,3036
ad238522946a69ebebb310e2e8e9479a3f6a613c,0,James E. King III,2018-01-14 08:42:28-05:00,['b56fc700d6ff3086c4704c5c4cae3c8ec2a06228'],11,13,24,1138500,3,,,,3036
f64a3fcaf9ae03b94b6b462168eb6f990f71084e,0,James E. King III,2018-01-14 08:54:25-05:00,['ad238522946a69ebebb310e2e8e9479a3f6a613c'],2,2,4,1138504,2,,,,3036
bfba370bf163425823ce7b660f9d123f5fc67c79,1,James E. King III,2018-01-16 09:22:42-05:00,['f64a3fcaf9ae03b94b6b462168eb6f990f71084e'],79,75,154,1138658,66,,,,3036
36c0b34dadca42feb1b89af35da494ab6f344d96,0,Jens Geyer,2018-01-19 19:21:56+01:00,['bfba370bf163425823ce7b660f9d123f5fc67c79'],5,13,18,1138676,1,,,,3036
b636ffb613ab49e0f037fbe696d28a4b17a72c5f,0,Jens Geyer,2018-01-19 19:21:57+01:00,['36c0b34dadca42feb1b89af35da494ab6f344d96'],4,3,7,1138683,1,,,,3036
52bf20c0daa0ba902421e6212be367cb294c43b3,0,James E. King III,2018-01-23 19:12:15-05:00,['b636ffb613ab49e0f037fbe696d28a4b17a72c5f'],2,2,4,1138687,1,,,,3036
8d96b3bbddb27aa4512031e0c923fe4c6865db07,0,James E. King III,2018-01-23 19:52:51-05:00,['52bf20c0daa0ba902421e6212be367cb294c43b3'],1,1,2,1138689,1,,,,3036
b03ca01cc9c46fc835174ab13b5a09f9cbf82249,1,James E. King III,2018-01-24 00:07:54-05:00,['8d96b3bbddb27aa4512031e0c923fe4c6865db07'],4117,4234,8351,1147040,48,0.0625,0.223958333,0.947916667,3037
e241265cb2ac7cbab2fd46bda52638da3a989d51,0,James E. King III,2018-01-24 00:08:23-05:00,['b03ca01cc9c46fc835174ab13b5a09f9cbf82249'],135,236,371,1147411,2,0.057142857,0.1,0.585714286,3037
00646bbba7a2101f0ad2938d2e37cb83abbfb3c7,0,James E. King III,2018-01-24 00:10:42-05:00,['e241265cb2ac7cbab2fd46bda52638da3a989d51'],1,1,2,1147413,1,,,,3037
f92493b8574a00830d665c5bfac7e0a8175bcb4f,0,James E. King III,2018-01-24 00:12:30-05:00,['00646bbba7a2101f0ad2938d2e37cb83abbfb3c7'],0,5,5,1147418,1,,,,3037
7004a61e44fe538805b44c3fb66bd5cb872548d4,1,James E. King III,2018-01-24 12:28:55-05:00,['f92493b8574a00830d665c5bfac7e0a8175bcb4f'],1252,2201,3453,1150871,40,,,,3057
23dde8c446bb635ff3d65752b278226d3cd7bc65,0,James E. King III,2018-01-24 14:56:29-05:00,['7004a61e44fe538805b44c3fb66bd5cb872548d4'],2,3,5,1150876,1,,,,3057
3d556248a8b97310da49939195330691dfe9d9ad,0,Jens Geyer,2018-01-26 00:10:06+01:00,['23dde8c446bb635ff3d65752b278226d3cd7bc65'],14,7,21,1150897,13,,,,3057
12f124c19a1a9f00c1979dbd2d5aac6f01c0e248,0,James E. King III,2018-01-29 15:44:43-05:00,['3d556248a8b97310da49939195330691dfe9d9ad'],1256,1380,2636,1153533,15,1,1,1,3064
2471efab00fbbb674f1aba321ea466f6a86e38b6,0,James E. King III,2018-01-30 07:49:20-05:00,['12f124c19a1a9f00c1979dbd2d5aac6f01c0e248'],13,41,54,1153587,3,,,,3064
f338d576b715ddf1384eedbe301169eea74ea073,0,James E. King III,2018-01-30 07:53:35-05:00,['2471efab00fbbb674f1aba321ea466f6a86e38b6'],47,46,93,1153680,7,,,,3064
5089b0a7b593c4ff97e56bbd2a5bd6823cfcddd8,0,Jens Geyer,2018-02-02 14:20:38+01:00,['f338d576b715ddf1384eedbe301169eea74ea073'],24,60,84,1153764,2,,,,3064
00645162ba1e73ea4fd6e7a47cecf910a29b3281,0,Jens Geyer,2018-02-02 14:21:18+01:00,['5089b0a7b593c4ff97e56bbd2a5bd6823cfcddd8'],6,12,18,1153782,1,,,,3064
33d30fcbb91558068a4012e2444b01385fdd338c,0,Jens Geyer,2018-02-08 18:22:32+01:00,['00645162ba1e73ea4fd6e7a47cecf910a29b3281'],20,35,55,1153837,1,,,,3064
35d62edd6e9ff84b0fdd472e132a739b663a41c2,0,Jens Geyer,2018-02-10 19:24:18+01:00,['33d30fcbb91558068a4012e2444b01385fdd338c'],0,5,5,1153842,1,,,,3064
d907cc92db5b93e699a4282e979d097ea863215a,0,James E. King III,2018-02-17 11:20:07-05:00,['35d62edd6e9ff84b0fdd472e132a739b663a41c2'],41,40,81,1153923,8,,,,3064
e93a90171529625966294fb35eaebf35cf4c6ba7,1,James E. King III,2018-03-02 13:44:50-05:00,['d907cc92db5b93e699a4282e979d097ea863215a'],4,1906,1910,1155833,33,0.334231806,0.471698113,0.822102426,3082
bf7f76bb1f1864fdbbf30ac50715920afbc4a91d,1,James E. King III,2018-03-02 13:48:08-05:00,['e93a90171529625966294fb35eaebf35cf4c6ba7'],40,37,77,1155910,5,,,,3082
6aa4c0f448d8f2573d2abcc8c3724bd18b3f8d1d,0,James E. King III,2018-03-02 16:15:18-05:00,['bf7f76bb1f1864fdbbf30ac50715920afbc4a91d'],8,2,10,1155920,2,,,,3082
641b139fd60649b588beb10b58a1c483b0ee5685,0,James E. King III,2018-03-03 12:01:19-05:00,['6aa4c0f448d8f2573d2abcc8c3724bd18b3f8d1d'],5,9,14,1155934,4,,,,3082
8de4bb9c803461811094284486fa5cf402764589,0,James E. King III,2018-03-03 13:15:03-05:00,['641b139fd60649b588beb10b58a1c483b0ee5685'],3,2,5,1155939,1,,,,3082
3b87c71ccba661ec40248005aa9f430f5a105271,0,James E. King III,2018-03-03 13:20:04-05:00,['8de4bb9c803461811094284486fa5cf402764589'],12,38,50,1155989,1,0,0,1,3082
55ddf19cca0dc9f56a974ff5740c21703ab9c4e1,0,James E. King III,2018-03-05 08:20:14-05:00,['3b87c71ccba661ec40248005aa9f430f5a105271'],11,27,38,1156027,3,0,1,1,3082
9e0c9272140ea91ea4b3f042d207acbbaa15c093,0,James E. King III,2018-03-05 08:26:15-05:00,['55ddf19cca0dc9f56a974ff5740c21703ab9c4e1'],1,4,5,1156032,1,,,,3082
d973409661f820d80d72c0034d06a12348c8705e,0,James E. King III,2018-03-05 12:00:22-05:00,['9e0c9272140ea91ea4b3f042d207acbbaa15c093'],3,1,4,1156036,1,1,1,0,3082
fed99350eeeaff11b687b11c26cff4cad0ce86fe,0,James E. King III,2018-03-05 13:25:07-05:00,['d973409661f820d80d72c0034d06a12348c8705e'],3,30,33,1156069,1,,,,3082
0eb0b77a3b01145162db45ed7d38422079326854,0,James E. King III,2018-03-05 13:33:56-05:00,['fed99350eeeaff11b687b11c26cff4cad0ce86fe'],5,5,10,1156079,1,,,,3082
78755f5297ae931b1f2268e9215d041dc4c0dcc7,1,James E. King III,2018-03-06 09:53:12-05:00,['0eb0b77a3b01145162db45ed7d38422079326854'],22,10,32,1156111,3,,,,3082
14991f904184cc57b5d3e74a4266a0d6fbaf4832,0,James E. King III,2018-03-06 09:53:21-05:00,['78755f5297ae931b1f2268e9215d041dc4c0dcc7'],0,1,1,1156112,1,1,1,1,3082
a37feafd42543b9a4b3192a4a9478b93e7308a24,1,James E. King III,2018-03-06 16:16:45-05:00,['14991f904184cc57b5d3e74a4266a0d6fbaf4832'],94,82,176,1156288,7,,,,3082
860a5f1ff828d395397c643a1f694e7bdd9729b0,1,James E. King III,2018-03-06 18:17:41-05:00,['a37feafd42543b9a4b3192a4a9478b93e7308a24'],144,330,474,1156762,19,,,,3085
b4f22ff30119ea5cadf9b16e97afdcabefe06696,0,James E. King III,2018-03-06 18:27:59-05:00,['860a5f1ff828d395397c643a1f694e7bdd9729b0'],2,3,5,1156767,1,1,1,0,3085
b963e286b4c847dd2692fdf8b025e35263b13e29,0,James E. King III,2018-03-08 11:55:08-05:00,['b4f22ff30119ea5cadf9b16e97afdcabefe06696'],61,0,61,1156828,3,0,0,0,3085
138da2049020fe66e51f8adb456cdd2bd8d5e502,0,James E. King III,2018-03-08 17:14:24-05:00,['b963e286b4c847dd2692fdf8b025e35263b13e29'],2,2,4,1156832,1,,,,3085
50862915ccfd5512e9982d2b75a3df99c5e7cdd3,0,James E. King III,2018-03-09 17:59:21-05:00,['138da2049020fe66e51f8adb456cdd2bd8d5e502'],0,3,3,1156835,1,0,0,1,3085
1918b21d1c3d9d32dec5f4ce68990b106a79d84f,0,James E. King III,2018-03-09 18:31:49-05:00,['50862915ccfd5512e9982d2b75a3df99c5e7cdd3'],0,2,2,1156837,1,1,1,1,3085
fe50feae7e9cad31aeeda0f30c7007ede13647f0,0,James E. King III,2018-03-09 18:32:36-05:00,['1918b21d1c3d9d32dec5f4ce68990b106a79d84f'],1,1,2,1156839,1,,,,3085
70b33fb6b48d62859a048cac1bec79cfadb2f310,0,James E. King III,2018-03-11 10:57:56-04:00,['fe50feae7e9cad31aeeda0f30c7007ede13647f0'],13,16,29,1156868,1,0,0,1,3085
8bcb7ac2be2f28e5fddfe578645c2aaa98b94717,1,James E. King III,2018-03-12 06:55:14-04:00,['70b33fb6b48d62859a048cac1bec79cfadb2f310'],14,74,88,1156956,9,0.3,0.9,1,3085
8678dfc78b54bd80b3b5bd098733f8bbdcc39150,0,James E. King III,2018-03-12 08:03:54-04:00,['8bcb7ac2be2f28e5fddfe578645c2aaa98b94717'],30,136,166,1157122,7,0.822222222,0.822222222,0.822222222,3086
3ae304268e1b058dc51642a83921e1d7ce7a1d12,0,James E. King III,2018-03-12 11:30:22-04:00,['8678dfc78b54bd80b3b5bd098733f8bbdcc39150'],9,7,16,1157138,5,,,,3086
5785279e2e809f6c56dbbe0eb41d13fb17c88bdd,1,James E. King III,2018-03-12 18:35:17-04:00,['3ae304268e1b058dc51642a83921e1d7ce7a1d12'],1569,407,1976,1159114,74,0.268518519,0.113425926,0.303240741,3088
a02ae56f7faf8f747551f6e333d001f872769033,0,James E. King III,2018-03-12 18:35:28-04:00,['5785279e2e809f6c56dbbe0eb41d13fb17c88bdd'],8,10,18,1159132,3,,,,3088
2bf03270bbead52344daa2252c517f0ccc0db040,0,James E. King III,2018-03-12 18:37:14-04:00,['a02ae56f7faf8f747551f6e333d001f872769033'],2,2,4,1159136,1,,,,3088
8d55c47610b765b2bcdfaebb7ee8d22930e0bd0d,0,James E. King III,2018-03-12 22:28:52-04:00,['2bf03270bbead52344daa2252c517f0ccc0db040'],6,17,23,1159159,2,,,,3088
5066eb484b0569b3290c597b848ee459f0112b11,1,James E. King III,2018-03-13 10:12:04-04:00,['8d55c47610b765b2bcdfaebb7ee8d22930e0bd0d'],35,6362,6397,1165556,7,0.333333333,1,1,3090
2b09dfed9c6b858571e7d8829a2b4a4bcda18d6a,1,James E. King III,2018-03-13 10:12:46-04:00,['5066eb484b0569b3290c597b848ee459f0112b11'],2206,197,2403,1167959,4,,,,3090
da9a9bac92550f676e170e600d4be24769e14835,1,James E. King III,2018-03-13 13:49:55-04:00,['2b09dfed9c6b858571e7d8829a2b4a4bcda18d6a'],18,28,46,1168005,4,1,1,1,3090
e58f75daa8a4e5efec4ff434d9427a05973e86fe,0,James E. King III,2018-03-14 13:07:10-04:00,['da9a9bac92550f676e170e600d4be24769e14835'],187,248,435,1168440,35,0.341463415,0.341463415,0.951219512,3090
68707d92192ffc82a98488e4cdd1033e20cdf3a5,1,Duru Can Celasun,2018-03-15 11:05:30+01:00,['e58f75daa8a4e5efec4ff434d9427a05973e86fe'],83,93,176,1168616,12,0,0,0,3090
a9efd1abd4fd4862d8e967ec207015af79494b6c,0,D. Can Celasun,2018-03-15 14:16:10+01:00,['68707d92192ffc82a98488e4cdd1033e20cdf3a5'],54,53,107,1168723,11,,,,3090
b7084cbc0d377c59e045553add6f61215ed77854,0,D. Can Celasun,2018-03-17 09:38:15+01:00,['a9efd1abd4fd4862d8e967ec207015af79494b6c'],69,261,330,1169053,2,1,1,1,3090
02fbe0ecc795881fe11a447d0a5f6f2f656f7bb4,0,Jens Geyer,2018-03-19 17:39:24+01:00,['b7084cbc0d377c59e045553add6f61215ed77854'],1,1,2,1169055,1,,,,3090
9bea32f73c36a8f53a45e818cfafe81b6fefefae,1,James E. King III,2018-03-19 14:38:49-04:00,['02fbe0ecc795881fe11a447d0a5f6f2f656f7bb4'],173,332,505,1169560,21,0,0,0.272727273,3090
859a40cf5f5c7c9169fb078af53b65876d6e089f,0,James E. King III,2018-03-19 14:39:22-04:00,['9bea32f73c36a8f53a45e818cfafe81b6fefefae'],4,4,8,1169568,3,,,,3090
b4960838a3b20e6bcf61727f21214a47418a2ca5,1,Allen George,2018-03-20 16:21:21-04:00,['859a40cf5f5c7c9169fb078af53b65876d6e089f'],33,280,313,1169881,4,,,,3091
e46419b5ecb8e430d8555c2d5fbcffbc6a91ff83,1,James E. King III,2018-03-20 16:28:15-04:00,['b4960838a3b20e6bcf61727f21214a47418a2ca5'],13,881,894,1170775,25,0.131465517,1,1,3098
22bd3450c6e97e348d64fb6a75171e8ced79d1e4,0,James E. King III,2018-03-20 16:32:32-04:00,['e46419b5ecb8e430d8555c2d5fbcffbc6a91ff83'],5,9,14,1170789,3,0,0,1,3098
9aaf295806d32eab5715b4f0681f7da9b64c1fa5,0,James E. King III,2018-03-21 01:02:11-04:00,['22bd3450c6e97e348d64fb6a75171e8ced79d1e4'],42,366,408,1171197,40,0.980861244,0.980861244,1,3099
e41de0fbcb43c51a0f1ede40207c80bd3409f99f,0,James E. King III,2018-03-21 07:48:31-04:00,['9aaf295806d32eab5715b4f0681f7da9b64c1fa5'],20,69,89,1171286,8,0,0.888888889,1,3099
714c77cebe72659f6577eb9c5293693bdfc9e692,1,James E. King III,2018-03-21 20:45:25-04:00,['e41de0fbcb43c51a0f1ede40207c80bd3409f99f'],24,83,107,1171393,6,0,0,1,3099
a8a97bde9eeada5ce0571ea1650b18f3ebc50e42,0,James E. King III,2018-03-22 11:30:14-04:00,['714c77cebe72659f6577eb9c5293693bdfc9e692'],3,3,6,1171399,1,,,,3099
dab4529f730c033e1ac037e820176667f5c422fd,0,Allen George,2018-03-23 07:40:49-04:00,['a8a97bde9eeada5ce0571ea1650b18f3ebc50e42'],1,1,2,1171401,1,,,,3099
272470790ad6db791bd6f9db399b2cd2d5879f74,1,James E. King III,2018-03-23 15:16:47-04:00,['dab4529f730c033e1ac037e820176667f5c422fd'],1154,1160,2314,1173715,34,0.4,1,1,3099
46fec417382a928e716a52b4ab6304febf797205,0,Duru Can Celasun,2018-03-28 10:35:16+02:00,['272470790ad6db791bd6f9db399b2cd2d5879f74'],0,14,14,1173729,1,0,0,1,3099
930428438c0b6c8f60560cbb7dcad79042badacb,0,D. Can Celasun,2018-03-29 14:53:36+02:00,['46fec417382a928e716a52b4ab6304febf797205'],4,55,59,1173788,2,0.25,0.5,0.75,3100
8a83b041d20671c3fae9528d5ac1f5413cad7c5a,0,D. Can Celasun,2018-03-30 08:48:15+02:00,['930428438c0b6c8f60560cbb7dcad79042badacb'],16,57,73,1173861,2,1,1,1,3100
d4fb364d30b0d01bbe8bdcab34f32ccfb539d564,0,Jens Geyer,2018-03-31 10:38:39+02:00,['8a83b041d20671c3fae9528d5ac1f5413cad7c5a'],6,4,10,1173871,1,,,,3100
8fb719efb1533e3a8038c155cbb209b492a29910,0,Jens Geyer,2018-04-01 12:29:51+02:00,['d4fb364d30b0d01bbe8bdcab34f32ccfb539d564'],1609,1656,3265,1177136,36,0.045454545,0.818181818,0.909090909,3100
99daecdd1d104effcc773f3f4d438f71c82db48a,0,Jens Geyer,2018-04-02 14:12:54+02:00,['8fb719efb1533e3a8038c155cbb209b492a29910'],13,17,30,1177166,1,0,0,0,3100
3c0edfa875218bd83f6b79a7823380e2adc08ae6,0,Jens Geyer,2018-04-02 23:41:01+02:00,['99daecdd1d104effcc773f3f4d438f71c82db48a'],8,17,25,1177191,1,,,,3100
a0cf38ed312a5342eb05574719485b725fa52eee,0,Jens Geyer,2018-04-04 17:32:14+02:00,['3c0edfa875218bd83f6b79a7823380e2adc08ae6'],1,1,2,1177193,1,,,,3100
6f8c99e98170dcd4f311e755b79f7013868c64c5,1,James E. King III,2018-04-05 10:25:19-04:00,['a0cf38ed312a5342eb05574719485b725fa52eee'],37,283,320,1177513,9,0,0,0.647058824,3100
0d2794d38f218486446200ee72b4c574fd7a6a25,1,James E. King III,2018-04-05 19:55:26-04:00,['6f8c99e98170dcd4f311e755b79f7013868c64c5'],2,5,7,1177520,2,,,,3100
85db0fe2ed2069050b5140ef5a500883b430823c,0,James E. King III,2018-04-06 08:37:11-04:00,['0d2794d38f218486446200ee72b4c574fd7a6a25'],20,54,74,1177594,2,,,,3101
10cfd6a504bec4a9aaca04ed9944d49ecf4ce322,0,James E. King III,2018-04-06 08:43:04-04:00,['85db0fe2ed2069050b5140ef5a500883b430823c'],7,7,14,1177608,1,,,,3101
63b75d9e3a4112b5b278933b487095f7bb431c1c,0,"James E. King, III",2018-04-06 08:56:54-04:00,['10cfd6a504bec4a9aaca04ed9944d49ecf4ce322'],3,3,6,1177614,1,,,,3101
7ad0665008764c0522672b314605d88959e20716,0,Jens Geyer,2018-04-06 22:49:05+02:00,['63b75d9e3a4112b5b278933b487095f7bb431c1c'],0,290,290,1177904,1,,,,3101
a9b6c7039b3f61b03528d262c3e8d9dc022e89cd,1,"James E. King, III",2018-04-08 07:11:37-04:00,['7ad0665008764c0522672b314605d88959e20716'],510,6262,6772,1184676,39,0.504697117,0.62585034,0.839002268,3139
b9d5fb25e4aa235d9a2405af0f7fc7c56ab59ecf,1,"James E. King, III",2018-04-09 08:04:42-04:00,['a9b6c7039b3f61b03528d262c3e8d9dc022e89cd'],32,81,113,1184789,1,0,0,0,3139
8a6d9f4f4257bfdf3e076d698777f60e23a564ba,0,GitHub,2018-04-09 08:11:38-04:00,['b9d5fb25e4aa235d9a2405af0f7fc7c56ab59ecf'],8,10,18,1184807,1,,,,3139
cc935b55543425ef79afa735e69e4bb06a1cb27c,0,"James E. King, III",2018-04-09 08:47:47-04:00,['8a6d9f4f4257bfdf3e076d698777f60e23a564ba'],0,21,21,1184828,1,0,0.047619048,0.666666667,3139
606f1ef31447526b908244933d5b716397a6bad8,0,Jens Geyer,2018-04-09 23:26:25+02:00,['cc935b55543425ef79afa735e69e4bb06a1cb27c'],282,336,618,1185446,16,,,,3140
0d8da22dba430c379de04ff48e507e7277f4ea21,0,GitHub,2018-04-11 13:45:08-04:00,['327ebb6c2b6df8bf075da02ef45a2a034e9b79ba'],1,1,2,1185448,1,,,,3140
858809fad01dba7318c33dc30f6cc92a6e2ac7b1,0,GitHub,2018-04-11 13:46:21-04:00,['b2a4d4ae21c789b689dd162deb819665567f481c'],1,1,2,1185450,1,,,,3140
2068544a09e22d4ca2091bde01bc858a15e5b762,1,James E. King III,2018-04-13 13:20:49-04:00,['606f1ef31447526b908244933d5b716397a6bad8'],67,194,261,1185711,4,0.75,0.75,1,3140
c564651dd404d7e9ff6bf7e5b343f429b9e52082,0,Jens Geyer,2018-04-14 00:51:41+02:00,['2068544a09e22d4ca2091bde01bc858a15e5b762'],67,400,467,1186178,7,0,0.916666667,1,3144
50bfc56d5d337a08a2dd3a6f60b0ed656719c6ed,0,Duru Can Celasun,2018-04-17 07:21:46+01:00,['c564651dd404d7e9ff6bf7e5b343f429b9e52082'],15,241,256,1186434,6,0.676767677,0.676767677,0.909090909,3146
4a00fc658a1dc90be33a223a2c7ee336679e8745,0,Jens Geyer,2018-04-17 22:12:17+02:00,['50bfc56d5d337a08a2dd3a6f60b0ed656719c6ed'],2,2,4,1186438,1,,,,3146
b255790b8e99a671ec59bf819019f3344ae37237,0,"James E. King, III",2018-04-17 23:18:29-04:00,['4a00fc658a1dc90be33a223a2c7ee336679e8745'],1,9,10,1186448,2,,,,3146
0293c3643b0075b510b9d92b2cc39b6d5e0fadb8,0,"James E. King, III",2018-04-17 23:21:30-04:00,['b255790b8e99a671ec59bf819019f3344ae37237'],19,21,40,1186488,1,,,,3146
09c1f3719c271b63fdc68daacb5620545b9b87d6,1,James E. King III,2018-05-01 07:53:52-04:00,['0293c3643b0075b510b9d92b2cc39b6d5e0fadb8'],1295,1542,2837,1189325,38,0.431034483,0.844827586,1,3150
ebf46314d73e6bbe02dd4059c5d2989c39e628f7,0,GitHub,2018-05-01 08:14:37-04:00,['09c1f3719c271b63fdc68daacb5620545b9b87d6'],0,7,7,1189332,1,,,,3150
33fb1a3f0da71ba79e3156f7d0c169e7480fcf26,1,James E. King III,2018-05-01 08:16:42-04:00,['ebf46314d73e6bbe02dd4059c5d2989c39e628f7'],5,15,20,1189352,1,0,0,1,3150
c7aa68bd59d1d3a1bbcb133fc986ff404d47b129,0,James E. King III,2018-05-01 09:07:50-04:00,['33fb1a3f0da71ba79e3156f7d0c169e7480fcf26'],10,11,21,1189373,2,0,0,0,3150
b33130f67964813169003fcbb4b7acc535082b5a,0,James E. King III,2018-05-02 13:39:49-04:00,['c7aa68bd59d1d3a1bbcb133fc986ff404d47b129'],0,16,16,1189389,1,0,0,0.5,3150
92d80629ac2a39d432ac5bb29f45951be3465f8f,0,Jens Geyer,2018-05-03 09:04:05+02:00,['b33130f67964813169003fcbb4b7acc535082b5a'],13,22,35,1189424,3,0,0,0,3150
edf8f0f2511e8eed3bb2129413307665ef4f4b79,0,James E. King III,2018-05-07 19:11:34-04:00,['92d80629ac2a39d432ac5bb29f45951be3465f8f'],19,0,19,1189443,1,0,0,0,3150
7db90771ac6bdbd7890e69ce8309fa650163a87c,0,James E. King III,2018-05-09 08:48:56-04:00,['edf8f0f2511e8eed3bb2129413307665ef4f4b79'],1,1,2,1189445,1,,,,3150
8672394ade6a8b893491cb9e0a3334c5c10e0252,0,James E. King III,2018-05-09 08:51:31-04:00,['7db90771ac6bdbd7890e69ce8309fa650163a87c'],1,1,2,1189447,1,,,,3150
6e1606a9cede7524fb79d555a25fd2742277165c,0,Chad Knight,2018-05-10 12:58:24-05:00,['8672394ade6a8b893491cb9e0a3334c5c10e0252'],1,1,2,1189449,1,,,,3150
336d4ecddfc8aa687ec5cd1bc3ff4455b11da451,0,GitHub,2018-05-10 16:06:22-04:00,"['8672394ade6a8b893491cb9e0a3334c5c10e0252', '6e1606a9cede7524fb79d555a25fd2742277165c']",1,1,2,1189451,1,,,,3150
e59b73d3c2bf1c328ccb78e683c0462fa1a473c7,0,James E. King III,2018-05-14 08:48:09-04:00,['336d4ecddfc8aa687ec5cd1bc3ff4455b11da451'],12,12,24,1189475,9,,,,3150
88591e32e710a0524327153c8b629d5b461e35e0,1,D. Can Celasun,2018-05-17 10:26:09+02:00,['e59b73d3c2bf1c328ccb78e683c0462fa1a473c7'],3,75,78,1189553,4,0.727272727,0.727272727,0.727272727,3152
eb9f65b74ec6babf85cf6e2686125e665e0e8e45,0,James E. King III,2018-06-07 09:38:49-04:00,['88591e32e710a0524327153c8b629d5b461e35e0'],4,7,11,1189564,1,1,1,1,3152
9edecce91a2a32639a222cf82459070c3661074b,0,James E. King III,2018-06-07 09:46:35-04:00,['eb9f65b74ec6babf85cf6e2686125e665e0e8e45'],2,2,4,1189568,2,,,,3152
4d10279244838383154003ea733487f7349fa690,1,James E. King III,2018-06-07 09:52:17-04:00,['9edecce91a2a32639a222cf82459070c3661074b'],38,38,76,1189644,2,,,,3154
747158c8daa994b3386f1dcb4fc9e91aed1748ad,0,James E. King III,2018-06-07 20:30:44-04:00,['4d10279244838383154003ea733487f7349fa690'],103,9,112,1189756,4,0,0,0.15,3154
b03d74992e453f24801e12dbb030ae384ec7e68a,1,James E. King III,2018-06-07 22:39:34-04:00,['747158c8daa994b3386f1dcb4fc9e91aed1748ad'],26,33,59,1189815,9,,,,3154
b92ca5f22618fcdcad9a4c24cd1a8fe64418deda,0,GitHub,2018-06-09 23:02:12-04:00,['b03d74992e453f24801e12dbb030ae384ec7e68a'],8,11,19,1189834,7,1,1,1,3154
d2f6f19bb8b79ecdbe705b5144ff64e91ac16f71,0,James E. King III,2018-06-10 03:02:32+00:00,['b92ca5f22618fcdcad9a4c24cd1a8fe64418deda'],0,1,1,1189835,1,,,,3154
b5471f63cb4bb8e3b00835a9ca9e48ff76a3bb51,0,James E. King III,2018-06-10 20:43:45+00:00,['d2f6f19bb8b79ecdbe705b5144ff64e91ac16f71'],4,4,8,1189843,2,,,,3154
f5f430df56871bc937950274b2c86681d3db6e59,1,James E. King III,2018-06-16 19:16:04+00:00,['b5471f63cb4bb8e3b00835a9ca9e48ff76a3bb51'],84,386,470,1190313,15,,,,3155
896c206c569f80c181c4c47a94b3d217df88b5a0,0,James E. King III,2018-06-21 20:48:16-04:00,['f5f430df56871bc937950274b2c86681d3db6e59'],10,42,52,1190365,2,0.28,0.28,1,3155
20e727e67a2b763bb30e09be65676e6598908830,0,Jens Geyer,2018-06-22 22:43:07+02:00,['896c206c569f80c181c4c47a94b3d217df88b5a0'],35,84,119,1190484,1,,,,3155
af7ecd6a2b15efe5c6b742cf4a9ccb31bcc1f362,1,Jens Geyer,2018-06-22 23:05:17+02:00,['20e727e67a2b763bb30e09be65676e6598908830'],142,195,337,1190821,2,,,,3155
d7b635f78471e424f5e8f2f40257f076cc2c249c,0,James E. King III,2018-06-27 08:48:18-04:00,['af7ecd6a2b15efe5c6b742cf4a9ccb31bcc1f362'],1,2,3,1190824,1,0,0,1,3155
c7fe3f4e3dbe8dd3eed4dd371ec72e6bb9e651dd,0,GitHub,2018-06-27 11:01:16-04:00,['d7b635f78471e424f5e8f2f40257f076cc2c249c'],30,44,74,1190898,1,,,,3155
a3a5909d1f61268e4d57c655eae2ee7784f11b65,0,James E. King III,2018-06-27 21:05:57+00:00,['c7fe3f4e3dbe8dd3eed4dd371ec72e6bb9e651dd'],1,60,61,1190959,2,,,,3156
129f332d72facda5d06f87e2b4e5e08bea0b6b44,0,James E. King III,2018-06-27 21:08:08+00:00,['a3a5909d1f61268e4d57c655eae2ee7784f11b65'],13,13,26,1190985,1,,,,3156
c0a5eed219f1d1d9f8634560489cd541e6ed5d4c,0,James E. King III,2018-07-03 08:15:49-04:00,['129f332d72facda5d06f87e2b4e5e08bea0b6b44'],1,5,6,1190991,1,0,0,1,3156
e7fa46458492a0243cde2ddd86e538c3b7cfd58e,0,James E. King III,2018-07-03 08:18:54-04:00,['c0a5eed219f1d1d9f8634560489cd541e6ed5d4c'],1,9,10,1191001,1,0.666666667,0.666666667,1,3156
f12cacf56145e2c8f0d4429694fedf5453648089,0,James E. King III,2018-07-05 09:29:51-04:00,['e7fa46458492a0243cde2ddd86e538c3b7cfd58e'],1,1,2,1191003,1,,,,3156
f2867c24984aa53edec54a138c03db934221bdea,0,James E. King III,2018-07-17 12:19:49-04:00,['f12cacf56145e2c8f0d4429694fedf5453648089'],3,15,18,1191021,2,0.307692308,0.461538462,1,3156
dabb539d64fb303a443c7962caccc9177669ca80,0,James E. King III,2018-07-30 16:31:28+00:00,['f2867c24984aa53edec54a138c03db934221bdea'],18,19,37,1191058,3,,,,3156
e8bec2359899bbc92220cd08398cffee9a6dd1d7,0,James E. King III,2018-07-31 10:21:42-04:00,['dabb539d64fb303a443c7962caccc9177669ca80'],1,5,6,1191064,1,,,,3156
fdd735eec34d7ddd7a4a8821bc92a445c92db87c,0,James E. King III,2018-08-01 08:59:18-04:00,['e8bec2359899bbc92220cd08398cffee9a6dd1d7'],0,2,2,1191066,1,,,,3156
0a2d4587c8cc0a54e4fa8fee9247d088d05b0d65,0,James E. King III,2018-08-03 17:03:22-04:00,['fdd735eec34d7ddd7a4a8821bc92a445c92db87c'],1,1,2,1191068,1,,,,3156
831819c5634627c8dfb5c3db777855bebac66a77,0,Duru Can Celasun,2018-08-07 06:40:38+01:00,['0a2d4587c8cc0a54e4fa8fee9247d088d05b0d65'],0,1,1,1191069,1,0,0,1,3156
6e67faa92827ece022380b211c2caaadd6145bf5,1,Jens Geyer,2018-08-07 23:28:49+02:00,['831819c5634627c8dfb5c3db777855bebac66a77'],37,38,75,1191144,9,1,1,0,3156
3f5f0f82a7fe15b5edc743d23d6dea5bd8c138aa,0,James E. King III,2018-08-28 23:55:15-04:00,['6e67faa92827ece022380b211c2caaadd6145bf5'],7,21,28,1191172,1,1,1,1,3156
8de3749235db03c1d043c9f31dcbdc4c0fb011ea,0,James E. King III,2018-08-29 08:03:07-04:00,['3f5f0f82a7fe15b5edc743d23d6dea5bd8c138aa'],1,1,2,1191174,1,,,,3156
66a44c5d8d57bd0c2e2afd228a29b5bc679a6770,1,Aki Sukegawa,2018-09-01 10:24:43+09:00,['8de3749235db03c1d043c9f31dcbdc4c0fb011ea'],24,690,714,1191888,11,0.492021277,0.492021277,0.872340426,3158
6e29b192a336bff7d2e22b8c73bc1f1216a41204,0,James E. King III,2018-09-02 07:01:14-04:00,['66a44c5d8d57bd0c2e2afd228a29b5bc679a6770'],14,10,24,1191912,4,1,1,0,3158
2566ecd5d9999f7ff70e6ac702243f0dfb24e7aa,0,James E. King III,2018-09-02 07:03:19-04:00,['6e29b192a336bff7d2e22b8c73bc1f1216a41204'],21,112,133,1192045,12,0.225806452,1,1,3158
612fdd871c9f4ac9249bf134e4162f408faa8851,0,James E. King III,2018-09-13 07:50:24-04:00,['2566ecd5d9999f7ff70e6ac702243f0dfb24e7aa'],7,12,19,1192064,2,0,0,1,3158
f74bc7b8bc2e5db69b4939d987f3c66109e8c3de,1,James E. King III,2018-09-15 09:44:05-04:00,['612fdd871c9f4ac9249bf134e4162f408faa8851'],4,12,16,1192080,2,,,,3158
180888820aa7d48485364718eeabbcfe8cba4edf,0,James E. King III,2018-09-15 09:47:14-04:00,['f74bc7b8bc2e5db69b4939d987f3c66109e8c3de'],0,67,67,1192147,3,1,1,0.583333333,3159
27705f487d897935b2735e5b50278a5503912616,0,James E. King III,2018-09-16 06:51:38-04:00,['180888820aa7d48485364718eeabbcfe8cba4edf'],1,10,11,1192158,1,1,1,1,3159
b2b767e1a4b009c3e133f918b5dd0a84da503149,0,James E. King III,2018-09-16 06:51:38-04:00,['27705f487d897935b2735e5b50278a5503912616'],19,70,89,1192247,8,0.2,0.35,1,3159
0f6e52abcce49102f4032393e6651cebb82ec29c,0,James E. King III,2018-09-16 07:02:55-04:00,['b2b767e1a4b009c3e133f918b5dd0a84da503149'],1,1,2,1192249,1,,,,3159
abd0df74492d24dccad115576c088e73e0b2634d,0,James E. King III,2018-09-16 19:56:29-04:00,['0f6e52abcce49102f4032393e6651cebb82ec29c'],11,70,81,1192330,3,,,,3160
12f8b14fff9888dbfe6f5d6c64dc462254922a31,1,James E. King III,2018-09-16 19:56:29-04:00,['abd0df74492d24dccad115576c088e73e0b2634d'],3,8,11,1192341,2,,,,3160
cbcfb2573f924cb051b7678b5cb4f7ef7138be49,0,James E. King III,2018-09-20 09:06:35-04:00,['12f8b14fff9888dbfe6f5d6c64dc462254922a31'],13,29,42,1192383,9,0,0.733333333,1,3160
ce70ba20c925e2b641798d791a3e6b9b2727c89c,0,James E. King III,2018-09-21 13:27:15-04:00,['cbcfb2573f924cb051b7678b5cb4f7ef7138be49'],3,9,12,1192395,1,,,,3160
a9235805469bff4c15bdd939240edb7eb9aec34f,0,Jens Geyer,2018-09-25 00:22:15+02:00,['ce70ba20c925e2b641798d791a3e6b9b2727c89c'],3,21,24,1192419,1,,,,3160
98acf189a78c3c6a78cf27c35450e1876d6500d5,0,James E. King III,2018-09-28 10:26:57-04:00,['a9235805469bff4c15bdd939240edb7eb9aec34f'],4,4,8,1192427,1,,,,3160
b5d6ea390fc5732ed1c1772709ab3731555dc3fc,1,James E. King III,2018-09-28 10:36:55-04:00,['98acf189a78c3c6a78cf27c35450e1876d6500d5'],1925,1091,3016,1195443,25,0.418604651,0.872093023,0.639534884,3160
c64389a194fe1516fef5830151dfb8b35f6c6bb2,0,James E. King III,2018-09-28 10:36:55-04:00,['b5d6ea390fc5732ed1c1772709ab3731555dc3fc'],4,6,10,1195453,2,,,,3160
014f53f6582fbae8146ae291d471382016091a06,1,James E. King III,2018-09-28 11:11:21-04:00,['c64389a194fe1516fef5830151dfb8b35f6c6bb2'],114,158,272,1195725,21,0.985915493,0.985915493,1,3174
14190de4cb44d7d6cfd09a1332795ee8e4a46035,0,James E. King III,2018-10-03 07:57:17-04:00,['014f53f6582fbae8146ae291d471382016091a06'],1,1,2,1195727,1,,,,3174
4a983069a63a6b0be0ae07e6dc4b0b23be44d93a,0,James E. King III,2018-10-03 15:12:26-04:00,['14190de4cb44d7d6cfd09a1332795ee8e4a46035'],1,5,6,1195733,1,,,,3174
53f0859639856d0d65278845ebab00c4c9fba8e9,0,James E. King III,2018-10-04 15:42:23-04:00,['4a983069a63a6b0be0ae07e6dc4b0b23be44d93a'],12,3,15,1195748,2,,,,3174
e1aacb9546ac1419df65ba4e5e15d9f4d054fd70,0,James E. King III,2018-10-04 19:43:07+00:00,['53f0859639856d0d65278845ebab00c4c9fba8e9'],2,2,4,1195752,1,,,,3174
031f57122f26656ce79c8d5dfe0a0822938afdb5,0,James E. King III,2018-10-04 15:44:02-04:00,['53f0859639856d0d65278845ebab00c4c9fba8e9'],2,2,4,1195756,1,,,,3174
6644a9ce1e0e57d8c3b754885168a59e0866f72f,0,GitHub,2018-10-04 23:09:37-04:00,"['031f57122f26656ce79c8d5dfe0a0822938afdb5', 'e1aacb9546ac1419df65ba4e5e15d9f4d054fd70']",2,2,4,1195760,1,,,,3174
eb31a6cd7e647e582c0e9efb5ad6b9e741932792,0,James E. King III,2018-10-05 17:05:07-04:00,['6644a9ce1e0e57d8c3b754885168a59e0866f72f'],1,1,2,1195762,1,,,,3174
d566da7739c9aae63fe7fc9d267887fa73e5dda7,0,James E. King III,2018-10-05 17:05:40-04:00,['eb31a6cd7e647e582c0e9efb5ad6b9e741932792'],4,4,8,1195770,1,,,,3174
2a2b72f6c8aef200ecee4984f011e06052288ff2,0,James E. King III,2018-10-11 10:19:50-04:00,['d566da7739c9aae63fe7fc9d267887fa73e5dda7'],3,11,14,1195784,3,0,1,1,3174
2853da436f9ba5c0673c645dd92c9e4fff9badec,0,James E. King III,2018-10-12 07:35:39-04:00,['2a2b72f6c8aef200ecee4984f011e06052288ff2'],16,57,73,1195857,3,0,0,0.95,3174
961fa701346a3aaa804db8845f5eb38ea230b353,0,James E. King III,2018-10-12 07:37:40-04:00,['2853da436f9ba5c0673c645dd92c9e4fff9badec'],4,48,52,1195909,4,0,0,1,3174
5c1ecb67cde4d9aff7ed3188ab11566184b27bf0,0,Duru Can Celasun,2018-10-16 07:40:13+01:00,['961fa701346a3aaa804db8845f5eb38ea230b353'],5,50,55,1195964,4,1,1,1,3175
7a51220c02d31c831e446906784836e9b3cd53b6,0,James E. King III,2018-10-17 09:20:47-04:00,['5c1ecb67cde4d9aff7ed3188ab11566184b27bf0'],6,3,9,1195973,1,,,,3175
8a130f63e5bd09e5c39f9760ba04b5ea0837ff4c,1,James E. King III,2018-10-17 19:13:45-04:00,['7a51220c02d31c831e446906784836e9b3cd53b6'],383,379,762,1196735,21,,,,3175
9ee29516c419b7eaa95ed89a93b135ea1c683576,0,Duru Can Celasun,2018-10-19 07:48:56+01:00,['8a130f63e5bd09e5c39f9760ba04b5ea0837ff4c'],9,9,18,1196753,6,,,,3175
cd829a0b9a5c66203b63350fa029589669ec43f6,0,James E. King III,2018-10-19 07:55:58-04:00,['9ee29516c419b7eaa95ed89a93b135ea1c683576'],5,5,10,1196763,1,,,,3175
da1169d75b154e48871851ea8d731fccb0876fe7,1,James E. King III,2018-10-28 11:27:38-04:00,['cd829a0b9a5c66203b63350fa029589669ec43f6'],2051,5131,7182,1203945,18,0,0.206798867,0.934844193,3177
92be4f312b88eac0a4ac450eda29fd20de11b1f0,0,James E. King III,2018-10-31 20:36:39-04:00,['da1169d75b154e48871851ea8d731fccb0876fe7'],0,59,59,1204004,1,,,,3178
f216dfb7168b08afbebd51b33d50dc6b16d88dbf,0,Duru Can Celasun,2018-11-03 07:45:50+01:00,['92be4f312b88eac0a4ac450eda29fd20de11b1f0'],0,4,4,1204008,1,0,1,1,3178
718a63c85b64f1c60b262229b812eabd40863d9f,0,James E. King III,2018-11-05 07:58:52-05:00,['f216dfb7168b08afbebd51b33d50dc6b16d88dbf'],35,100,135,1204143,1,0.16,1,1,3178
fed4977027f2a305d9de5c19b0dc606550eea41b,0,Duru Can Celasun,2018-11-06 07:55:55+01:00,['718a63c85b64f1c60b262229b812eabd40863d9f'],0,6,6,1204149,1,0,0,1,3178
f7d43ce0aa58cc7e33af425140e5a063e3f3a75f,0,James E. King III,2018-11-06 12:20:52-05:00,['fed4977027f2a305d9de5c19b0dc606550eea41b'],8,8,16,1204165,5,,,,3178
d5bd2005eac7fa4912b60b3a815596c67a348afb,0,James E. King III,2018-11-09 17:56:25-05:00,['f7d43ce0aa58cc7e33af425140e5a063e3f3a75f'],3,9,12,1204177,3,,,,3178
2391f33465b7b5ec1f3c9191f627a469916b892a,1,James E. King III,2018-11-11 17:07:24-05:00,['d5bd2005eac7fa4912b60b3a815596c67a348afb'],17,11,28,1204205,5,,,,3178
6436899e4723d4a22eac107041019aa981226237,0,James E. King III,2018-11-12 07:51:25-05:00,['2391f33465b7b5ec1f3c9191f627a469916b892a'],6,34,40,1204245,2,0.65,0.65,0,3178
b57d126157938e5bba4fc55125d73e7ac5bf11a2,0,James E. King III,2018-11-12 07:57:43-05:00,['6436899e4723d4a22eac107041019aa981226237'],29,133,162,1204407,10,1,1,1,3178
24918abba929282d6e405fedbc2ef68c3e894136,0,James E. King III,2018-11-12 07:58:54-05:00,['b57d126157938e5bba4fc55125d73e7ac5bf11a2'],2,23,25,1204432,2,0.857142857,1,1,3178
0882354f28a259b7715df10a729cd76c3e8254a3,0,James E. King III,2018-11-16 15:50:17-05:00,['24918abba929282d6e405fedbc2ef68c3e894136'],13,13,26,1204458,1,,,,3178
aa177ea4b30b2fe2711ced7b79cfd5947711146f,0,James E. King III,2018-11-19 12:53:16-05:00,['0882354f28a259b7715df10a729cd76c3e8254a3'],8,34,42,1204500,1,,,,3178
5112afcc9732381401435b7134a18aab30d4dec9,0,James E. King III,2018-11-22 08:17:15-05:00,['aa177ea4b30b2fe2711ced7b79cfd5947711146f'],2,4,6,1204506,1,0,0,1,3178
7af79c83591ddf289abaeacc7f0e97af7397f825,0,James E. King III,2018-11-22 08:30:56-05:00,['5112afcc9732381401435b7134a18aab30d4dec9'],1,10,11,1204517,1,1,1,0.833333333,3178
7abb7d5fbc700db2338719bc88b7f4b10304942b,1,James E. King III,2018-11-23 16:53:25-05:00,['7af79c83591ddf289abaeacc7f0e97af7397f825'],4,8,12,1204529,1,0,0,0,3178
fc52c3cceed1070d8c618d18a1abd0a437cf0295,0,Jens Geyer,2018-11-24 02:08:20+01:00,['7abb7d5fbc700db2338719bc88b7f4b10304942b'],4,44,48,1204577,2,1,1,1,3178
b073e1438d9236203c70efb5b3ba55a61f4c4d14,0,Jens Geyer,2018-11-24 21:46:53+01:00,['fc52c3cceed1070d8c618d18a1abd0a437cf0295'],28,46,74,1204651,1,0,0,1,3178
7f0fa6c21ec225aebbbc563607646124279e557c,0,James E. King III,2018-11-27 22:19:24-05:00,['b073e1438d9236203c70efb5b3ba55a61f4c4d14'],5,20,25,1204676,1,0,0,1,3178
2c69b5a01e589c19855a00b68596d0564bb2bb5b,1,James E. King III,2018-11-29 15:28:44-05:00,['7f0fa6c21ec225aebbbc563607646124279e557c'],22,1130,1152,1205828,21,0.657754011,0.703208556,0.778074866,3190
dd965c1eb437e0067009492b0d18b1d3f8e79d07,0,James E. King III,2018-12-03 09:08:09-05:00,['2c69b5a01e589c19855a00b68596d0564bb2bb5b'],3,2,5,1205833,3,,,,3190
30d3125cc277b6e42034d5ac72fd3e5f248f353a,0,James E. King III,2018-12-05 16:07:09-05:00,['dd965c1eb437e0067009492b0d18b1d3f8e79d07'],0,18,18,1205851,1,1,1,1,3190
54e9587117595d3ecbde1bf8065dc09197808bdb,0,James E. King III,2018-12-05 16:09:10-05:00,['30d3125cc277b6e42034d5ac72fd3e5f248f353a'],11,61,72,1205923,6,,,,3192
17a9cffabb746f7dc481a5af9d8a1aeeda537fb6,0,James E. King III,2018-12-05 16:14:09-05:00,['54e9587117595d3ecbde1bf8065dc09197808bdb'],2,2,4,1205927,1,,,,3192
208a048dc440036bd5304a6fd16e32fda33b4600,0,James E. King III,2018-12-07 16:18:46-05:00,['17a9cffabb746f7dc481a5af9d8a1aeeda537fb6'],1,0,1,1205928,1,,,,3192
9c3d2d6c0ac6805fdb52cff582067a9cb6863caf,0,James E. King III,2018-12-10 08:35:09-05:00,['208a048dc440036bd5304a6fd16e32fda33b4600'],1,1,2,1205930,1,,,,3192
f201bf05fbb56a33112e9f7ccf3790dffeab383e,0,James E. King III,2018-12-10 18:44:23-05:00,['9c3d2d6c0ac6805fdb52cff582067a9cb6863caf'],1,4,5,1205935,1,0,0,1,3192
db61f10497bcf069da03537629dcc79b0523ebe4,0,James E. King III,2018-12-10 18:44:23-05:00,['f201bf05fbb56a33112e9f7ccf3790dffeab383e'],0,4,4,1205939,1,0,0,1,3192
e6e7e62981e285d6d7e023a618be3bafa514edae,0,James E. King III,2018-12-10 18:44:23-05:00,['db61f10497bcf069da03537629dcc79b0523ebe4'],1,1,2,1205941,1,,,,3192
44ee32cef57cbbd0ad62dfa026f0ee5e746f5c2b,0,James E. King III,2018-12-10 18:44:23-05:00,['e6e7e62981e285d6d7e023a618be3bafa514edae'],0,2,2,1205943,1,,,,3192
2b7365c54f823013cc6a4760798051b22743c103,0,Duru Can Celasun,2018-12-11 09:44:44+01:00,['44ee32cef57cbbd0ad62dfa026f0ee5e746f5c2b'],6,9,15,1205958,1,0,1,1,3192
ef7a18970f309632e3a3015ac1c659d72d36967b,1,GREATEST Wiggler EvaR!,2018-12-16 18:22:04-05:00,['2b7365c54f823013cc6a4760798051b22743c103'],784,669,1453,1207411,20,0.980392157,0.45751634,0.117647059,3192
f4b17857db4a7ff6885d22535b0e9b963af49397,0,GitHub,2018-12-17 00:35:16-05:00,"['2b7365c54f823013cc6a4760798051b22743c103', 'ef7a18970f309632e3a3015ac1c659d72d36967b']",784,669,1453,1208864,20,,,,3192
33772b7d78dc3e73154f1942320e1a6ef3301e1b,1,James E. King III,2018-12-17 09:57:27-05:00,['f4b17857db4a7ff6885d22535b0e9b963af49397'],2,13,15,1208879,1,,,,3192
56ac72e74ae354c286c41f5d5a3c0b8723feb587,0,James E. King III,2018-12-17 12:18:48-05:00,['33772b7d78dc3e73154f1942320e1a6ef3301e1b'],41,7,48,1208927,2,,,,3192
9b75e4fe745a9b08e6ccdc0998ec7a69272f5b4c,0,James E. King III,2018-12-18 10:17:57-05:00,['56ac72e74ae354c286c41f5d5a3c0b8723feb587'],29,25,54,1208981,11,,,,3192
384647d290e2e4a55a14b1b7ef1b7e66293a2c33,0,James E. King III,2018-12-18 20:24:34-05:00,['9b75e4fe745a9b08e6ccdc0998ec7a69272f5b4c'],101,380,481,1209462,63,,,,3192
7ac9e43ebcc4e65b4150aea83e85af19e22964a1,0,James E. King III,2018-12-19 22:12:32-05:00,['9b75e4fe745a9b08e6ccdc0998ec7a69272f5b4c'],0,13,13,1209475,1,,,,3192
087d88108d34e3b08bc24eb555ec2d98b5293c31,0,James E. King III,2018-12-25 12:53:52-05:00,['7ac9e43ebcc4e65b4150aea83e85af19e22964a1'],9,12,21,1209496,1,0,0,1,3192
a597725bcbfc261caae834fd763dd3734ab1ffce,0,James E. King III,2018-12-27 13:03:23-05:00,['087d88108d34e3b08bc24eb555ec2d98b5293c31'],1,37,38,1209534,1,,,,3193
f9f037bd5a9776ff1f7e28b530418299d102d8d3,0,James E. King III,2018-12-28 07:33:17-05:00,['a597725bcbfc261caae834fd763dd3734ab1ffce'],1,84,85,1209619,3,,,,3195
a139082755369611ed243376ec3c4161452369fc,0,James E. King III,2018-12-28 07:46:47-05:00,['f9f037bd5a9776ff1f7e28b530418299d102d8d3'],26,26,52,1209671,17,,,,3195
c3375d9e434b5740808813138b28b70517e82c7d,1,James E. King III,2018-12-30 11:06:00-05:00,"['a139082755369611ed243376ec3c4161452369fc', '384647d290e2e4a55a14b1b7ef1b7e66293a2c33']",88,371,459,1210130,56,,,,3195
ab494bc29dd84c46c6630682e2a0051401a39e9b,0,James E. King III,2018-12-30 11:09:34-05:00,['c3375d9e434b5740808813138b28b70517e82c7d'],5,1,6,1210136,1,,,,3195
3671b8bce9668d680c179db0ba38f7e4df0ff3e6,0,James E. King III,2018-12-30 22:37:32-05:00,['a139082755369611ed243376ec3c4161452369fc'],5,11,16,1210152,1,0,1,1,3195
75bac10dbd8d953bb2f556b7dcc3bdf7518e67a6,0,James E. King III,2018-12-30 22:38:33-05:00,['3671b8bce9668d680c179db0ba38f7e4df0ff3e6'],4,4,8,1210160,1,,,,3195
bf51a9faf9942571cf1eea64ae260a9ced5c4598,0,James E. King III,2018-12-30 22:39:32-05:00,['75bac10dbd8d953bb2f556b7dcc3bdf7518e67a6'],2,2,4,1210164,1,,,,3195
e2109b914cefcf53f454586008a78cf19bbe8018,0,GitHub,2018-12-30 22:41:49-05:00,"['bf51a9faf9942571cf1eea64ae260a9ced5c4598', 'ab494bc29dd84c46c6630682e2a0051401a39e9b']",88,367,455,1210619,56,,,,3195
138a81d5b401b57ee4883879f94b10ba4f935453,0,James E. King III,2018-12-31 17:27:43-05:00,['e2109b914cefcf53f454586008a78cf19bbe8018'],39,20,59,1210678,1,1,1,1,3195
0e99ee31ba25ee0b2b8eecea44b7208318cf3f56,0,James E. King III,2019-01-01 14:45:36-05:00,['138a81d5b401b57ee4883879f94b10ba4f935453'],95,0,95,1210773,2,,,,3195
4c71660dab62f2ac08ab7d81b41053fdaf2cdeb9,1,James E. King III,2019-01-02 07:54:43-05:00,['0e99ee31ba25ee0b2b8eecea44b7208318cf3f56'],7,62,69,1210842,4,,,,3196
df9c60d38f0255ea08ea0a5aeba1abc4a0ccf04d,0,James E. King III,2019-01-02 10:05:48-05:00,['4c71660dab62f2ac08ab7d81b41053fdaf2cdeb9'],4,8,12,1210854,1,,,,3196
1c6914d5c51da5a0a1d92453bfad549831f313d5,0,James E. King III,2019-01-02 10:42:23-05:00,['df9c60d38f0255ea08ea0a5aeba1abc4a0ccf04d'],86,46,132,1210986,1,0.025,0,0,3196
a3a7c6c7890b742379db5691f000fb242469af0e,1,James E. King III,2019-01-02 15:20:23-05:00,['1c6914d5c51da5a0a1d92453bfad549831f313d5'],1,79,80,1211066,6,,,,3197
99f673a767104a037e24eb10e1f3341e0ab428f4,0,James E. King III,2019-01-02 19:20:56-05:00,['a3a7c6c7890b742379db5691f000fb242469af0e'],12,11,23,1211089,8,,,,3197
217e8246ab6fdb6a1fa6016ba0f4979eb1d8a92a,0,James E. King III,2019-01-02 23:10:04-05:00,['99f673a767104a037e24eb10e1f3341e0ab428f4'],0,5,5,1211094,1,,,,3197
57516213cc3b17a38196b07282feb47144e5232f,1,James E. King III,2019-01-03 00:04:07-05:00,['217e8246ab6fdb6a1fa6016ba0f4979eb1d8a92a'],4,7,11,1211105,1,,,,3197
9e813aeed2291a25fc965ba58944c3705b9d15c6,0,James E. King III,2019-01-03 00:06:19-05:00,['57516213cc3b17a38196b07282feb47144e5232f'],24,31,55,1211160,8,0,0,0,3197
5abf58cf792466302d3c21d6b93ff50bb42d4c2f,0,James E. King III,2019-01-03 00:10:15-05:00,['9e813aeed2291a25fc965ba58944c3705b9d15c6'],157,83,240,1211400,13,0.95,0.1875,0,3197
36ffe1e8dc5168ea683bb10896377eaffc057667,0,James E. King III,2019-01-03 07:23:45-05:00,['5abf58cf792466302d3c21d6b93ff50bb42d4c2f'],1,1,2,1211402,1,,,,3197
882d48da5d5db439c11029f46006c71f6429ae2c,0,James E. King III,2019-01-03 14:45:16-05:00,['36ffe1e8dc5168ea683bb10896377eaffc057667'],23,107,130,1211532,3,,,,3197
88584f8469a1768f16f8477d0247a27d214a5ebc,0,James E. King III,2019-01-03 18:55:36-05:00,['882d48da5d5db439c11029f46006c71f6429ae2c'],141,65,206,1211738,5,0.814285714,0,0,3198
6503043bc42ab96da14c25f3aee2bb4add719774,0,James E. King III,2019-01-03 22:04:36-05:00,['88584f8469a1768f16f8477d0247a27d214a5ebc'],22,81,103,1211841,5,0.692307692,1,1,3198
d5324413664a44da1cbdf671e0fe00b8571c2b4b,0,James E. King III,2019-01-04 14:27:10-05:00,['6503043bc42ab96da14c25f3aee2bb4add719774'],3,13,16,1211857,1,0,0,1,3198
ecebd77c4a19919471345c21e797d55c5f83c22b,1,James E. King III,2019-01-04 16:28:13-05:00,['d5324413664a44da1cbdf671e0fe00b8571c2b4b'],5,317,322,1212179,5,,,,3199
abf3aa5810bc641f566b95b9748dabe2284baafb,1,James E. King III,2019-01-04 21:31:55-05:00,['ecebd77c4a19919471345c21e797d55c5f83c22b'],34,34,68,1212247,3,,,,3199
414f9a5bf6372844274b0adee7263f4d03ed8e70,0,James E. King III,2019-01-04 21:33:31-05:00,['abf3aa5810bc641f566b95b9748dabe2284baafb'],0,1,1,1212248,1,,,,3199
41d5d3a9ef5f6c90b0bff1a6e5f785841c11c15b,0,James E. King III,2019-01-05 01:59:19-05:00,['414f9a5bf6372844274b0adee7263f4d03ed8e70'],0,4,4,1212252,1,0,1,1,3199
b239b0a53b016ea55939b6fd667955762bd56909,0,James E. King III,2019-01-05 01:59:19-05:00,['41d5d3a9ef5f6c90b0bff1a6e5f785841c11c15b'],1,1,2,1212254,1,,,,3199
0f7904562771ba2c04e0836dfa6eb7771bf3a6a1,0,James E. King III,2019-01-05 01:59:19-05:00,['b239b0a53b016ea55939b6fd667955762bd56909'],0,1,1,1212255,1,0,1,1,3199
d2c6dc8e44e40a2b439a8aaadd224e2960a08f9e,0,James E. King III,2019-01-05 09:33:02-05:00,['0f7904562771ba2c04e0836dfa6eb7771bf3a6a1'],2,2,4,1212259,1,,,,3199
93e8ec2d6a372cd6f68b7c11508ff7f8ea043f08,1,James E. King III,2019-01-06 21:33:37-05:00,['d2c6dc8e44e40a2b439a8aaadd224e2960a08f9e'],12,8,20,1212279,2,0.666666667,0.666666667,0,3199
3cf066708e29e8cef76102c82cb51e74dfdd0426,0,James E. King III,2019-01-07 08:11:37-05:00,['93e8ec2d6a372cd6f68b7c11508ff7f8ea043f08'],14,7,21,1212300,1,,,,3199
7b935597bac2336c7f4d282069ab4d78ca473543,0,James E. King III,2019-01-07 08:11:37-05:00,['3cf066708e29e8cef76102c82cb51e74dfdd0426'],21,21,42,1212342,8,,,,3199
e42cf5023e3fc7fddf7e6f897aa1fb7d4a090afc,0,James E. King III,2019-01-07 08:11:37-05:00,['7b935597bac2336c7f4d282069ab4d78ca473543'],3,3,6,1212348,1,,,,3199
0705d9956750b9d61d763c8d8e38bb98e86870eb,0,James E. King III,2019-01-07 08:11:37-05:00,['e42cf5023e3fc7fddf7e6f897aa1fb7d4a090afc'],4,1,5,1212353,1,,,,3199
83b65f06fa380ed94669bdb461344f4f6b591191,0,James E. King III,2019-01-07 08:11:37-05:00,['0705d9956750b9d61d763c8d8e38bb98e86870eb'],7,18,25,1212378,1,,,,3199
c109e019790a87ef1f874dfac3482ac45a57d3ab,0,James E. King III,2019-01-07 08:11:37-05:00,['83b65f06fa380ed94669bdb461344f4f6b591191'],612,19,631,1213009,26,0.183168317,0,0,3199
2150a3451bd110ed528df6f3e6a805dc5b3fd147,0,James E. King III,2019-01-07 08:11:37-05:00,['c109e019790a87ef1f874dfac3482ac45a57d3ab'],8,0,8,1213017,1,,,,3199
f23e6a5e23c8ad1feaaa6913314c7836246a2925,0,James E. King III,2019-01-07 08:11:37-05:00,['2150a3451bd110ed528df6f3e6a805dc5b3fd147'],9,2,11,1213028,1,,,,3199
9f837bbfb4c61ad8afe80950b6ce677a5cd39aeb,0,James E. King III,2019-01-07 08:11:37-05:00,['f23e6a5e23c8ad1feaaa6913314c7836246a2925'],39,8,47,1213075,3,,,,3199
52637b33aba090851436b2031476529423ea3281,0,James E. King III,2019-01-07 08:11:37-05:00,['9f837bbfb4c61ad8afe80950b6ce677a5cd39aeb'],49,17,66,1213141,1,,,,3199
316723add4c368ffd144dd5beb55245832e073fa,1,James E. King III,2019-01-07 08:11:37-05:00,['52637b33aba090851436b2031476529423ea3281'],1399,1307,2706,1215847,143,0,0.5,1,3199
d65e91c47613e54eb0c2bf521ae2cd4242d58ed9,0,James E. King III,2019-01-07 08:11:37-05:00,['316723add4c368ffd144dd5beb55245832e073fa'],3,3,6,1215853,2,,,,3199
8cb3b6854818bf63d3208afaf4dc9e70c6137500,0,James E. King III,2019-01-07 08:11:37-05:00,['d65e91c47613e54eb0c2bf521ae2cd4242d58ed9'],2,2,4,1215857,1,,,,3199
0f43f95b89db01a8c68225824f8aa7fd4522007e,0,James E. King III,2019-01-07 08:11:37-05:00,['8cb3b6854818bf63d3208afaf4dc9e70c6137500'],9,9,18,1215875,2,,,,3199
e9421b826f3db5491b583db5202394e8e3861226,0,James E. King III,2019-01-07 08:11:37-05:00,['0f43f95b89db01a8c68225824f8aa7fd4522007e'],6,0,6,1215881,1,,,,3199
7f8aef709937fb0a033ba89eade671a989d16f96,0,James E. King III,2019-01-07 08:11:37-05:00,['e9421b826f3db5491b583db5202394e8e3861226'],13,12,25,1215906,3,,,,3199
7007506960437a51fad46a2426ebadee50b7817f,0,James E. King III,2019-01-07 08:11:37-05:00,['7f8aef709937fb0a033ba89eade671a989d16f96'],14,9,23,1215929,6,,,,3199
77d26e2e5c2f9624f6d4b5f20819448164a7ae1b,0,James E. King III,2019-01-07 08:11:37-05:00,['7007506960437a51fad46a2426ebadee50b7817f'],10,2,12,1215941,1,,,,3199
863262dad7ee2719a6699d564a249dfea7480032,0,James E. King III,2019-01-07 08:11:37-05:00,['77d26e2e5c2f9624f6d4b5f20819448164a7ae1b'],9,9,18,1215959,3,,,,3199
5e16f8b9086ce9bf4fa74993ecc51a7b9354f51e,0,James E. King III,2019-01-07 08:11:37-05:00,['863262dad7ee2719a6699d564a249dfea7480032'],21,7,28,1215987,2,,,,3199
1f34504f43a7a409364d4114f180762bf2679e57,0,James E. King III,2019-01-07 08:11:37-05:00,['5e16f8b9086ce9bf4fa74993ecc51a7b9354f51e'],3,0,3,1215990,1,,,,3199
0140cbf5674c5573d142c95c182f4ba98de99769,0,James E. King III,2019-01-07 08:11:37-05:00,['1f34504f43a7a409364d4114f180762bf2679e57'],21,0,21,1216011,8,0.95,0.4,0,3199
caf7da976755694ee2a905cc8b85e36852f87558,1,James E. King III,2019-01-07 10:45:27-05:00,['0140cbf5674c5573d142c95c182f4ba98de99769'],24,7,31,1216042,3,0,1,1,3199
e824efcb7935e019998264b8982ad5e51858879e,0,James E. King III,2019-01-07 16:51:00-05:00,['caf7da976755694ee2a905cc8b85e36852f87558'],1,40,41,1216083,2,,,,3200
795d3477d59c9c346e05cd825dc48778cd9fa70b,0,James E. King III,2019-01-08 10:26:52-05:00,"['e824efcb7935e019998264b8982ad5e51858879e', 'e76f2264b50a576fc2c339548fc2522c15f14f45']",0,0,0,1216083,0,,,,3200
6b87ca45c048b4d9362c4d0168e029a7cd1c6805,0,James E. King III,2019-01-08 14:15:41-05:00,"['795d3477d59c9c346e05cd825dc48778cd9fa70b', '2f5e7760c7973a4675f1372be43540f9179a3521']",0,0,0,1216083,0,,,,3200
c70aca4fbba61bb7ed839ffcfda1c3cabc435c9e,0,James E. King III,2019-01-08 14:29:02-05:00,"['6b87ca45c048b4d9362c4d0168e029a7cd1c6805', '1b7729f71e76af446d8d0119f67a51c4718e1f3b']",0,0,0,1216083,0,,,,3200
792de73ae64f8b175d4720b80f842661d55b6e4a,0,James E. King III,2019-01-08 14:29:40-05:00,"['c70aca4fbba61bb7ed839ffcfda1c3cabc435c9e', 'e25771d4c29a398ba5d23b447a37d15ab77e7f42']",0,0,0,1216083,0,,,,3200
88dc0dfa37850563c9d58960d31f98f15ec8511b,0,James E. King III,2019-01-08 14:34:57-05:00,"['792de73ae64f8b175d4720b80f842661d55b6e4a', '5a53060de2af5959db0ef21ee4a865ae3fa67fd3']",0,0,0,1216083,0,,,,3200
66ba505f4792d11de35de1f7ba1cf07a1ffa49d6,0,James E. King III,2019-01-08 14:36:17-05:00,"['88dc0dfa37850563c9d58960d31f98f15ec8511b', '69bba6ef4630674f8dea0201ffdafe511278404b']",0,0,0,1216083,0,,,,3200
d54824acbd2efe399846eba426186c1d8c2020b8,0,James E. King III,2019-01-08 14:37:08-05:00,"['66ba505f4792d11de35de1f7ba1cf07a1ffa49d6', 'be691f4ebfcc0496aaefc464803210e4e40f62ad']",0,0,0,1216083,0,,,,3200
a7e587b17920f5ba7eea6e6b79fa493055f8524f,0,James E. King III,2019-01-08 14:38:37-05:00,"['d54824acbd2efe399846eba426186c1d8c2020b8', '352a50eb36b851bfb3f69469db580e6edfd6250f']",0,0,0,1216083,0,,,,3200
9e84ec0abb5658942742cda8a2c18c2df24941aa,0,James E. King III,2019-01-08 14:40:37-05:00,"['a7e587b17920f5ba7eea6e6b79fa493055f8524f', '9c929c8979fab8d883b83df87034ed81373effb5']",0,2,2,1216085,1,,,,3200
04d6d02624e346e9197fe4538f8d37d588808e05,0,James E. King III,2019-01-08 14:43:23-05:00,"['9e84ec0abb5658942742cda8a2c18c2df24941aa', '591e20f9636c37527a70dc03598218c3468a0eff']",0,0,0,1216085,0,,,,3200
9313fbe278d8d8c9ae2436f8adddb0283cb8b047,0,James E. King III,2019-01-08 14:44:30-05:00,"['04d6d02624e346e9197fe4538f8d37d588808e05', '53dd39833a08ce33582e5ff31fa18bb4735d6731']",0,0,0,1216085,0,,,,3200
803bc50b979d15033caa8670b4fb2266616bd9d8,0,James E. King III,2019-01-08 14:48:21-05:00,"['9313fbe278d8d8c9ae2436f8adddb0283cb8b047', '858809fad01dba7318c33dc30f6cc92a6e2ac7b1']",4,5,9,1216094,2,,,,3200
a5df39032ca206e2e6a9ec975147e81746d9a255,0,James E. King III,2019-01-08 15:01:16-05:00,"['803bc50b979d15033caa8670b4fb2266616bd9d8', '0d8da22dba430c379de04ff48e507e7277f4ea21']",0,0,0,1216094,0,,,,3200
c9ac8d2953a4806cc93aa4ff2e700623ecad980c,1,James E. King III,2019-01-09 17:05:34-05:00,['a5df39032ca206e2e6a9ec975147e81746d9a255'],3078,3069,6147,1222241,22,,,,3202
ca8af9b48f9e62edc57c4a233c6377144214ef5a,0,James E. King III,2019-01-11 09:13:12-05:00,['c9ac8d2953a4806cc93aa4ff2e700623ecad980c'],1943,284,2227,1224468,46,0.2859375,0.1796875,0.0375,3202
cc19bf1d7b5a32ed345e31c5634ac4d1e2b1d86e,0,James E. King III,2019-01-11 12:56:42-05:00,['ca8af9b48f9e62edc57c4a233c6377144214ef5a'],0,395,395,1224863,1,,,,3203
d7c11ada8857e834ebdba9af71344c6c0425207d,0,James E. King III,2019-01-11 19:19:44-05:00,['cc19bf1d7b5a32ed345e31c5634ac4d1e2b1d86e'],1,2,3,1224866,2,,,,3203
91854f0b30aba0b6c1d41297bb101e72081a1bf4,1,James E. King III,2019-01-11 19:20:40-05:00,['d7c11ada8857e834ebdba9af71344c6c0425207d'],28,39,67,1224933,1,,,,3203
76ee393d20044f7bf930611cf8fc370acb8e9e1a,0,James E. King III,2019-01-11 19:24:39-05:00,['91854f0b30aba0b6c1d41297bb101e72081a1bf4'],3,4,7,1224940,1,,,,3203
278528cf7b1dd5dd977bce882aa126fac8695697,1,James E. King III,2019-01-11 20:47:00-05:00,['76ee393d20044f7bf930611cf8fc370acb8e9e1a'],1120,384,1504,1226444,31,,,,3207
17355425429274e7971fff39d7e45279cdf550fa,1,James E. King III,2019-01-13 09:01:52-05:00,['278528cf7b1dd5dd977bce882aa126fac8695697'],114,21,135,1226579,13,,,,3207
f3ec277e7e2c147342831ecec590bc2f71b07761,0,James E. King III,2019-01-13 11:17:40-05:00,['17355425429274e7971fff39d7e45279cdf550fa'],12,17,29,1226608,3,,,,3207
234fb47229dad47842e97a599614dbbd81b7c4a2,0,James E. King III,2019-01-14 08:13:52-05:00,['f3ec277e7e2c147342831ecec590bc2f71b07761'],10126,71,10197,1236805,77,0.68342512,0.461716113,0.202700302,3207
5c327d7bf629f6c5906759ccc919cf98d27ddf78,1,James E. King III,2019-01-14 08:15:33-05:00,['234fb47229dad47842e97a599614dbbd81b7c4a2'],1,8,9,1236814,1,,,,3207
4eac57abcfc5f6fb591d894fe446add243392557,0,James E. King III,2019-01-14 09:56:02-05:00,['5c327d7bf629f6c5906759ccc919cf98d27ddf78'],44,33,77,1236891,1,1,1,0,3207
e20ab3e2371803e69b321f13116e04a926ca39be,1,Beluga Behr,2019-01-14 11:22:02-05:00,['4eac57abcfc5f6fb591d894fe446add243392557'],26,32,58,1236949,10,1,0,0,3207
fe11c48ee185c9aead78d0c67c644c575df255a8,0,James E. King III,2019-01-14 12:10:24-05:00,['4eac57abcfc5f6fb591d894fe446add243392557'],0,1,1,1236950,1,1,1,1,3207
f61d9e52827ec14f35dde0f5c0740837a5572c83,0,James E. King III,2019-01-14 12:14:10-05:00,['fe11c48ee185c9aead78d0c67c644c575df255a8'],1,6,7,1236957,1,1,1,1,3207
bbc137787496154fb794b210ad783899f2d3092f,0,James E. King III,2019-01-14 13:57:30-05:00,['f61d9e52827ec14f35dde0f5c0740837a5572c83'],6,23,29,1236986,9,,,,3207
ee006ecb0da884e7d70f6f1e87d6c4b27197e55c,0,James E. King III,2019-01-14 15:57:43-05:00,['bbc137787496154fb794b210ad783899f2d3092f'],28,28,56,1237042,1,,,,3207
010ccf0a0c7023fea0f6bf4e4078ebdff7e61982,0,GitHub,2019-01-14 16:54:59-05:00,"['ee006ecb0da884e7d70f6f1e87d6c4b27197e55c', 'e20ab3e2371803e69b321f13116e04a926ca39be']",26,32,58,1237100,10,,,,3207
f86845e8ed622e7e3b7c87f00f16729ee6cc524d,1,James E. King III,2019-01-15 09:20:54-05:00,['010ccf0a0c7023fea0f6bf4e4078ebdff7e61982'],67,11418,11485,1248585,44,0.535079514,0.855940131,0.96445276,3229
ac9e9b1227074f6ae152468471fcfdca6f51fb2a,1,Jens Geyer,2019-01-17 01:33:24+01:00,['f86845e8ed622e7e3b7c87f00f16729ee6cc524d'],2,2,4,1248589,1,,,,3229
67df34afa782be67154034b31e4ad7cb3834fed1,0,Jens Geyer,2019-01-17 01:34:04+01:00,['ac9e9b1227074f6ae152468471fcfdca6f51fb2a'],1,1,2,1248591,1,,,,3229
8630eb9cf23bd734b1b979cebef83186cb5c1e24,1,Jens Geyer,2019-01-20 11:35:17+01:00,['67df34afa782be67154034b31e4ad7cb3834fed1'],1,1,2,1248593,1,,,,3229
3b280d1ee2ce1467333289c733980cda423abf82,0,Jens Geyer,2019-01-20 12:38:36+01:00,['8630eb9cf23bd734b1b979cebef83186cb5c1e24'],3,3,6,1248599,1,,,,3229
1ad08ca91b62701bf2989f52e73e6642aee1f7f0,0,Jens Geyer,2019-01-20 22:13:54+01:00,['3b280d1ee2ce1467333289c733980cda423abf82'],1,75,76,1248675,1,0.06557377,0,1,3229
ef32bc10b70aa2926957fd8f35691563234f08b6,0,James E. King III,2019-01-21 16:14:25-05:00,['1ad08ca91b62701bf2989f52e73e6642aee1f7f0'],11,45,56,1248731,6,,,,3230
f83d3f90d60365aa9898e57991f051e88e8094c6,0,cyy,2019-01-22 10:36:17+08:00,['ef32bc10b70aa2926957fd8f35691563234f08b6'],6,5,11,1248742,4,,,,3230
7190ca7a3d8d259730580a9979519ddd6a344619,0,cyy,2019-01-22 10:36:17+08:00,['f83d3f90d60365aa9898e57991f051e88e8094c6'],7,0,7,1248749,3,,,,3230
d12dbed670acb9fbe65662fb72d2069e5ee6d0a0,0,cyy,2019-01-22 10:36:18+08:00,['7190ca7a3d8d259730580a9979519ddd6a344619'],9,0,9,1248758,3,,,,3230
bfdbd0344bd3ddf348985b51e02212e8092859d4,0,cyy,2019-01-22 10:36:18+08:00,['d12dbed670acb9fbe65662fb72d2069e5ee6d0a0'],384,111,495,1249253,17,0.252873563,0.034482759,0.206896552,3230
6a01d46df606c239e59ed37e723f9bb1309870b4,0,cyy,2019-01-22 10:36:18+08:00,['bfdbd0344bd3ddf348985b51e02212e8092859d4'],21,0,21,1249274,2,1,1,0,3230
c1bfe3d7182c6e61879cfe9568c898c402654962,0,cyy,2019-01-22 10:36:18+08:00,['6a01d46df606c239e59ed37e723f9bb1309870b4'],13,0,13,1249287,1,,,,3230
fc222b3a8741eda6f4ec874cf7e7d7b5c69ee630,0,cyy,2019-01-22 10:36:18+08:00,['c1bfe3d7182c6e61879cfe9568c898c402654962'],2,0,2,1249289,1,0,0,0,3230
c349cdb2952497c5a1ecbf1dae84e2ce5aa6db1d,0,cyy,2019-01-22 10:36:18+08:00,['fc222b3a8741eda6f4ec874cf7e7d7b5c69ee630'],53,53,106,1249395,16,,,,3230
72a878ebe39c3b4611dc2915dbc2080bafa082b3,0,cyy,2019-01-22 10:36:18+08:00,['c349cdb2952497c5a1ecbf1dae84e2ce5aa6db1d'],2,2,4,1249399,1,,,,3230
f6460fa00b0d9705ad1b88435aebc5aad9f0da7d,1,cyy,2019-01-22 10:38:14+08:00,['72a878ebe39c3b4611dc2915dbc2080bafa082b3'],7,6,13,1249412,2,,,,3230
f7a4ead00d7988e76d2a22758f9e674644582620,0,cyy,2019-01-22 10:38:14+08:00,['f6460fa00b0d9705ad1b88435aebc5aad9f0da7d'],7,7,14,1249426,1,,,,3230
9fed90104ce08b85f7b7d2b9d707cb07562968ff,0,cyy,2019-01-22 10:38:15+08:00,['f7a4ead00d7988e76d2a22758f9e674644582620'],7,3,10,1249436,5,1,0,0,3230
f1eadad76edb3c680b9b964601d440ea05df02ca,0,James E. King III,2019-01-21 22:24:01-05:00,['ef32bc10b70aa2926957fd8f35691563234f08b6'],77,72,149,1249585,24,,,,3230
c28a739b8cb62fca9ea869d8d157c0b1d64565b8,0,James E. King III,2019-01-21 22:25:40-05:00,['f1eadad76edb3c680b9b964601d440ea05df02ca'],1,17,18,1249603,3,0.8,0.8,0.8,3230
cd9e8c9bf75d7aaae7fed1cf3e19f8d25e49a2cf,0,James E. King III,2019-01-22 00:00:53-05:00,['c28a739b8cb62fca9ea869d8d157c0b1d64565b8'],7,7,14,1249617,1,,,,3230
8cd3f92ff7c0104c6b460c19c16aca3cefcf517a,0,cyy,2019-01-22 16:28:15+08:00,['9fed90104ce08b85f7b7d2b9d707cb07562968ff'],0,11,11,1249628,1,,,,3230
5870cc81e8c716cf938c8f077549548885d30dcd,0,James E. King III,2019-01-22 09:37:31-05:00,['cd9e8c9bf75d7aaae7fed1cf3e19f8d25e49a2cf'],9,0,9,1249637,1,,,,3230
b2a4afec2ac11ee78bc4f094e552150191316258,0,James E. King III,2019-01-22 09:38:17-05:00,['5870cc81e8c716cf938c8f077549548885d30dcd'],3,0,3,1249640,1,,,,3230
dd63da19fad25ff8379f9505e626b16f45593e57,0,GitHub,2019-01-22 09:40:21-05:00,"['b2a4afec2ac11ee78bc4f094e552150191316258', '8cd3f92ff7c0104c6b460c19c16aca3cefcf517a']",514,194,708,1250348,46,,,,3230
0cd2099fa327caca294f4bf83ac85aa924e2db47,0,James E. King III,2019-01-22 09:50:26-05:00,['dd63da19fad25ff8379f9505e626b16f45593e57'],0,2,2,1250350,1,,,,3231
0c93bb69032e7dd234a15efc75c19e9eecd27276,1,James E. King III,2019-01-22 11:14:05-05:00,['0cd2099fa327caca294f4bf83ac85aa924e2db47'],20,42,62,1250412,1,1,1,1,3231
98f379ece17c8acb6a91cb3fd5b16acc3f0d1698,0,James E. King III,2019-01-23 09:24:32-05:00,['0c93bb69032e7dd234a15efc75c19e9eecd27276'],22,39,61,1250473,9,,,,3231
022b8bf91c83bd63f637f88a178a095d5d04b85f,0,James E. King III,2019-01-23 14:09:06-05:00,['98f379ece17c8acb6a91cb3fd5b16acc3f0d1698'],1,1,2,1250475,1,,,,3231
328e437f2653ddd40259c41959d806f7c0a074b9,0,James E. King III,2019-01-24 07:46:13-05:00,['022b8bf91c83bd63f637f88a178a095d5d04b85f'],0,14,14,1250489,1,,,,3231
22749ac376b10982eb5fa5a32ba336b20e1e6344,0,James E. King III,2019-01-24 07:57:20-05:00,['328e437f2653ddd40259c41959d806f7c0a074b9'],1,3,4,1250493,1,,,,3231
b1d63e7190fb1e4a2d87a9be42f3d4b7f17305fd,1,James E. King III,2019-01-24 12:20:30-05:00,['22749ac376b10982eb5fa5a32ba336b20e1e6344'],204,687,891,1251384,25,,,,3242
f5de98aab38d3460ee7339c47b1bcf3467e1fd9e,0,James E. King III,2019-01-24 12:28:09-05:00,['b1d63e7190fb1e4a2d87a9be42f3d4b7f17305fd'],4,18,22,1251406,1,0,1,0,3242
67fbc1f6159602fbb0d5859f67edf760d40d155d,0,James E. King III,2019-01-24 12:29:33-05:00,['f5de98aab38d3460ee7339c47b1bcf3467e1fd9e'],4,18,22,1251428,1,0,1,0,3242
129bb3e10d7bf1a1965d31cb8f30c7ccd3f96ecb,0,James E. King III,2019-01-25 10:03:37-05:00,['67fbc1f6159602fbb0d5859f67edf760d40d155d'],4,60,64,1251492,11,0,0.833333333,1,3242
8935c98046dbbdd36ede73c1525f1be9df8da5cd,0,James E. King III,2019-01-25 23:33:54-05:00,['129bb3e10d7bf1a1965d31cb8f30c7ccd3f96ecb'],71,80,151,1251643,54,,,,3242
b96c43892a9e89dfa61834505bb25357e80287da,0,James E. King III,2019-01-25 23:33:54-05:00,['8935c98046dbbdd36ede73c1525f1be9df8da5cd'],3096,344,3440,1255083,43,,,,3242
3f559940c23deed67c61e1e8fd92e1aa5a6f108d,0,James E. King III,2019-01-26 09:35:46-05:00,['b96c43892a9e89dfa61834505bb25357e80287da'],117,150,267,1255350,6,,,,3242
29f7f8f32f6bf88751e0ef3c8e3f2fba1aac5b8f,1,James E. King III,2019-01-26 23:53:38-05:00,['3f559940c23deed67c61e1e8fd92e1aa5a6f108d'],2474,36,2510,1257860,31,0.411463664,0.144319345,0.037871034,3242
5e23c4df5b8a2c7f36f807dc07dc897fd8a39763,0,James E. King III,2019-01-27 00:00:33-05:00,['29f7f8f32f6bf88751e0ef3c8e3f2fba1aac5b8f'],0,1,1,1257861,1,,,,3242
638c91f6be6e4417f0d5d8d57886c9b74afabfbd,0,James E. King III,2019-01-27 08:21:40-05:00,['5e23c4df5b8a2c7f36f807dc07dc897fd8a39763'],0,9,9,1257870,1,1,1,1,3242
4927179a5384a75932e459e290d424f8df8db50c,0,GitHub,2019-01-28 08:32:47-05:00,['638c91f6be6e4417f0d5d8d57886c9b74afabfbd'],9,27,36,1257906,1,,,,3242
1231930abd1d72b422deec967559caf3dc02dac7,0,James E. King III,2019-01-28 09:36:41-05:00,['4927179a5384a75932e459e290d424f8df8db50c'],0,16,16,1257922,3,,,,3242
aa0c8b35d8f78812de1d7803d6277a37d2ed593a,1,Jens Geyer,2019-01-28 23:12:28+01:00,['1231930abd1d72b422deec967559caf3dc02dac7'],5,17004,17009,1274931,124,0.367415494,0.599832039,0.77356708,3349
042580f53441efe1bc5c80c89351fcb30740659e,1,James E. King III,2019-01-29 09:48:12-05:00,['aa0c8b35d8f78812de1d7803d6277a37d2ed593a'],1200,1231,2431,1277362,143,0,0,0,3349
7489ed6ac8bad64e72fa83ec9d53e1eeddca6c23,0,James E. King III,2019-01-29 18:08:43-05:00,['53dd39833a08ce33582e5ff31fa18bb4735d6731'],3,1,4,1277366,1,1,1,0,3349
91a4fd7076a703975f1b901fbddbeee854ae0d7b,0,GitHub,2019-01-30 10:24:33-05:00,['042580f53441efe1bc5c80c89351fcb30740659e'],29,40,69,1277435,1,,,,3349
06ecaae4f3ff10a607d85e2c8ccb8fcaed3e68ab,0,GitHub,2019-01-30 10:29:08-05:00,['91a4fd7076a703975f1b901fbddbeee854ae0d7b'],5,5,10,1277445,1,,,,3349
4f7d93d8c35565fc9c5a43e4637505352c974c69,0,James E. King III,2019-01-30 14:59:22-05:00,['06ecaae4f3ff10a607d85e2c8ccb8fcaed3e68ab'],20,11,31,1277476,2,,,,3349
2ec93c8a2da2531755078ab6d5a65a96e26cf4c2,0,James E. King III,2019-01-30 20:14:27-05:00,['4f7d93d8c35565fc9c5a43e4637505352c974c69'],21,390,411,1277887,4,1,1,0,3349
f6511c904bcac1dd8c7e24aa3432326738865f1b,0,James E. King III,2019-01-31 23:07:58-05:00,['2ec93c8a2da2531755078ab6d5a65a96e26cf4c2'],2,14,16,1277903,2,0.428571429,0,0.285714286,3349
f95620d2b17ddd913f8108b39aa8138abe7d6027,1,James E. King III,2019-02-01 11:13:49-05:00,['f6511c904bcac1dd8c7e24aa3432326738865f1b'],14,66,80,1277983,7,0.857142857,0.857142857,0.214285714,3349
43f689d153b07e2c513964f537204824042bf99f,0,James E. King III,2019-02-01 11:13:49-05:00,['f95620d2b17ddd913f8108b39aa8138abe7d6027'],1,1,2,1277985,1,,,,3349
973c8552e0516cea35810d8870dbb33e4f05f9c5,0,James E. King III,2019-02-01 11:13:49-05:00,['43f689d153b07e2c513964f537204824042bf99f'],3,4,7,1277992,1,0,1,0,3349
84d9cd27f9a7a5062c9cc270583a001a7aaec196,1,James E. King III,2019-02-01 11:13:49-05:00,['973c8552e0516cea35810d8870dbb33e4f05f9c5'],18,59,77,1278069,1,1,1,0.619047619,3349
f15b4152b9ea8e73a24e37e3f54a999060ea68bf,1,James E. King III,2019-02-01 11:13:49-05:00,['84d9cd27f9a7a5062c9cc270583a001a7aaec196'],1,13,14,1278083,1,0,1,0.5,3349
2be45e566dd490aabf7a45ec3474545a0817024e,0,James E. King III,2019-02-01 11:13:49-05:00,['f15b4152b9ea8e73a24e37e3f54a999060ea68bf'],0,23,23,1278106,1,,,,3350
53bd0e6295547e76ab00913cfd62f8d040bd996c,0,James E. King III,2019-02-01 11:13:49-05:00,['2be45e566dd490aabf7a45ec3474545a0817024e'],4,8,12,1278118,4,,,,3350
3ec4031a4c6d685bcc02fa10dd13b2df58732b82,0,James E. King III,2019-02-01 11:13:49-05:00,['53bd0e6295547e76ab00913cfd62f8d040bd996c'],22,32,54,1278172,10,1,1,0.5,3351
1686c87024766015d510fc007aeef548a9c1a2a0,0,James E. King III,2019-02-01 14:31:58-05:00,['3ec4031a4c6d685bcc02fa10dd13b2df58732b82'],4,9,13,1278185,4,,,,3351
ef9405f9302831c0c7a23988aae1643747943c50,0,James E. King III,2019-02-01 16:14:19-05:00,['1686c87024766015d510fc007aeef548a9c1a2a0'],1,1,2,1278187,1,,,,3351
d77e0977260fa8d82d56836ed07cdca0f23cadcb,0,James E. King III,2019-02-02 01:17:46-05:00,['ef9405f9302831c0c7a23988aae1643747943c50'],1,1,2,1278189,1,,,,3351
4c57be0b609924f6516dd293985fc6d76f738c16,0,James E. King III,2019-02-02 22:10:41-05:00,['d77e0977260fa8d82d56836ed07cdca0f23cadcb'],30,60,90,1278279,4,0,0,1,3351
71afec0ea3fc700d5f0d1c46512723963bf1e2f7,1,James E. King III,2019-02-02 22:10:41-05:00,['4c57be0b609924f6516dd293985fc6d76f738c16'],9,20,29,1278308,2,0,1,1,3351
8fdb7587e688ae66a0e30e9f22bf8dc09599b2e9,0,James E. King III,2019-02-04 13:57:21-05:00,['71afec0ea3fc700d5f0d1c46512723963bf1e2f7'],4,32,36,1278344,8,,,,3352
adde44b0f542c97dc7e9b2678be53705006c05e3,1,Jens Geyer,2019-02-05 09:08:24+01:00,['8fdb7587e688ae66a0e30e9f22bf8dc09599b2e9'],111,258,369,1278713,9,0.094736842,0.115789474,1,3352
4a898564f936b39d45490f370737ce55d4c2b3f5,1,James E. King III,2019-02-06 16:07:19-05:00,['adde44b0f542c97dc7e9b2678be53705006c05e3'],1,1,2,1278715,1,,,,3352
a6a3a787ec3d3bd71b276e85c9a02a53ad1105c4,0,James E. King III,2019-02-07 09:27:33-05:00,['4a898564f936b39d45490f370737ce55d4c2b3f5'],9,125,134,1278849,8,1,0,0.333333333,3355
fc6c15c83de4f9d34e570c1f1465e7a1f6abc798,0,James E. King III,2019-02-07 17:16:59-05:00,['a6a3a787ec3d3bd71b276e85c9a02a53ad1105c4'],9,7,16,1278865,1,,,,3355
e44f6a9e06aa0ae42463a791357c0e5c18020c59,0,James E. King III,2019-02-07 20:00:16-05:00,['fc6c15c83de4f9d34e570c1f1465e7a1f6abc798'],11,11,22,1278887,4,,,,3355
74a3e0923d9425fd0c3c854b770782148f91ec19,1,James E. King III,2019-02-08 00:34:01-05:00,['e44f6a9e06aa0ae42463a791357c0e5c18020c59'],11,24,35,1278922,2,0,0.75,0.25,3355
647501693bd14256df8839c13cb03659bdee4202,1,James E. King III,2019-02-08 00:40:59-05:00,['74a3e0923d9425fd0c3c854b770782148f91ec19'],659,635,1294,1280216,66,1,1,0.043478261,3355
9804ab983a6c43dec56e0dcc4155cc2c21073822,1,James E. King III,2019-02-08 17:16:17-05:00,['647501693bd14256df8839c13cb03659bdee4202'],41,260,301,1280517,7,0.588235294,0.156862745,0.921568627,3355
6c26e098cab78a965ff14460f2fee52e6940b2ed,0,James E. King III,2019-02-09 10:44:53-05:00,['9804ab983a6c43dec56e0dcc4155cc2c21073822'],4,19,23,1280540,4,,,,3355
2b70c1df2bb2c1667f30dff6d4b263459fabe91a,0,James E. King III,2019-02-09 10:47:31-05:00,['6c26e098cab78a965ff14460f2fee52e6940b2ed'],1,1,2,1280542,1,,,,3355
e53d23c16c806c6da62ebaa7f205328cf710d9a5,0,James E. King III,2019-02-10 13:11:46-05:00,['2b70c1df2bb2c1667f30dff6d4b263459fabe91a'],1,6,7,1280549,5,,,,3355
393f6c93e1a65b7be74d79b5a6b00f878e88a630,0,James E. King III,2019-02-11 17:46:30-05:00,['e53d23c16c806c6da62ebaa7f205328cf710d9a5'],40,67,107,1280656,6,0.34375,0.46875,0.75,3355
3ca88065dfdb24c5bad6fbd1e3a7e01812628d3b,0,James E. King III,2019-02-12 13:26:45-05:00,['393f6c93e1a65b7be74d79b5a6b00f878e88a630'],0,2,2,1280658,1,,,,3355
dbc1f8def5018ce5d85d38b9875c6c6b6b424478,0,GitHub,2019-02-14 16:46:38-05:00,['3ca88065dfdb24c5bad6fbd1e3a7e01812628d3b'],62,73,135,1280793,16,0,0,0,3355
b000bc02df16a16a21d0fe3467227c3bc6d62a0c,0,GitHub,2019-02-14 17:58:04-05:00,['dbc1f8def5018ce5d85d38b9875c6c6b6b424478'],34,3,37,1280830,1,,,,3355
6b3f7d92f9dc231cb7ae1606dd15d8faad38be1a,0,James E. King III,2019-02-14 19:17:01-05:00,['b000bc02df16a16a21d0fe3467227c3bc6d62a0c'],5,5,10,1280840,1,,,,3355
c6b019affd5f6b9598069e3d5d3f78dec035cb1a,1,James E. King III,2019-02-15 13:55:11-05:00,['6b3f7d92f9dc231cb7ae1606dd15d8faad38be1a'],158,60,218,1281058,2,0.989130435,0.945652174,1,3355
a4ee1f281bc4ec4b08efe3a5b3408738d7f9f516,0,James E. King III,2019-02-22 06:21:28-05:00,['c6b019affd5f6b9598069e3d5d3f78dec035cb1a'],1,1,2,1281060,1,,,,3355
ddd2224e9c91207b1e90a3702278b17060a3dbb7,1,James E. King III,2019-02-22 06:37:49-05:00,['a4ee1f281bc4ec4b08efe3a5b3408738d7f9f516'],5,717,722,1281782,13,0.696470588,0.795294118,0.971764706,3359
36d4552532f46128fcca12bb3fa0b72e6fcdd817,0,James E. King III,2019-02-22 08:22:23-05:00,['ddd2224e9c91207b1e90a3702278b17060a3dbb7'],53,77,130,1281912,1,,,,3359
c63eacc684f4e4bada8381a9f8c06ea4644f6def,0,James E. King III,2019-02-22 09:11:35-05:00,['36d4552532f46128fcca12bb3fa0b72e6fcdd817'],1,1,2,1281914,1,,,,3359
6e5c0f6e315ea1cd8526789558bfd10d6cee2173,0,James E. King III,2019-02-22 09:14:17-05:00,['c63eacc684f4e4bada8381a9f8c06ea4644f6def'],2,2,4,1281918,1,,,,3359
264a3f318ed3e9e51573f67f963c8509786bcec2,0,Jens Geyer,2019-02-24 17:19:09+01:00,['6e5c0f6e315ea1cd8526789558bfd10d6cee2173'],6,25,31,1281949,3,0,1,1,3359
1e41be40d8c0bcccda698c57f77fb5cb2a66f044,0,Jens Geyer,2019-02-25 22:14:33+01:00,['384647d290e2e4a55a14b1b7ef1b7e66293a2c33'],1,1,2,1281951,1,,,,3359
798e90aa8715ed0deff68ef4784926fe2be5c0ea,0,Jens Geyer,2019-02-25 22:14:35+01:00,['1e41be40d8c0bcccda698c57f77fb5cb2a66f044'],62,73,135,1282086,16,0,0,0,3359
a34f78385f3cd5105d9d82a8922837ffab56e281,0,Jens Geyer,2019-02-25 23:21:18+01:00,['264a3f318ed3e9e51573f67f963c8509786bcec2'],4,2,6,1282092,1,,,,3359
7a51197bed35f39118e705fc85a2bf5229a3251e,0,James E. King III,2019-02-27 08:36:37-05:00,['7489ed6ac8bad64e72fa83ec9d53e1eeddca6c23'],24,8,32,1282124,3,,,,3359
e60b33d20d291f1ad6df3c3d1000efd821e5ea9c,0,James E. King III,2019-02-27 08:42:45-05:00,"['a34f78385f3cd5105d9d82a8922837ffab56e281', '7a51197bed35f39118e705fc85a2bf5229a3251e']",0,0,0,1282124,0,,,,3359
68ff6cddc055acd9f5611c297c7721a573745678,0,Jens Geyer,2019-02-28 08:39:59+01:00,['e60b33d20d291f1ad6df3c3d1000efd821e5ea9c'],42,160,202,1282326,9,0,0.377358491,0.075471698,3359
92c660f541fff657682f8239b6a995f3b71e6214,0,Jens Geyer,2019-03-06 23:13:09+01:00,['798e90aa8715ed0deff68ef4784926fe2be5c0ea'],6,25,31,1282357,3,0,1,1,3359
5e649973ebee6a0e272bff8979e92d1e8ce91737,0,Jens Geyer,2019-03-06 23:13:52+01:00,['92c660f541fff657682f8239b6a995f3b71e6214'],6,23,29,1282386,9,,,,3359
5ecaeb9d4a6a7ca8a553e3c346434f59cf265e78,0,Jens Geyer,2019-03-08 22:03:41+01:00,['5e649973ebee6a0e272bff8979e92d1e8ce91737'],13,41,54,1282440,7,,,,3359
52da9ab8011da02fbf8947f5b371094cbcf93af9,0,Jens Geyer,2019-03-08 22:08:21+01:00,['5ecaeb9d4a6a7ca8a553e3c346434f59cf265e78'],198,663,861,1283301,19,,,,3370
c685cb05d4138ae5477ed0ebd37f36aaa6531082,0,Jens Geyer,2019-03-08 22:08:23+01:00,['52da9ab8011da02fbf8947f5b371094cbcf93af9'],1,4,5,1283306,2,,,,3370
8d21d80cd151b3c4503955bf3eada915dd00f389,0,Jens Geyer,2019-03-08 22:08:23+01:00,['c685cb05d4138ae5477ed0ebd37f36aaa6531082'],78,105,183,1283489,66,,,,3370
17fa32f27556af3893beee9e1c364a4d997b3cbf,0,James E. King III,2019-03-09 09:19:54-05:00,['8d21d80cd151b3c4503955bf3eada915dd00f389'],3,2,5,1283494,1,,,,3370
a9b748bb0e02a2b6aaa3f39d09ec7f1fa47a0cf4,0,James E. King III,2019-03-09 10:25:29-05:00,['7a51197bed35f39118e705fc85a2bf5229a3251e'],1,7,8,1283502,1,,,,3370
dc1b301b311d8865eff2a49fad6343f7302fd9a9,0,GitHub,2019-03-09 10:37:24-05:00,['68ff6cddc055acd9f5611c297c7721a573745678'],2,2,4,1283506,1,,,,3370
22c412e42d00d84c687725475f7f935953938e5f,1,Jens Geyer,2019-03-13 09:09:09+01:00,['dc1b301b311d8865eff2a49fad6343f7302fd9a9'],2,32,34,1283540,2,0,1,0,3370
e6fa4aac4923abe7a9749809c8403b0a3e215f94,0,James E. King III,2019-03-13 08:50:49-04:00,"['22c412e42d00d84c687725475f7f935953938e5f', 'a9b748bb0e02a2b6aaa3f39d09ec7f1fa47a0cf4']",0,7,7,1283547,1,,,,3370
f26f4e1e6d7a56801ef676e503d9da93ad87f86a,0,GitHub,2019-03-13 13:39:00-04:00,['e6fa4aac4923abe7a9749809c8403b0a3e215f94'],2,13,15,1283562,1,,,,3370
1b770f233f4470d61d0d133f8cb014a544bb255c,1,Jens Geyer,2019-03-14 20:39:13+01:00,['f26f4e1e6d7a56801ef676e503d9da93ad87f86a'],37,39,76,1283638,1,1,1,1,3370
cf51a843911e7d8fefe1018cfce3560a593cd808,0,Jens Geyer,2019-03-14 21:13:54+01:00,['1b770f233f4470d61d0d133f8cb014a544bb255c'],26,6,32,1283670,1,0.066666667,0,0,3370
bf27637960aca6a6c3c5eb700a677e57b88b2409,0,Jens Geyer,2019-03-15 01:31:04+01:00,['cf51a843911e7d8fefe1018cfce3560a593cd808'],67,59,126,1283796,5,1,0,1,3370
0c4e96f956cd7e3dc527ef215b14c0407148f46c,1,James E. King III,2019-03-15 07:35:18-04:00,['bf27637960aca6a6c3c5eb700a677e57b88b2409'],3,101,104,1283900,5,,,,3372
b11f63c552b8ad47b23931177987ada0a92188cf,1,Jens Geyer,2019-03-15 22:01:37+01:00,['0c4e96f956cd7e3dc527ef215b14c0407148f46c'],10,35,45,1283945,4,0,1,1,3372
6378ff69a624594dc4552076c9a24c5ae81b97a5,0,Jens Geyer,2019-03-15 22:55:26+01:00,['b11f63c552b8ad47b23931177987ada0a92188cf'],9,24,33,1283978,3,0,1,0,3372
3b7798295b7aec5d65da9aff402d3292e25fe0ab,0,James E. King III,2019-03-16 00:35:50-04:00,['6378ff69a624594dc4552076c9a24c5ae81b97a5'],5,5,10,1283988,2,,,,3372
718ab46379b6b358f5b216b76e5031da04f0dcae,0,James E. King III,2019-03-16 00:39:48-04:00,['3b7798295b7aec5d65da9aff402d3292e25fe0ab'],1,1,2,1283990,1,,,,3372
00dd9b6ff576c995136912d5964c0cbfbf7d369b,0,Jens Geyer,2019-03-20 21:48:52+01:00,['718ab46379b6b358f5b216b76e5031da04f0dcae'],0,12,12,1284002,1,,,,3372
98c194103de11742b8785bdca49816265a84c32f,1,Jens Geyer,2019-03-21 09:01:50+01:00,['00dd9b6ff576c995136912d5964c0cbfbf7d369b'],7,28,35,1284037,1,0,0,0.25,3372
421444f2df2c27fcb1affdbd5bfac6cc972144fa,0,Jens Geyer,2019-03-21 09:03:13+01:00,['98c194103de11742b8785bdca49816265a84c32f'],42,38,80,1284117,11,1,1,1,3372
73a0272d66b07bb6d64fc8fafd8faca9df8d0e32,0,Jens Geyer,2019-03-21 09:03:19+01:00,['421444f2df2c27fcb1affdbd5bfac6cc972144fa'],1,5,6,1284123,1,0,1,1,3372
ddec431b4a402258c3b56b873908c98a15f22de4,0,James E. King III,2019-03-22 14:38:36-04:00,['73a0272d66b07bb6d64fc8fafd8faca9df8d0e32'],31,25,56,1284179,8,1,0,0,3372
7b94dd422117ffb6c646d1217c643efb80a8cf45,1,Jens Geyer,2019-03-27 00:17:55+01:00,['ddec431b4a402258c3b56b873908c98a15f22de4'],144,205,349,1284528,11,0,1,0.622222222,3372
0bc4712929b42d22424c31b11406d7afef950661,0,Jens Geyer,2019-03-31 16:16:56+02:00,['7b94dd422117ffb6c646d1217c643efb80a8cf45'],4,10,14,1284542,1,,,,3372
c9b1e29bc9e0702d7441383358d565e1e76ccea7,0,Jens Geyer,2019-04-04 00:02:03+02:00,['0bc4712929b42d22424c31b11406d7afef950661'],2,2,4,1284546,1,,,,3372
0223091b7049cbbddea675931771219de929fd59,1,Jens Geyer,2019-04-06 09:53:09+02:00,['c9b1e29bc9e0702d7441383358d565e1e76ccea7'],242,1473,1715,1286261,20,,,,3375
181d900a396a199083bf9e06da16214b720aacbc,0,Danny Browning,2019-04-15 09:55:04-06:00,['0223091b7049cbbddea675931771219de929fd59'],8,13,21,1286282,4,,,,3375
2135a361a5d3767b6d48c70acff4b2b6577e6d9c,0,James E. King III,2019-04-16 10:27:03-04:00,['0223091b7049cbbddea675931771219de929fd59'],1,1,2,1286284,1,,,,3375
e26269e7b3f64a59a699baab841d11f1c03fed50,0,GitHub,2019-04-19 02:15:17+02:00,"['2135a361a5d3767b6d48c70acff4b2b6577e6d9c', '181d900a396a199083bf9e06da16214b720aacbc']",8,13,21,1286305,4,,,,3375
2ff952b0af4035bcb71d8d73d9eb75df31983544,0,Jens Geyer,2019-04-19 16:07:29+02:00,['e26269e7b3f64a59a699baab841d11f1c03fed50'],17,17,34,1286339,1,,,,3375
8f327f24eeb6ca4c2cdb99a8c5e5a1ce93b29bf6,0,Jens Geyer,2019-04-28 00:31:57+02:00,['2ff952b0af4035bcb71d8d73d9eb75df31983544'],150,0,150,1286489,1,0.396039604,0.396039604,0,3375
366cc3dee0f279b652644ae96b05fabd6fae2e06,0,Jens Geyer,2019-04-28 23:51:34+02:00,['8f327f24eeb6ca4c2cdb99a8c5e5a1ce93b29bf6'],2,3,5,1286494,1,0,0,1,3375
cc13de4f87bda658d138b4f9b47f55202be4ac51,0,Jens Geyer,2019-05-03 22:58:53+02:00,['366cc3dee0f279b652644ae96b05fabd6fae2e06'],4,9,13,1286507,3,0,0,0,3375
65d5f84507b69118c8c9f664f635652ba00ae346,0,Jens Geyer,2019-05-03 23:10:16+02:00,['cc13de4f87bda658d138b4f9b47f55202be4ac51'],0,0,0,1286507,1,,,,3375
8d554f503ee8b10e2a225e4e755158e494d40983,0,Jens Geyer,2019-05-04 12:13:11+02:00,['65d5f84507b69118c8c9f664f635652ba00ae346'],2,13,15,1286522,1,1,1,0.4,3375
27d8387c49a49fcf193893f834e9766ae0b051c1,0,Jens Geyer,2019-05-04 12:22:47+02:00,['8d554f503ee8b10e2a225e4e755158e494d40983'],6,12,18,1286540,1,1,1,0,3375
9ecdce3fe00931cebda39357b31b655236ab9221,1,James E. King III,2019-05-04 21:52:29-04:00,['27d8387c49a49fcf193893f834e9766ae0b051c1'],4,12,16,1286556,2,,,,3375
ee8caca54ef51e05c7eee8d67e3c63cd73081e8a,0,James E. King III,2019-05-04 21:52:29-04:00,['9ecdce3fe00931cebda39357b31b655236ab9221'],17,20,37,1286593,6,,,,3375
acdd4226c210336e9e15eb812e5932a645fcd5ce,0,James E. King III,2019-05-04 21:52:29-04:00,['ee8caca54ef51e05c7eee8d67e3c63cd73081e8a'],4,1,5,1286598,2,,,,3375
14a9a120a859c2e101bcd5f529693139bf9aef7a,0,Jens Geyer,2019-05-10 00:20:25+02:00,['acdd4226c210336e9e15eb812e5932a645fcd5ce'],0,3,3,1286601,1,,,,3375
8f7487e1086d8da6baff3376679436e526dd8fd0,1,Jens Geyer,2019-05-10 00:39:30+02:00,['14a9a120a859c2e101bcd5f529693139bf9aef7a'],130,194,324,1286925,5,0,0,0,3375
e0e1a088d6857fd5ca9044c0a330fb2ad54020b4,0,Duru Can Celasun,2019-05-10 21:08:07+02:00,['8f7487e1086d8da6baff3376679436e526dd8fd0'],2,16,18,1286943,2,,,,3376
85431d9c6a4695c5fbdeccc34e60de6c6ecf7225,0,Jens Geyer,2019-05-10 22:49:20+02:00,['e0e1a088d6857fd5ca9044c0a330fb2ad54020b4'],4,7,11,1286954,2,,,,3376
522f873e1ee916d599c61c274e13fa0f31a8b12d,0,James E. King III,2019-05-10 18:47:27-04:00,['85431d9c6a4695c5fbdeccc34e60de6c6ecf7225'],14,14,28,1286982,1,,,,3376
a5dbb011fd5682db3406c91d02f17d9d019daa77,0,Jens Geyer,2019-05-11 18:46:48+02:00,['522f873e1ee916d599c61c274e13fa0f31a8b12d'],1,1,2,1286984,1,,,,3376
f3d4d51d429015cd14229ae16b242038dffe5fa4,0,James E. King III,2019-05-12 07:07:28-04:00,['a5dbb011fd5682db3406c91d02f17d9d019daa77'],1,2,3,1286987,1,1,1,1,3376
ce32ed70124f4213894f2c0cfdb76bf624ce62b6,0,James E. King III,2019-05-12 07:08:07-04:00,['f3d4d51d429015cd14229ae16b242038dffe5fa4'],3,7,10,1286997,1,,,,3376
b808a11559644cc385fe403a06ef8c626149b9b1,0,James E. King III,2019-05-12 07:22:05-04:00,['ce32ed70124f4213894f2c0cfdb76bf624ce62b6'],1,1,2,1286999,1,,,,3376
4ffe76351eac93fa2f2632241544e10e80b2b11e,0,James E. King III,2019-05-13 06:52:19-04:00,['b808a11559644cc385fe403a06ef8c626149b9b1'],14,10,24,1287023,5,,,,3376
6ba58e9a662e9c61b63e1bff68b374d6bba848ce,0,GitHub,2019-05-13 07:21:21-04:00,['4ffe76351eac93fa2f2632241544e10e80b2b11e'],9,15,24,1287047,1,,,,3376
6b6a8279aba29a67f005f5e498e88519cdb85049,0,James E. King III,2019-05-13 16:53:57-04:00,['6ba58e9a662e9c61b63e1bff68b374d6bba848ce'],2,1,3,1287050,1,0,0,0,3376
b261f3c0f114be31ef0f9a103dc4d2baa7c4fc3f,0,James E. King III,2019-05-13 16:53:57-04:00,['6b6a8279aba29a67f005f5e498e88519cdb85049'],0,60,60,1287110,1,0.357142857,1,1,3377
79c23377057f5bbb2d52097eb13073db2d69db8c,0,James E. King III,2019-05-14 06:15:48-04:00,['b261f3c0f114be31ef0f9a103dc4d2baa7c4fc3f'],1,6,7,1287117,1,,,,3377
c035eca3c672511779440bd0779ce5bc93d5c327,0,James E. King III,2019-05-14 14:26:48-04:00,['79c23377057f5bbb2d52097eb13073db2d69db8c'],8,26,34,1287151,1,1,1,1,3377
370d7513f074d96007006a82fca4d45e72afe4da,0,James E. King III,2019-05-20 07:20:42-04:00,['c035eca3c672511779440bd0779ce5bc93d5c327'],1,1,2,1287153,1,,,,3377
057bebc1c346d6adcc2894d8f299c4276650d33d,0,James E. King III,2019-05-26 14:59:04-04:00,"['370d7513f074d96007006a82fca4d45e72afe4da', '17fa32f27556af3893beee9e1c364a4d997b3cbf']",2,6,8,1287161,4,,,,3377
5a17b13ebcba71181498ac3ccfa1e8aa04018a72,1,Jens Geyer,2019-06-04 22:31:58+02:00,['057bebc1c346d6adcc2894d8f299c4276650d33d'],558,928,1486,1288647,27,0.901098901,0.763736264,1,3379
936944384fc925af696a1e3cec8dad33f94c7cb3,0,Jens Geyer,2019-06-05 22:03:14+02:00,['5a17b13ebcba71181498ac3ccfa1e8aa04018a72'],1,0,1,1288648,1,1,1,1,3379
47f6317336b2d8fbd1249a1a49aa561ee052719f,0,Jens Geyer,2019-06-07 22:26:53+02:00,['936944384fc925af696a1e3cec8dad33f94c7cb3'],4,249,253,1288901,5,,,,3379
83ff75377706eee2033f8de0208be2a61de5fbc6,1,Jens Geyer,2019-06-07 22:26:55+02:00,['47f6317336b2d8fbd1249a1a49aa561ee052719f'],14,253,267,1289168,5,,,,3379
b342bd9a614b792a566291350c89aec4e50dbd2c,0,Jens Geyer,2019-06-07 22:31:26+02:00,['83ff75377706eee2033f8de0208be2a61de5fbc6'],1,359,360,1289528,5,,,,3381
19fdca82c2e61bd42f92a502a91a07b9dc74b5d2,0,Jens Geyer,2019-06-12 22:09:58+02:00,['b342bd9a614b792a566291350c89aec4e50dbd2c'],17,32,49,1289577,1,,,,3381
5eef01f231b1e7b33d1ebfb65aeb136f851b350b,0,Duru Can Celasun,2019-06-13 19:49:45+02:00,['19fdca82c2e61bd42f92a502a91a07b9dc74b5d2'],2,10,12,1289589,2,0,0,0,3381
823474ec89355f72d3f0720ae5dacc2036d41c03,0,Jens Geyer,2019-06-14 22:42:15+02:00,['5eef01f231b1e7b33d1ebfb65aeb136f851b350b'],51,38,89,1289678,1,0.857142857,0.857142857,0.142857143,3381
4d46c1124450eeb77d2a6adc7ea5fab304bfeb4a,1,Duru Can Celasun,2019-06-19 22:52:24+02:00,['823474ec89355f72d3f0720ae5dacc2036d41c03'],9,1182,1191,1290869,12,0.437057992,0.46251768,0.973125884,3385
433a649a36ce9c78793128391e8466e9e96a9482,1,Jens Geyer,2019-06-19 23:32:19+02:00,['4d46c1124450eeb77d2a6adc7ea5fab304bfeb4a'],9,72,81,1290950,2,,,,3385
96c6113dda9869b7e2d4318bc0bce4f12f3ca3d2,0,Jens Geyer,2019-06-21 01:48:31+02:00,['433a649a36ce9c78793128391e8466e9e96a9482'],41,46,87,1291037,1,0,0,1,3385
3f0d4447919a7b358e60b09ab919bbe52758cc98,0,James E. King III,2019-06-21 06:38:32-04:00,['96c6113dda9869b7e2d4318bc0bce4f12f3ca3d2'],38,411,449,1291486,11,0.477272727,0.477272727,0.962121212,3390
29ecfaba536984e0a41fb1f1bcb1520640dd5471,0,James E. King III,2019-06-21 07:30:13-04:00,['3f0d4447919a7b358e60b09ab919bbe52758cc98'],2,2,4,1291490,1,,,,3390
a85d532bb397ecfab59afa079da1fe776548af08,0,James E. King III,2019-06-21 11:21:40-04:00,['29ecfaba536984e0a41fb1f1bcb1520640dd5471'],4,10,14,1291504,1,,,,3390
95870f06cdee04b9ec8a263f8c71597a3b95678a,0,James E. King III,2019-06-21 15:33:55-04:00,['a85d532bb397ecfab59afa079da1fe776548af08'],2,2,4,1291508,1,,,,3390
19505c3de3f235b71da46b971c3ce38d59db1f22,0,Jens Geyer,2019-06-22 01:03:55+02:00,['95870f06cdee04b9ec8a263f8c71597a3b95678a'],2,29,31,1291539,2,,,,3390
1e808af7b319802527517a7161d4e3edbde6f5b3,0,Jens Geyer,2019-06-22 10:27:57+02:00,['19505c3de3f235b71da46b971c3ce38d59db1f22'],1,5,6,1291545,1,0,1,1,3390
99ae730c5dac4c7a16e1d706ee56ca3e132fce29,0,James E. King III,2019-06-23 08:37:12-04:00,['1e808af7b319802527517a7161d4e3edbde6f5b3'],1,1,2,1291547,1,,,,3390
d886ab291dbde2cac695b3586d41f278e4ffadfc,0,GitHub,2019-06-23 08:40:36-04:00,['99ae730c5dac4c7a16e1d706ee56ca3e132fce29'],3,4,7,1291554,1,,,,3390
03bf8482690026beeb7560a4f8d2ab7512edafd9,0,GitHub,2019-06-23 08:47:56-04:00,['d886ab291dbde2cac695b3586d41f278e4ffadfc'],1,1,2,1291556,1,,,,3390
62238d1a6c2746d9afa3900bf83d50896e5fed20,0,Jens Geyer,2019-06-26 20:53:22+02:00,['03bf8482690026beeb7560a4f8d2ab7512edafd9'],1,1,2,1291558,1,,,,3390
c5068e297ccb32d3776673c752977714baf45391,0,James E. King III,2019-06-27 12:28:19-04:00,['62238d1a6c2746d9afa3900bf83d50896e5fed20'],10,10,20,1291578,1,,,,3390
bd1a273ab7979824952bab906b8e260f81b2bd15,0,Jens Geyer,2019-06-27 21:30:25+02:00,['c5068e297ccb32d3776673c752977714baf45391'],71,119,190,1291768,6,0,0.763636364,0,3390
d9019fc5a4a2cec110a9acd9f36a45ee34e3b7f2,1,Duru Can Celasun,2019-06-29 07:07:10+01:00,['bd1a273ab7979824952bab906b8e260f81b2bd15'],85,271,356,1292124,8,1,1,1,3396
0124c4d66b4e550c1c56c45e994f842b0638d8a2,0,James E. King III,2019-07-01 11:40:42-04:00,['d9019fc5a4a2cec110a9acd9f36a45ee34e3b7f2'],2,2,4,1292128,1,,,,3396
5338d99176756eefc21fe5c3f2eed3fab99ef715,0,James E. King III,2019-07-01 11:40:42-04:00,['0124c4d66b4e550c1c56c45e994f842b0638d8a2'],3,4,7,1292135,1,,,,3396
c2c1e1d709e65d37359cefeb5dc068913f83021b,1,James E. King III,2019-07-01 11:44:58-04:00,['5338d99176756eefc21fe5c3f2eed3fab99ef715'],4,4,8,1292143,4,,,,3396
a304b7c3a00a3c7a8547d3f66bbe6d128f344415,0,Jens Geyer,2019-07-01 19:22:42+02:00,['c2c1e1d709e65d37359cefeb5dc068913f83021b'],3,3,6,1292149,1,,,,3396
3711d9081095551c04980d328a2e4729d9730219,0,Jens Geyer,2019-07-01 19:39:52+02:00,['a304b7c3a00a3c7a8547d3f66bbe6d128f344415'],2,23,25,1292174,2,,,,3396
a392566e9b31edfb3f3da9bb09dc193215c285c2,0,James E. King III,2019-07-01 14:07:45-04:00,['3711d9081095551c04980d328a2e4729d9730219'],19,19,38,1292212,13,,,,3396
35cda2fa85ae9c94fc1296e2abcaa2ef733b7352,0,James E. King III,2019-07-01 14:09:28-04:00,['a392566e9b31edfb3f3da9bb09dc193215c285c2'],2,22,24,1292236,1,0,0.222222222,1,3396
6c847d2d028c155534aee006a77a5dca783233c4,1,James E. King III,2019-07-01 20:11:56-04:00,['35cda2fa85ae9c94fc1296e2abcaa2ef733b7352'],39,187,226,1292462,7,0,0,0.861538462,3396
9b49c96a6a064c40779966960ad1c98d90d6011c,0,James E. King III,2019-07-01 20:13:09-04:00,['6c847d2d028c155534aee006a77a5dca783233c4'],0,1,1,1292463,1,0,1,0,3396
6a61dfabbf6ae2fa9fbbc3996590ebdbe38e569f,0,James E. King III,2019-07-01 20:13:54-04:00,['9b49c96a6a064c40779966960ad1c98d90d6011c'],2,64,66,1292529,2,0.480769231,1,1,3396
1a2dee60b4384de2f6190caa85cf3e2a497c31b9,0,James E. King III,2019-07-01 20:15:03-04:00,['6a61dfabbf6ae2fa9fbbc3996590ebdbe38e569f'],1,1,2,1292531,1,,,,3396
93ff9b00531682ece08a1a43883e55fd2aa83a15,1,James E. King III,2019-07-07 12:16:52-04:00,['1a2dee60b4384de2f6190caa85cf3e2a497c31b9'],941,178,1119,1293650,22,,,,3396
3131fe975ce2efd2887e41f86e73f7205a02a2a4,0,James E. King III,2019-07-07 12:16:52-04:00,['93ff9b00531682ece08a1a43883e55fd2aa83a15'],17,29,46,1293696,4,0,0.583333333,0.666666667,3396
08fea1640e3585b74bbbd9ec53db798df7fe1656,0,James E. King III,2019-07-07 12:16:52-04:00,['3131fe975ce2efd2887e41f86e73f7205a02a2a4'],15,23,38,1293734,1,,,,3396
f9435643d758f9b08937399abe7f721ec7d65fcf,0,James E. King III,2019-07-07 12:18:30-04:00,['08fea1640e3585b74bbbd9ec53db798df7fe1656'],1,1,2,1293736,1,,,,3396
08a6eb6e1f21aa15682e414e124d7ee1a51a39c7,0,James E. King III,2019-07-08 06:42:09-04:00,['f9435643d758f9b08937399abe7f721ec7d65fcf'],66,96,162,1293898,13,0,0,0,3396
c35ed736d26a1dfd8965ae197a67904ed9b4fba3,1,James E. King III,2019-07-08 09:56:59-04:00,['08a6eb6e1f21aa15682e414e124d7ee1a51a39c7'],62,40,102,1294000,5,0,0,0,3396
178891f7d62adc98d1d1e661a0c26dd6a67ee50b,0,James E. King III,2019-07-08 09:56:59-04:00,['c35ed736d26a1dfd8965ae197a67904ed9b4fba3'],3,3,6,1294006,2,,,,3396
234e80e1b9acb1bc778c7adfaa6cb695d922d5f0,0,James E. King III,2019-07-08 13:06:21-04:00,['178891f7d62adc98d1d1e661a0c26dd6a67ee50b'],1,5,6,1294012,1,1,1,0,3396
286eee16b147a302ddc7b10740c5e5401ebbec17,0,James E. King III,2019-07-08 13:07:04-04:00,['234e80e1b9acb1bc778c7adfaa6cb695d922d5f0'],2,2,4,1294016,1,1,1,1,3396
49aab657b95e0b0955cb487fefb794ae2f83fd98,0,GitHub,2019-07-11 06:55:28-04:00,['286eee16b147a302ddc7b10740c5e5401ebbec17'],4,5,9,1294025,1,,,,3396
f34b50fdc582d8e625f5d6fe01d7f85ead5cc903,0,James E. King III,2019-07-15 07:04:35-04:00,['49aab657b95e0b0955cb487fefb794ae2f83fd98'],0,40,40,1294065,1,,,,3397
4c847372eb9af8ec0b21ace31840eaabfdf32660,0,Duru Can Celasun,2019-07-15 12:46:25+01:00,['f34b50fdc582d8e625f5d6fe01d7f85ead5cc903'],9,5,14,1294079,1,0,0,1,3397
90a044659878f3581aba922dbde1ed4bd7918678,1,James E. King III,2019-07-23 22:50:28-04:00,['4c847372eb9af8ec0b21ace31840eaabfdf32660'],0,285,285,1294364,1,,,,3398
ebb6b2ed68a4e0a986ce3a7797fb4ae054aa23ac,1,Duru Can Celasun,2019-07-24 16:42:06+01:00,['90a044659878f3581aba922dbde1ed4bd7918678'],0,26,26,1294390,1,1,1,1,3398
bb311a772e0a6fc142387abc3489a103662ea187,0,James E. King III,2019-07-27 16:48:57-04:00,['ebb6b2ed68a4e0a986ce3a7797fb4ae054aa23ac'],0,2,2,1294392,1,1,1,1,3398
6ae2b189efbe83caa11d341e69359159a773525e,1,Duru Can Celasun,2019-08-05 12:59:08+01:00,['bb311a772e0a6fc142387abc3489a103662ea187'],0,15,15,1294407,2,1,1,1,3398
b1002a71fb3838039d3442420c604999551311e9,1,Duru Can Celasun,2019-08-05 21:03:02+01:00,['6ae2b189efbe83caa11d341e69359159a773525e'],2,212,214,1294621,5,0.516949153,0.855932203,0.940677966,3400
3e95c533be4489ff2cb82118e886ed93225d30fc,0,Duru Can Celasun,2019-08-07 09:04:46+01:00,['b1002a71fb3838039d3442420c604999551311e9'],22,54,76,1294697,1,1,1,1,3400
74d6d9d3d6400d1672f48b4acf5bc7d1260ad96d,0,Jim King,2019-08-11 07:54:36-04:00,['3e95c533be4489ff2cb82118e886ed93225d30fc'],1,1,2,1294699,1,,,,3400
26ef904600edc810f6514605c0611b7442a4c64e,0,Duru Can Celasun,2019-08-19 08:18:22+01:00,['74d6d9d3d6400d1672f48b4acf5bc7d1260ad96d'],1,86,87,1294786,4,0.216666667,0.65,0.866666667,3400
8c7ab5f7c26a2e5d0300818d749912e562a334c4,0,Issacpeng,2019-08-20 16:01:58+08:00,['74d6d9d3d6400d1672f48b4acf5bc7d1260ad96d'],2,2,4,1294790,2,,,,3400
9cf37be1f1c86626ddadb277ff6cb17b2fb27da0,0,Jens Geyer,2019-08-20 21:28:38+02:00,['26ef904600edc810f6514605c0611b7442a4c64e'],2,3,5,1294795,2,,,,3400
9027a728ee65bbc92cc12e0c62eed1aadf6be415,0,GitHub,2019-08-21 22:03:05+02:00,"['9cf37be1f1c86626ddadb277ff6cb17b2fb27da0', '8c7ab5f7c26a2e5d0300818d749912e562a334c4']",2,2,4,1294799,2,,,,3400
2ff4b13df4fcadf5fba48f23550b09c13390c164,0,Jens Geyer,2019-08-22 22:43:15+02:00,['9027a728ee65bbc92cc12e0c62eed1aadf6be415'],0,2,2,1294801,1,0,0,1,3400
44fcfabc37e98badfe03e1349c728842d3fdf321,0,Jens Geyer,2019-08-23 09:00:02+02:00,['2ff4b13df4fcadf5fba48f23550b09c13390c164'],1,1,2,1294803,1,,,,3400
81f5e10ec420ae01675b61f212939a93128438f0,0,Jens Geyer,2019-08-24 16:13:34+02:00,['44fcfabc37e98badfe03e1349c728842d3fdf321'],8,8,16,1294819,1,,,,3400
693e19cf485cf22d32466d3478aaecbfb07010be,0,Jens Geyer,2019-08-25 00:20:55+02:00,['81f5e10ec420ae01675b61f212939a93128438f0'],1,1,2,1294821,1,,,,3400
a4fc3d42e9a9ab54f8e1341a60e98d9be1eabc55,0,Jens Geyer,2019-08-25 14:04:58+02:00,['693e19cf485cf22d32466d3478aaecbfb07010be'],1,24,25,1294846,7,,,,3403
a715f701bf4850b41b7f3fa016d16a9153319e1e,0,Jens Geyer,2019-08-28 22:56:35+02:00,['a4fc3d42e9a9ab54f8e1341a60e98d9be1eabc55'],58,119,177,1295023,4,,,,3403
942bd8403b0b5ece17cfd5df46118cfa39386808,0,Danny Browning,2019-09-06 10:28:24-06:00,['a715f701bf4850b41b7f3fa016d16a9153319e1e'],57,58,115,1295138,14,,,,3403
236032a8af4f772a21962d6e5316e6f7aa494b85,0,Danny Browning,2019-09-06 10:40:53-06:00,['942bd8403b0b5ece17cfd5df46118cfa39386808'],6,28,34,1295172,3,1,1,1,3404
8ff8abd6f22c23a94164fa45bec844238120ed6f,0,Jens Geyer,2019-09-11 00:41:49+02:00,['a715f701bf4850b41b7f3fa016d16a9153319e1e'],1,5,6,1295178,2,,,,3404
b7bd211699095e55fa4d74a35b6c4244946b7f70,0,Jens Geyer,2019-09-11 22:52:40+02:00,['8ff8abd6f22c23a94164fa45bec844238120ed6f'],1,5,6,1295184,1,1,1,1,3404
061eafb1fa2aa83068305cf0eb768930253e8710,0,Jens Geyer,2019-09-11 22:53:12+02:00,['b7bd211699095e55fa4d74a35b6c4244946b7f70'],1,5,6,1295190,1,,,,3404
f1bc6aef7d670533e34336a7b7602b8b38f9d278,0,Jens Geyer,2019-09-11 23:11:46+02:00,['061eafb1fa2aa83068305cf0eb768930253e8710'],2,2,4,1295194,1,,,,3404
77d96c18c3729bf3faeadff67e57e7e429f1d3cd,1,Jens Geyer,2019-09-11 23:35:26+02:00,['f1bc6aef7d670533e34336a7b7602b8b38f9d278'],57,58,115,1295309,14,,,,3404
b3745eea10cde93957882df56ef21f05f5e3cf6b,0,Duru Can Celasun,2019-09-20 16:15:04+01:00,['77d96c18c3729bf3faeadff67e57e7e429f1d3cd'],1,36,37,1295346,5,0,0,0,3405
5e9203b2b239794bac5338b638e3a9c30efc1932,0,Jens Geyer,2019-09-21 14:40:15+02:00,['b3745eea10cde93957882df56ef21f05f5e3cf6b'],1,1,2,1295348,1,,,,3405
2a95441275a1e137893d9c788885164b7c756bdc,0,Jens Geyer,2019-09-22 11:04:07+02:00,['5e9203b2b239794bac5338b638e3a9c30efc1932'],6,5,11,1295359,1,,,,3405
2d03630b618a105ae71ee73c008ac361334789c6,0,Jens Geyer,2019-09-22 11:38:29+02:00,['2a95441275a1e137893d9c788885164b7c756bdc'],3,3,6,1295365,2,,,,3405
786c019476dd5508c53314cf3b25c47fe3ec2ae8,0,GitHub,2019-09-23 08:41:30-04:00,"['2d03630b618a105ae71ee73c008ac361334789c6', '236032a8af4f772a21962d6e5316e6f7aa494b85']",6,28,34,1295399,3,,,,3405
4a97457a98cad0acba7065c61186e034e32e36f8,0,Duru Can Celasun,2019-09-30 12:28:11+01:00,['786c019476dd5508c53314cf3b25c47fe3ec2ae8'],2,2,4,1295403,1,,,,3405
d1ccd0a08fd82a1c58acd308fe533306362a73be,0,Duru Can Celasun,2019-10-02 00:15:44+01:00,['4a97457a98cad0acba7065c61186e034e32e36f8'],0,1,1,1295404,1,,,,3405
5a8cd9d1fbb8517915d80b851b4b3434f4ff5ba5,0,Jens Geyer,2019-10-06 12:17:19+02:00,['d1ccd0a08fd82a1c58acd308fe533306362a73be'],2,1,3,1295407,1,0,0,0,3405
fd2acd1521aea6f4570ce363e99fbfc0818f2dc2,0,Jens Geyer,2019-10-06 12:19:16+02:00,['5a8cd9d1fbb8517915d80b851b4b3434f4ff5ba5'],2,2,4,1295411,1,,,,3405
17424372f3adb28b9ec8352dff4b4e59d47700c2,0,Jens Geyer,2019-10-06 12:21:52+02:00,['fd2acd1521aea6f4570ce363e99fbfc0818f2dc2'],0,2,2,1295413,1,,,,3405
ec8c7c419b1c0318e5b34a1c6e9e939b9a8681fd,0,Duru Can Celasun,2019-10-08 22:51:19+01:00,['17424372f3adb28b9ec8352dff4b4e59d47700c2'],0,3,3,1295416,1,0,0,1,3405
3b5c40c6ea469ade1d537d558c43dfcd82d5d17f,0,Duru Can Celasun,2019-10-08 22:53:14+01:00,['ec8c7c419b1c0318e5b34a1c6e9e939b9a8681fd'],6,6,12,1295428,2,,,,3405
dfa74bc99e8c71d6b7d7091f103754e1ebfdf45a,0,Duru Can Celasun,2019-10-08 22:54:08+01:00,['3b5c40c6ea469ade1d537d558c43dfcd82d5d17f'],5,37,42,1295470,4,,,,3405
caf8904913172b8ed37374a91751d36f404adcee,0,Duru Can Celasun,2019-10-08 22:57:53+01:00,['dfa74bc99e8c71d6b7d7091f103754e1ebfdf45a'],1,1,2,1295472,1,,,,3405
d4c6b5632ffd4792a89d845592aa953573173f8f,0,Duru Can Celasun,2019-10-08 22:59:10+01:00,['caf8904913172b8ed37374a91751d36f404adcee'],1,1,2,1295474,1,,,,3405
80984289011604d43ec3282a3e8464fa08765f27,0,Duru Can Celasun,2019-10-08 23:06:30+01:00,['d4c6b5632ffd4792a89d845592aa953573173f8f'],0,41,41,1295515,1,,,,3405
4fc4661c3043c7499c4682229418d62562ca45af,0,Duru Can Celasun,2019-10-08 23:09:04+01:00,['80984289011604d43ec3282a3e8464fa08765f27'],1,0,1,1295516,1,0,0,0,3405
a152a0ad8898323c4f694cae586031d645eb8128,0,Duru Can Celasun,2019-10-08 23:18:30+01:00,['4fc4661c3043c7499c4682229418d62562ca45af'],9,12,21,1295537,1,0.5,0.5,0,3405
904f5619a9df6a8a3ac8f830e4dab7148c2d7777,0,Duru Can Celasun,2019-10-09 09:27:23+01:00,['a152a0ad8898323c4f694cae586031d645eb8128'],1,1,2,1295539,1,,,,3405
df8ef4b489e2b84ac6dbbf895be32d6fb2415c81,0,Duru Can Celasun,2019-10-09 09:33:29+01:00,['904f5619a9df6a8a3ac8f830e4dab7148c2d7777'],15,0,15,1295554,2,,,,3405
a0c5f32c31e5692ae28051899319cc6b03cfe291,0,D. Can Celasun,2019-10-09 11:41:47+01:00,['df8ef4b489e2b84ac6dbbf895be32d6fb2415c81'],3,3,6,1295560,2,,,,3405
224b43ec7e916d2d588ad356762553fe2181aea5,0,Jens Geyer,2019-10-10 01:28:55+02:00,['a0c5f32c31e5692ae28051899319cc6b03cfe291'],2,133,135,1295695,3,,,,3406
85d8162dcbfd17db3bb8232a2dbb870dd9908cc4,0,Jens Geyer,2019-10-10 01:38:05+02:00,['224b43ec7e916d2d588ad356762553fe2181aea5'],0,15,15,1295710,2,,,,3406
ab89b8b40ee593e344dafb6192fd6ef3b1357c8b,0,Duru Can Celasun,2019-10-10 12:50:50+01:00,['85d8162dcbfd17db3bb8232a2dbb870dd9908cc4'],4,3,7,1295717,2,,,,3406
a899fe84123b6511d8076645048f70592dfcac96,0,Jens Geyer,2019-10-11 00:27:00+02:00,['ab89b8b40ee593e344dafb6192fd6ef3b1357c8b'],0,8,8,1295725,3,0,0,0.6,3406
cecee50308fc7e6f77f55b3fd906c1c6c471fa2f,0,Jens Geyer,2019-10-11 19:05:55+02:00,['a899fe84123b6511d8076645048f70592dfcac96'],0,282,282,1296007,3,,,,3406
0f14e2f3f65ddab76bfae28b3343ba12157d93f5,0,Duru Can Celasun,2019-10-15 10:25:10+01:00,['a899fe84123b6511d8076645048f70592dfcac96'],0,356,356,1296363,5,0.097674419,0.809302326,1,3407
7cb8473bcd019deed508942cd628b606a544852e,0,Jens Geyer,2019-10-17 00:07:12+02:00,['0f14e2f3f65ddab76bfae28b3343ba12157d93f5'],1,1,2,1296365,1,,,,3407
a3fa0d928f7647aa6007e16ac81d76a3b5183d2c,0,Jens Geyer,2019-10-17 00:07:13+02:00,['7cb8473bcd019deed508942cd628b606a544852e'],0,282,282,1296647,3,,,,3407
e02559fd46b07035a4a41c9d2604765756e3745b,0,Jens Geyer,2019-10-17 20:31:24+02:00,['a3fa0d928f7647aa6007e16ac81d76a3b5183d2c'],43,43,86,1296733,33,,,,3407
dd14e869ce5262307f796fee20baee17eb00a608,0,Jens Geyer,2019-10-17 20:54:34+02:00,['e02559fd46b07035a4a41c9d2604765756e3745b'],14,14,28,1296761,1,,,,3407
b75e88a33d67ae05ef9b5fa001d2a63a2effe377,0,Jens Geyer,2019-10-17 23:47:40+02:00,['cecee50308fc7e6f77f55b3fd906c1c6c471fa2f'],2,5,7,1296768,3,,,,3407
4286054d3d8b81572d257ccaeca60fa86d3e5054,0,Jens Geyer,2019-10-17 23:49:41+02:00,"['dd14e869ce5262307f796fee20baee17eb00a608', 'b75e88a33d67ae05ef9b5fa001d2a63a2effe377']",0,2,2,1296770,2,,,,3407
5fe31ea7d728a2f0a4de4aae7479d6fe3ec93f5a,0,Jens Geyer,2019-10-17 23:51:36+02:00,['4286054d3d8b81572d257ccaeca60fa86d3e5054'],1,1,2,1296772,1,,,,3407
58efe895b5878b6cffc1b054b7a9a92fef041647,0,Jens Geyer,2019-10-18 00:15:23+02:00,['5fe31ea7d728a2f0a4de4aae7479d6fe3ec93f5a'],3,44,47,1296819,5,,,,3408
9f0548e05f1b1383cc122148d60cc40383ce599e,0,Jens Geyer,2019-10-18 00:26:47+02:00,['58efe895b5878b6cffc1b054b7a9a92fef041647'],1,1,2,1296821,1,,,,3408
538e36c645d6e56748c6af3ef80ef21b26646ed2,0,Duru Can Celasun,2019-10-18 14:09:01+01:00,['9f0548e05f1b1383cc122148d60cc40383ce599e'],3,43,46,1296867,5,,,,3409
76fa8c9a81621aae254e10c19c68b31b41f5b4b7,1,D. Can Celasun,2019-10-18 15:15:45+01:00,['538e36c645d6e56748c6af3ef80ef21b26646ed2'],8,19,27,1296894,3,,,,3409
6701dbb8e89f6550c7843e9b75b118998df471c3,0,Jens Geyer,2019-10-19 21:03:08+02:00,['76fa8c9a81621aae254e10c19c68b31b41f5b4b7'],3,3,6,1296900,1,,,,3409
616df98f00a594f133466aa7f94930c1bf85b24a,0,Jens Geyer,2019-10-20 00:12:14+02:00,['6701dbb8e89f6550c7843e9b75b118998df471c3'],34,36,70,1296970,26,,,,3409
7199741f440ef7de15e13755ea2371157c8cd298,0,Jens Geyer,2019-10-20 16:20:57+02:00,['616df98f00a594f133466aa7f94930c1bf85b24a'],8,11,19,1296989,6,,,,3409
3f3567a1143194712747fff9dd02b2162e2d14dd,0,Jens Geyer,2019-10-20 16:21:29+02:00,['7199741f440ef7de15e13755ea2371157c8cd298'],16623,105,16728,1313717,135,0.633626232,0.397235319,0.224389198,3409
6e4c581fddae9106c2c5a59c4d0bfbe6ad3e4560,0,Duru Can Celasun,2019-10-21 15:21:11+01:00,['3f3567a1143194712747fff9dd02b2162e2d14dd'],6,146,152,1313869,7,0.8,0.8,1,3411
9cb1c794cd39cfb276771f8e52f0306eb8d462fd,0,Qinghui Xu,2019-10-23 20:45:33+02:00,['6e4c581fddae9106c2c5a59c4d0bfbe6ad3e4560'],15,83,98,1313967,2,1,1,1,3412
c03e2aa196615bc3149d1829b8b8ed01e58c7aa1,1,Duru Can Celasun,2019-10-23 21:43:09+01:00,['6e4c581fddae9106c2c5a59c4d0bfbe6ad3e4560'],2,6,8,1313975,1,0,0,1,3412
e4870a3571475726dfd53997d7742044d71fd353,0,Duru Can Celasun,2019-10-24 21:23:30+01:00,['c03e2aa196615bc3149d1829b8b8ed01e58c7aa1'],55,149,204,1314179,4,1,1,0.766666667,3413
9ea48f362a578ee8556fcf3ca84215cefbc1b99e,0,Jens Geyer,2019-11-02 12:24:12+01:00,['e4870a3571475726dfd53997d7742044d71fd353'],14,14,28,1314207,1,,,,3413
b1d4b3afcccb64a68b846a55c4f8bb1a11aa56cb,0,Jens Geyer,2019-11-02 15:02:54+01:00,['9ea48f362a578ee8556fcf3ca84215cefbc1b99e'],1,3,4,1314211,1,0,0,0,3413
ec439548c531e5848a4e85684d666745d747926f,1,Jens Geyer,2019-11-02 17:34:23+01:00,['b1d4b3afcccb64a68b846a55c4f8bb1a11aa56cb'],35,43,78,1314289,21,,,,3413
43a93f1e6e7bc0d4247c8fe40c99cdcb8123b334,0,Jens Geyer,2019-11-03 18:34:24+01:00,['ec439548c531e5848a4e85684d666745d747926f'],1,1,2,1314291,1,,,,3413
bc75467e4426c76d201c83621f08fa211660b6c3,0,Jens Geyer,2019-11-03 18:39:38+01:00,['43a93f1e6e7bc0d4247c8fe40c99cdcb8123b334'],3,3,6,1314297,3,,,,3413
cf73b66cd83e2e883d00dff518d3c0250bb839cc,0,Jens Geyer,2019-11-03 18:42:11+01:00,['bc75467e4426c76d201c83621f08fa211660b6c3'],1,1,2,1314299,1,,,,3413
1ce7317cae2c580ded065db6dad54647e96d3359,0,Jens Geyer,2019-11-03 18:52:39+01:00,['cf73b66cd83e2e883d00dff518d3c0250bb839cc'],1,1,2,1314301,1,,,,3413
3adb44aa26023e4016ba844ab4bda32525d5c4fb,1,Jens Geyer,2019-11-03 18:59:39+01:00,['1ce7317cae2c580ded065db6dad54647e96d3359'],1,1,2,1314303,1,,,,3413
c5fadee94a88e4f5c8d8323305513fdb7ef552d9,1,Jens Geyer,2019-11-03 19:07:04+01:00,['3adb44aa26023e4016ba844ab4bda32525d5c4fb'],1,1,2,1314305,1,,,,3413
a5b2bf5b0bc82545b26b7a42bbf7b5dc9ef51b33,0,Jens Geyer,2019-11-03 19:07:13+01:00,['c5fadee94a88e4f5c8d8323305513fdb7ef552d9'],1,1,2,1314307,1,,,,3413
24045b7211318b7b62dce83a7f0e962e20292f1b,0,Qinghui Xu,2019-11-04 10:21:47+01:00,['9cb1c794cd39cfb276771f8e52f0306eb8d462fd'],1,1,2,1314309,1,,,,3413
f7b219791653d206a03d236e2bd69e79c4d4a392,0,Jens Geyer,2019-11-04 22:00:24+01:00,['a5b2bf5b0bc82545b26b7a42bbf7b5dc9ef51b33'],2,2,4,1314313,1,,,,3413
508d9951d5fd8a539788caff6d38f08db564d50b,0,Jens Geyer,2019-11-04 22:10:01+01:00,['f7b219791653d206a03d236e2bd69e79c4d4a392'],1,2,3,1314316,1,,,,3413
4653009035db96228e33e8965e432752b41c8ed1,1,Duru Can Celasun,2019-11-05 21:31:13+00:00,['508d9951d5fd8a539788caff6d38f08db564d50b'],15,29,44,1314360,2,1,1,1,3413
596e25f9b07f4eb626e8644b6cc18b93c417b4e5,0,Jens Geyer,2019-11-06 01:11:55+01:00,['4653009035db96228e33e8965e432752b41c8ed1'],2,2,4,1314364,1,,,,3413
963812ae62579f6040b805218d9e798e1e66b324,0,Duru Can Celasun,2019-11-08 09:02:00+00:00,['596e25f9b07f4eb626e8644b6cc18b93c417b4e5'],1,3,4,1314368,1,,,,3413
50caa4de84210d792632c61941c3bb4180f0c665,1,Jens Geyer,2019-11-08 19:24:59+01:00,['963812ae62579f6040b805218d9e798e1e66b324'],2,2,4,1314372,2,,,,3413
4c27181a06cf18154e9e1e8abeb711a75b5cf435,0,Duru Can Celasun,2019-11-09 19:20:09+00:00,['50caa4de84210d792632c61941c3bb4180f0c665'],1,237,238,1314610,3,0.58778626,0.961832061,1,3415
59694a796f824ffcde745065efa36b8d0ddf8275,1,Duru Can Celasun,2019-11-09 19:22:26+00:00,['4c27181a06cf18154e9e1e8abeb711a75b5cf435'],8,34,42,1314652,3,0.3,0.3,0,3415
24fa9d0728c5893b11901f6ffb25a9e74a4647c8,0,Duru Can Celasun,2019-11-09 22:21:09+00:00,['59694a796f824ffcde745065efa36b8d0ddf8275'],0,14,14,1314666,1,1,1,1,3415
9f11c1e545a9aa0db076e9b5be9b7e397e594f4a,0,Jens Geyer,2019-11-13 09:34:57+01:00,['24fa9d0728c5893b11901f6ffb25a9e74a4647c8'],81,291,372,1315038,3,,,,3415
fad7fd3e5a850c0f4bf57e7370fad359d575fdc6,0,Jens Geyer,2019-11-13 09:34:58+01:00,['9f11c1e545a9aa0db076e9b5be9b7e397e594f4a'],224,221,445,1315483,17,,,,3415
2646bd65b5ba499779e37ab2d19d67a7684cbdb3,0,Jens Geyer,2019-11-13 09:34:58+01:00,['fad7fd3e5a850c0f4bf57e7370fad359d575fdc6'],44,54,98,1315581,4,,,,3415
ed99455e2ec8ec9c8ed95540c63018d395737f30,0,Jens Geyer,2019-11-14 22:17:39+01:00,['2646bd65b5ba499779e37ab2d19d67a7684cbdb3'],368,507,875,1316456,6,,,,3416
41f47aff7ccc1a093eb5e48250377c1178babeec,0,Jens Geyer,2019-11-15 23:27:20+01:00,['ed99455e2ec8ec9c8ed95540c63018d395737f30'],117,625,742,1317198,14,,,,3416
528a0f0731cc98d8ba2ea4ee146e2d9b0cea9fc6,1,Jens Geyer,2019-11-18 20:17:03+01:00,['41f47aff7ccc1a093eb5e48250377c1178babeec'],6,119,125,1317323,3,,,,3416
225646b554e6c37de31657e11d907bf35d50679d,1,Jens Geyer,2019-11-20 03:04:00+01:00,['528a0f0731cc98d8ba2ea4ee146e2d9b0cea9fc6'],1,5,6,1317329,1,0,0,1,3416
f4475ff76fe3dcc1b3774d52bf28b333ab9acd01,1,GitHub,2019-11-20 15:31:35+00:00,['225646b554e6c37de31657e11d907bf35d50679d'],2,25,27,1317356,5,0,1,1,3419
261cad3417841a47d3f8caf46f344f0af7d41511,0,Jens Geyer,2019-11-21 22:26:09+01:00,['f4475ff76fe3dcc1b3774d52bf28b333ab9acd01'],160,182,342,1317698,12,0,0,0.791666667,3419
8ae80a7f8466e5c340388fcb1d797dc3779d9f80,0,Jens Geyer,2019-11-21 22:43:21+01:00,['261cad3417841a47d3f8caf46f344f0af7d41511'],0,24,24,1317722,2,0.8,1,1,3419
eacd1d48c85ea756fd5edd10d7c328ee11a0657f,0,Jens Geyer,2019-11-23 01:15:45+01:00,['8ae80a7f8466e5c340388fcb1d797dc3779d9f80'],81,282,363,1318085,25,0.623762376,0.881188119,0.435643564,3422
9d958a3caf5c82b25a00b0b6cd4ab431bc1fed18,0,Jens Geyer,2019-11-23 22:24:52+01:00,['eacd1d48c85ea756fd5edd10d7c328ee11a0657f'],97,14,111,1318196,3,0.242424242,0,0.166666667,3422
b541c6f2b126219867963c8b577b4c08d72e866d,0,Jens Geyer,2019-11-23 22:33:29+01:00,['9d958a3caf5c82b25a00b0b6cd4ab431bc1fed18'],24,8,32,1318228,2,1,0.5,0,3422
5080645cb0ffe52de9d82685b2ab2d6b03aa6f3e,0,Jens Geyer,2019-11-23 22:40:53+01:00,['b541c6f2b126219867963c8b577b4c08d72e866d'],19,162,181,1318409,13,0.223140496,0.504132231,1,3422
622937162aeccf2a27d9196937ebf7ead40036f5,0,Duru Can Celasun,2019-11-25 09:58:52+00:00,['5080645cb0ffe52de9d82685b2ab2d6b03aa6f3e'],13,81,94,1318503,3,0.896551724,1,1,3423
bf2cad9cfae28b602b5bb899e9becacee975057c,0,Duru Can Celasun,2019-11-25 21:40:52+00:00,['622937162aeccf2a27d9196937ebf7ead40036f5'],5,5,10,1318513,1,,,,3423
c140bb90b0c2ed6175afe8c9c579acd8ea9c7d0b,0,Jens Geyer,2019-11-27 22:24:12+01:00,['bf2cad9cfae28b602b5bb899e9becacee975057c'],11,6,17,1318530,3,,,,3423
a019cda66ceccdf9068c9f5e2c27f890c450f9ec,1,Jens Geyer,2019-11-28 00:52:47+01:00,['c140bb90b0c2ed6175afe8c9c579acd8ea9c7d0b'],725,725,1450,1319980,30,,,,3424
4266faef0e800db2c51d11419296c448fa815dc4,0,Jens Geyer,2019-11-28 21:34:32+01:00,['a019cda66ceccdf9068c9f5e2c27f890c450f9ec'],30,61,91,1320071,4,0,0,0.833333333,3424
98ce2c8f2b3bb5aaee3e67a5b461dd1a87685cc0,0,Marcin Pajkowski,2019-11-29 10:27:26+01:00,['4266faef0e800db2c51d11419296c448fa815dc4'],7,6,13,1320084,2,,,,3424
c63084193a8c2131267b7278823b76a726fcef7b,0,Jens Geyer,2019-12-02 19:29:38+01:00,['4266faef0e800db2c51d11419296c448fa815dc4'],8,8,16,1320100,3,,,,3424
b34680f01a09896cfbf3536b4b791e4d7c0ee0a3,1,Jens Geyer,2019-12-02 20:51:14+01:00,['c63084193a8c2131267b7278823b76a726fcef7b'],3,26,29,1320129,1,1,1,1,3424
9c6c6bf81a3c934e96378b26fc133f50cf4226a2,0,Jens Geyer,2019-12-02 21:03:35+01:00,['b34680f01a09896cfbf3536b4b791e4d7c0ee0a3'],1,1,2,1320131,1,,,,3424
1e049101c580fd2dfd044cb00e2489090199cf0a,0,Jens Geyer,2019-12-03 23:02:15+01:00,['9c6c6bf81a3c934e96378b26fc133f50cf4226a2'],0,13,13,1320144,1,0.111111111,0.333333333,0.666666667,3424
450bc69248043f0ea5ca336d786583ebf3e9d826,0,Jens Geyer,2019-12-03 23:28:18+01:00,['1e049101c580fd2dfd044cb00e2489090199cf0a'],2,3,5,1320149,1,,,,3424
65e352bbf3ad677cfc1e5fb9b2a363336754c745,0,Jens Geyer,2019-12-04 09:03:19+01:00,['450bc69248043f0ea5ca336d786583ebf3e9d826'],0,92,92,1320241,1,,,,3425
e780855d336beb23119cc83d1ca6c3008f842541,0,Jens Geyer,2019-12-05 09:03:10+01:00,['65e352bbf3ad677cfc1e5fb9b2a363336754c745'],85,174,259,1320500,3,0,0.045454545,0,3425
ffb97e105cbef6afc809a1bdac9cdac1f35d6bab,1,Jens Geyer,2019-12-07 08:47:32+01:00,['e780855d336beb23119cc83d1ca6c3008f842541'],72,69,141,1320641,21,0,0,1,3425
45a9827f0f455d377ae87d9a35349c10181d6893,0,D. Can Celasun,2019-12-10 20:44:22+00:00,['ffb97e105cbef6afc809a1bdac9cdac1f35d6bab'],9,0,9,1320650,1,0,0,0,3425
b40f5c227f8db61be523f23ca017519167589d97,0,D. Can Celasun,2019-12-10 20:44:24+00:00,['45a9827f0f455d377ae87d9a35349c10181d6893'],5,57,62,1320712,5,0.696969697,0.696969697,0.696969697,3425
1234ddf8a5c98d5d700c82e087f04725170ad581,0,D. Can Celasun,2019-12-10 22:13:06+00:00,['b40f5c227f8db61be523f23ca017519167589d97'],57,5,62,1320774,5,0.303030303,0.303030303,0.303030303,3425
3d9f50d61728d377951f9b6df5f19196f6b3af46,0,D. Can Celasun,2019-12-10 22:13:19+00:00,['1234ddf8a5c98d5d700c82e087f04725170ad581'],0,9,9,1320783,1,1,1,1,3425
3a0e1fd356963ad3ac0648b9891d1f8ff326f6ce,0,Jens Geyer,2019-12-10 23:25:15+01:00,['3d9f50d61728d377951f9b6df5f19196f6b3af46'],4,2,6,1320789,1,1,1,1,3425
6e023df1ded255dda00eb4c041c201e66c8d1fbc,0,Jens Geyer,2019-12-10 23:57:35+01:00,['3a0e1fd356963ad3ac0648b9891d1f8ff326f6ce'],86,3013,3099,1323888,42,0.72361809,0.91038526,0.891122278,3457
9320f891d7d972fc2cc4f9569b66767c5dfc4242,0,Duru Can Celasun,2019-12-12 13:50:42+00:00,['6e023df1ded255dda00eb4c041c201e66c8d1fbc'],11,0,11,1323899,1,0,0,0,3457
9c43962da8e4b530014619e3703a279053cf2182,1,Duru Can Celasun,2019-12-12 13:50:42+00:00,['9320f891d7d972fc2cc4f9569b66767c5dfc4242'],13,59,72,1323971,7,0.62962963,0.62962963,0.62962963,3457
cf95fef9b88761ff773257aa0ac0a41e4093820b,0,Duru Can Celasun,2019-12-12 22:30:07+00:00,['9c43962da8e4b530014619e3703a279053cf2182'],0,1,1,1323972,1,,,,3457
f1c53418a794f3d740b809ece822ce79c0bb62a3,0,Duru Can Celasun,2019-12-12 23:09:36+00:00,['cf95fef9b88761ff773257aa0ac0a41e4093820b'],6,119,125,1324097,5,,,,3457
6e2a6983ec95c7a64db3d219b9533af1c2b8c1a1,0,Jens Geyer,2019-12-13 00:33:46+01:00,['f1c53418a794f3d740b809ece822ce79c0bb62a3'],15,60,75,1324172,5,,,,3457
dfae5d7f4a66e747e56ecfa9f50817c2936e75c3,0,GitHub,2019-12-12 23:34:48+00:00,"['6e2a6983ec95c7a64db3d219b9533af1c2b8c1a1', '24045b7211318b7b62dce83a7f0e962e20292f1b']",15,83,98,1324270,2,,,,3457
0ebf3ce99d74bc77912536dc3ad95dac10ebf12a,0,Duru Can Celasun,2019-12-12 23:42:00+00:00,['dfae5d7f4a66e747e56ecfa9f50817c2936e75c3'],1,1,2,1324272,1,,,,3457
418d88b447769745eeba372d12f486b22053a7a8,0,Duru Can Celasun,2019-12-13 09:13:12+00:00,['0ebf3ce99d74bc77912536dc3ad95dac10ebf12a'],3,7,10,1324282,1,0,0,1,3457
b374ce35550659d4f109c2afc657733e7590aaed,0,GitHub,2019-12-13 13:10:23+00:00,['418d88b447769745eeba372d12f486b22053a7a8'],8,71,79,1324361,3,0.14893617,0.14893617,0.872340426,3457
44d8cc6b435557ef5ba9e4c9df91b2f114a5bfa0,0,Duru Can Celasun,2019-12-14 09:33:37+00:00,['b374ce35550659d4f109c2afc657733e7590aaed'],2,2,4,1324365,1,,,,3457
6e443789e9006f4e291974d179b839b3e5ea8798,0,GitHub,2019-12-14 09:52:36-05:00,"['44d8cc6b435557ef5ba9e4c9df91b2f114a5bfa0', '98ce2c8f2b3bb5aaee3e67a5b461dd1a87685cc0']",7,6,13,1324378,2,,,,3457
30ac2598e84928d9af7066b5d3248b7aea4376b2,0,Duru Can Celasun,2020-01-07 14:28:45+00:00,['6e443789e9006f4e291974d179b839b3e5ea8798'],112,208,320,1324698,5,1,1,1,3457
bee4f2fd69db32621addd9353ab0aa2e2ba94349,0,Jens Geyer,2020-01-11 00:52:42+01:00,['30ac2598e84928d9af7066b5d3248b7aea4376b2'],45,46,91,1324789,4,0,1,1,3457
45a94594ff50ad51a18f6ad1900209e978e5921b,0,Jens Geyer,2020-01-11 12:57:53+01:00,['bee4f2fd69db32621addd9353ab0aa2e2ba94349'],1,1,2,1324791,1,,,,3457
70c4e7a7c7b2a2b4146372868702b7ea0d143e05,0,D. Can Celasun,2020-01-15 21:13:50+00:00,['45a94594ff50ad51a18f6ad1900209e978e5921b'],7,7,14,1324805,5,,,,3457
a5ec666e1ba76fe7385ed56f484c9dfdd5b6bfc9,0,Duru Can Celasun,2020-01-17 12:33:38+00:00,['70c4e7a7c7b2a2b4146372868702b7ea0d143e05'],0,13,13,1324818,1,,,,3457
397645ac24874b6f54d88b2700e56be090753825,0,Duru Can Celasun,2020-01-18 20:55:51+00:00,['a5ec666e1ba76fe7385ed56f484c9dfdd5b6bfc9'],79,332,411,1325229,4,0.84,1,1,3457
1c789cea1e59d457379ca10bdcb8f4ac4632dec9,0,Jens Geyer,2020-01-19 22:13:16+01:00,['397645ac24874b6f54d88b2700e56be090753825'],2,2,4,1325233,1,,,,3457
46554d0a4c741a886bf1e2cb9e0dd529eb94a387,0,Jens Geyer,2020-01-19 22:18:52+01:00,['1c789cea1e59d457379ca10bdcb8f4ac4632dec9'],24,6,30,1325263,3,1,1,1,3457
c97e6aa8604fed4a889b6c0a413e085371de6608,0,Jens Geyer,2020-01-19 22:26:09+01:00,['46554d0a4c741a886bf1e2cb9e0dd529eb94a387'],8,30,38,1325301,3,0,0,1,3457
d082d1d61b024e441df21b8b46a6261d7f955405,0,Jens Geyer,2020-01-19 22:33:58+01:00,['c97e6aa8604fed4a889b6c0a413e085371de6608'],1,0,1,1325302,1,1,1,0,3457
829b7d330d8e626808887b3e1072ec3e3051805b,0,Jens Geyer,2020-01-19 23:00:32+01:00,['d082d1d61b024e441df21b8b46a6261d7f955405'],0,26,26,1325328,2,,,,3457
3a2a44bb51cb4cc5480d4b97f5bc6a4fe6228b0a,0,Duru Can Celasun,2020-01-21 17:02:22+00:00,['829b7d330d8e626808887b3e1072ec3e3051805b'],5,3,8,1325336,1,,,,3457
a86a3549cff1643b94438c8afc0fec5e5c6ade4f,0,Jens Geyer,2020-01-23 23:17:00+01:00,['3a2a44bb51cb4cc5480d4b97f5bc6a4fe6228b0a'],7,15,22,1325358,1,,,,3457
436bce33215a918ebdc89596bc3c5bfafb33feea,0,Jens Geyer,2020-01-28 22:47:55+01:00,['a86a3549cff1643b94438c8afc0fec5e5c6ade4f'],4,10,14,1325372,1,0,1,1,3457
e8f82da45e63a6477e4165e80358d613de689a82,0,Jens Geyer,2020-01-28 22:53:58+01:00,['436bce33215a918ebdc89596bc3c5bfafb33feea'],2,1,3,1325375,1,1,1,0,3457
e56f717b7f62ba5b1ace7382d728ac7f0fda940f,0,Jens Geyer,2020-01-28 23:20:40+01:00,['e8f82da45e63a6477e4165e80358d613de689a82'],4,18,22,1325397,3,0,0,1,3457
cb4c31a0720e5449ac562b65ac7916f583d0cb7f,0,Jens Geyer,2020-01-28 23:27:48+01:00,['e56f717b7f62ba5b1ace7382d728ac7f0fda940f'],5,20,25,1325422,7,,,,3457
f8b004081da0c5006c3a0ce0352b66d2d857405e,1,GitHub,2020-01-29 08:03:46+00:00,['cb4c31a0720e5449ac562b65ac7916f583d0cb7f'],1,1,2,1325424,1,,,,3457
f049ff374dd8232a1b4e2b3e01f7530936cae0d0,0,Jens Geyer,2020-02-05 21:40:16+01:00,['f8b004081da0c5006c3a0ce0352b66d2d857405e'],0,13,13,1325437,1,1,1,1,3457
68b113a73e2fbbaa5d94e1f077c60e0038fc903c,0,Jens Geyer,2020-02-05 22:36:33+01:00,['f049ff374dd8232a1b4e2b3e01f7530936cae0d0'],2,2,4,1325441,1,,,,3457
b576ae91f0b777aab0fb0df913067b5f1ca66345,0,Jens Geyer,2020-02-05 22:40:21+01:00,['68b113a73e2fbbaa5d94e1f077c60e0038fc903c'],1,1,2,1325443,1,,,,3457
baddaa8612fe70070208d30b91d820e99fb2a716,0,Jens Geyer,2020-02-06 22:59:31+01:00,['b576ae91f0b777aab0fb0df913067b5f1ca66345'],0,1,1,1325444,1,,,,3457
77c4afae16207a8a806162fa8b6418f329ad5fa3,0,Jens Geyer,2020-02-06 23:06:07+01:00,['baddaa8612fe70070208d30b91d820e99fb2a716'],2,2,4,1325448,1,,,,3457
7d30e2c0b67ef14351d233ac8b29292ae2fbbd90,0,Jens Geyer,2020-02-06 23:10:08+01:00,['77c4afae16207a8a806162fa8b6418f329ad5fa3'],3,3,6,1325454,1,,,,3457
ded326101af3c6c9daad9814ce6404d385f36a1f,0,Jens Geyer,2020-02-06 23:21:02+01:00,['7d30e2c0b67ef14351d233ac8b29292ae2fbbd90'],19,20,39,1325493,7,,,,3457
b012318fc8f1d3de4c64514d5d32cb424952d905,1,Jens Geyer,2020-02-12 22:40:42+01:00,['ded326101af3c6c9daad9814ce6404d385f36a1f'],14,15,29,1325522,3,,,,3457
aa9e7e8f5966ec9233ef418bab81b48c5a539028,1,Jens Geyer,2020-02-13 22:42:14+01:00,['b012318fc8f1d3de4c64514d5d32cb424952d905'],2,20,22,1325544,2,1,1,1,3457
bb5f7ec6b06220808cd20c8488fe8f90a54f3929,1,Jens Geyer,2020-02-14 09:15:17+01:00,['aa9e7e8f5966ec9233ef418bab81b48c5a539028'],2,4,6,1325550,1,0,0,1,3457
c8e46cf861cd1ebae273e968bb3995f778d998f1,0,Jens Geyer,2020-02-16 13:18:24+01:00,['bb5f7ec6b06220808cd20c8488fe8f90a54f3929'],2,3,5,1325555,2,,,,3457
222362cc70d66b5f8bb6422622fcf384407b54c8,1,Jens Geyer,2020-02-16 13:19:43+01:00,['c8e46cf861cd1ebae273e968bb3995f778d998f1'],9,83,92,1325647,2,0,0,0,3458
7b712f42d7bc03610511abd397845983deafa258,0,Jens Geyer,2020-02-21 21:08:19+01:00,['222362cc70d66b5f8bb6422622fcf384407b54c8'],4,7,11,1325658,2,1,1,1,3458
d8480c9ac14f133d272372530e33619b2a64ddf7,0,Jens Geyer,2020-02-21 21:15:29+01:00,['7b712f42d7bc03610511abd397845983deafa258'],1,1,2,1325660,1,,,,3458
bd26d385693e4f172c348dc27f9d1e23288c50cf,0,Jens Geyer,2020-02-21 21:25:45+01:00,['d8480c9ac14f133d272372530e33619b2a64ddf7'],0,6,6,1325666,1,0,0,0,3458
ea4a086757f834880220c50392532b60751c6885,0,Jens Geyer,2020-02-21 21:35:39+01:00,['bd26d385693e4f172c348dc27f9d1e23288c50cf'],0,9,9,1325675,1,0,0,1,3458
f0c761e171782565f74ff3cd7d0e9ce8e1d2b6ad,0,Jens Geyer,2020-02-21 21:41:27+01:00,['ea4a086757f834880220c50392532b60751c6885'],8,51,59,1325734,5,,,,3458
a89036c8c3d05be4e6186de0864335beef01294a,1,Jens Geyer,2020-02-21 21:57:37+01:00,['f0c761e171782565f74ff3cd7d0e9ce8e1d2b6ad'],14,440,454,1326188,7,1,0.941908714,0.937759336,3461
d858a8d4bcdc8767b4a89e3636e61f486ad9366f,0,Jens Geyer,2020-02-21 22:06:09+01:00,['a89036c8c3d05be4e6186de0864335beef01294a'],2,5,7,1326195,1,,,,3461
f5a9a30e345fc8cf52d37388cb7b9ab741a3a4ac,0,Jens Geyer,2020-02-23 14:50:30+01:00,['d858a8d4bcdc8767b4a89e3636e61f486ad9366f'],0,3,3,1326198,1,,,,3461
61d502075bf5da10331c201f604acdfefc4d5edc,0,Jens Geyer,2020-02-23 14:51:48+01:00,['f5a9a30e345fc8cf52d37388cb7b9ab741a3a4ac'],0,115,115,1326313,5,,,,3463
f8b3698ab49c5997760867a85f85b01ba9768e8e,0,Jens Geyer,2020-02-23 14:57:59+01:00,['61d502075bf5da10331c201f604acdfefc4d5edc'],387,427,814,1327127,2,,,,3463
b70dc1e61c5c4637d16160df3197164e0bef79bf,1,Jens Geyer,2020-02-23 14:58:10+01:00,['f8b3698ab49c5997760867a85f85b01ba9768e8e'],1,1,2,1327129,1,,,,3463
13cbc8defa0877c14af42666b9a7575dea78de72,0,Jens Geyer,2020-02-23 15:01:50+01:00,['b70dc1e61c5c4637d16160df3197164e0bef79bf'],594,1181,1775,1328904,2,,,,3463
66d110bcce5c7e1b0deeacd28b046fb4a9c0249b,0,Jens Geyer,2020-02-23 15:12:19+01:00,['13cbc8defa0877c14af42666b9a7575dea78de72'],8,13,21,1328925,3,,,,3463
4b475af6943d99a21e2b79578167a4d228fe0df1,0,Jens Geyer,2020-02-24 19:00:49+01:00,['66d110bcce5c7e1b0deeacd28b046fb4a9c0249b'],15,15,30,1328955,2,,,,3463
b7b02afcd835639a0735731a63ff5b1386879c97,0,Jens Geyer,2020-02-25 23:21:57+01:00,['4b475af6943d99a21e2b79578167a4d228fe0df1'],3,19,22,1328977,3,,,,3463
aec555aac89ec9634e99ce0f4f0aec5799e6e3d8,0,Jens Geyer,2020-02-26 22:14:12+01:00,['b7b02afcd835639a0735731a63ff5b1386879c97'],0,2,2,1328979,2,,,,3463
4903d18fca988871bcedce3b420fef2cd9682ca1,0,Jens Geyer,2020-02-27 20:37:50+01:00,['aec555aac89ec9634e99ce0f4f0aec5799e6e3d8'],4,50,54,1329033,1,,,,3463
56700e469d5d0659994a3963ad5a111740cf8277,1,Jens Geyer,2020-02-28 19:18:34+01:00,['4903d18fca988871bcedce3b420fef2cd9682ca1'],17872,269,18141,1347174,158,0.640288581,0.471649194,0.247435464,3463
1b7b00cde9cdd4a0dd9f09f240df551c87d4ab27,0,Jens Geyer,2020-02-28 19:20:27+01:00,['56700e469d5d0659994a3963ad5a111740cf8277'],103,0,103,1347277,6,,,,3463
e791760098b6a9490e19af2b18a3e002f561973b,1,Jens Geyer,2020-03-07 10:59:24+01:00,['1b7b00cde9cdd4a0dd9f09f240df551c87d4ab27'],1,26,27,1347304,2,0,1,1,3463
2e115774776f2e5bcfe826e30548feab030fb263,0,Jens Geyer,2020-03-07 11:12:13+01:00,['e791760098b6a9490e19af2b18a3e002f561973b'],6,13,19,1347323,3,,,,3463
b1f755a1e920f01750cc868dafd193413d17af8d,1,Jens Geyer,2020-03-10 22:37:33+01:00,['2e115774776f2e5bcfe826e30548feab030fb263'],2,2,4,1347327,1,,,,3463
299b68e72334086c4685a5eaef397eb7c6129044,0,Jens Geyer,2020-03-10 22:38:23+01:00,['b1f755a1e920f01750cc868dafd193413d17af8d'],3,6,9,1347336,1,,,,3463
adf278dae0b1e53baf100b6a7108327698545366,0,Jens Geyer,2020-03-10 22:46:59+01:00,['299b68e72334086c4685a5eaef397eb7c6129044'],9,9,18,1347354,1,,,,3463
ed1711e8611a2acc89b178a1cc0924b215e07a4c,0,Jens Geyer,2020-03-13 02:17:58+01:00,['adf278dae0b1e53baf100b6a7108327698545366'],3,12,15,1347369,2,,,,3463
b013dc004a019c9a30689b8e49ade34c3b18b7e5,0,Jens Geyer,2020-03-14 15:41:12+01:00,['ed1711e8611a2acc89b178a1cc0924b215e07a4c'],11,29,40,1347409,2,1,1,1,3463
dad2bf87da9e46382b088544eba56b1829e25d92,0,Jens Geyer,2020-03-15 12:20:08+01:00,['b013dc004a019c9a30689b8e49ade34c3b18b7e5'],6,2,8,1347417,2,0,0,0,3463
9b992f5af8c7b76a6f71929e7a90eecd6e41a65a,0,Jens Geyer,2020-03-15 19:31:26+01:00,['dad2bf87da9e46382b088544eba56b1829e25d92'],1,98,99,1347516,2,,,,3463
eccd2e879e73bbc1a948b31139ac1d4c383c0335,0,Jens Geyer,2020-03-16 23:38:53+01:00,['9b992f5af8c7b76a6f71929e7a90eecd6e41a65a'],0,167,167,1347683,1,,,,3463
4b66a9d8812cf2c19f15382c56ec8e1327b6f2a1,0,Jens Geyer,2020-03-19 23:13:03+01:00,['eccd2e879e73bbc1a948b31139ac1d4c383c0335'],13,209,222,1347905,11,0.41509434,0.490566038,0.867924528,3467
655f52590d23443a432a3326cbb64ca93cb4b90a,0,Jens Geyer,2020-03-22 13:22:37+01:00,['4b66a9d8812cf2c19f15382c56ec8e1327b6f2a1'],6,10,16,1347921,2,1,1,0,3467
9f3198e1a84a1c20c5c9ce0497b4b399584694c0,0,Jens Geyer,2020-03-22 13:26:59+01:00,['655f52590d23443a432a3326cbb64ca93cb4b90a'],32,32,64,1347985,1,,,,3467
24ab31fc5738532b082c7b0638bfcd2a7a26d7c5,0,Jens Geyer,2020-03-22 14:12:21+01:00,['9f3198e1a84a1c20c5c9ce0497b4b399584694c0'],0,26,26,1348011,1,0.928571429,1,1,3467
4a33b188f44ce097e25ca56ebd48026b41effd6a,0,Jens Geyer,2020-03-22 15:30:27+01:00,['24ab31fc5738532b082c7b0638bfcd2a7a26d7c5'],14,14,28,1348039,6,,,,3467
aeda987cc42ef7dcf57682b7ee168e7dfdbd5f57,0,Jens Geyer,2020-03-22 15:30:37+01:00,['4a33b188f44ce097e25ca56ebd48026b41effd6a'],131,125,256,1348295,2,,,,3467
dfe7f30070498c7463ab61720133eff1bcd11cc3,0,Jens Geyer,2020-03-27 21:44:05+01:00,['aeda987cc42ef7dcf57682b7ee168e7dfdbd5f57'],30,30,60,1348355,4,,,,3467
11fc716a20474a7b668654f96db43d97a09bc318,0,Jens Geyer,2020-03-28 13:56:49+01:00,['dfe7f30070498c7463ab61720133eff1bcd11cc3'],0,28,28,1348383,1,0.866666667,0.933333333,0.933333333,3467
7e90252af64b0a0dee5e5e6f37808aa11a6b2e03,0,Allen George,2020-03-28 10:11:37-04:00,['11fc716a20474a7b668654f96db43d97a09bc318'],1,1,2,1348385,1,,,,3467
8ec585793c63c765a18ec97335eda6b89b494ab5,0,Jens Geyer,2020-03-29 18:28:05+02:00,['11fc716a20474a7b668654f96db43d97a09bc318'],0,2,2,1348387,1,0,0,1,3467
3b56a036c38aaa0575760c958f57067119ad51b3,0,GitHub,2020-03-31 08:21:16-04:00,"['8ec585793c63c765a18ec97335eda6b89b494ab5', '7e90252af64b0a0dee5e5e6f37808aa11a6b2e03']",1,1,2,1348389,1,,,,3467
86396c688068c428d997ad3209823ab5a2e3dcae,0,Jens Geyer,2020-03-31 23:06:36+02:00,['3b56a036c38aaa0575760c958f57067119ad51b3'],1,10,11,1348400,1,0,1,1,3467
dfd6df7588564739be7a1eba8a7c3ed83ee27a4b,0,Jens Geyer,2020-04-03 02:12:25+02:00,['86396c688068c428d997ad3209823ab5a2e3dcae'],8,32,40,1348440,6,1,1,1,3467
102428d35da461aec0f3d8a513e4a21bb56ddb69,0,Jens Geyer,2020-04-03 02:19:11+02:00,['dfd6df7588564739be7a1eba8a7c3ed83ee27a4b'],0,1,1,1348441,1,,,,3467
dbb95e438f90609c8bc70b6953f65e97afedbb1b,0,Jens Geyer,2020-04-03 21:17:25+02:00,['102428d35da461aec0f3d8a513e4a21bb56ddb69'],7,16,23,1348464,3,,,,3467
818105653db4916f9e8b59b8fb8f074cb083c30b,0,Jens Geyer,2020-04-04 20:52:26+02:00,['dbb95e438f90609c8bc70b6953f65e97afedbb1b'],18,31,49,1348513,7,,,,3467
13e6f9ec89ae4f8f87165eccea88442e83afb314,0,Jens Geyer,2020-04-06 22:47:20+02:00,['818105653db4916f9e8b59b8fb8f074cb083c30b'],1,7,8,1348521,1,,,,3467
5159da90964b774e6ff952efaf2bce516538ae50,0,Jens Geyer,2020-04-09 21:22:46+02:00,['13e6f9ec89ae4f8f87165eccea88442e83afb314'],1,1,2,1348523,1,,,,3467
23aabcc1b196dc443a974e168ed5826d06fed945,0,Jens Geyer,2020-04-09 21:28:29+02:00,['5159da90964b774e6ff952efaf2bce516538ae50'],1,1,2,1348525,1,,,,3467
f44b6ee8db9342d804c6ba01da9953e791021bfe,0,Jens Geyer,2020-04-09 21:41:57+02:00,['23aabcc1b196dc443a974e168ed5826d06fed945'],3,3,6,1348531,1,0,0,0,3467
6bbdb1a46ce6ba0ac4e27e29b2c9c9eef107186c,1,Jens Geyer,2020-04-09 21:52:46+02:00,['f44b6ee8db9342d804c6ba01da9953e791021bfe'],0,388,388,1348919,1,,,,3468
daa7669a7665539a484815a7d5200651ba74df9a,0,Jens Geyer,2020-04-13 18:04:20+02:00,['6bbdb1a46ce6ba0ac4e27e29b2c9c9eef107186c'],0,1,1,1348920,1,,,,3468
69642f389a06f5ba1b374de52c6b0e29892035d8,1,Jens Geyer,2020-04-13 18:06:56+02:00,['daa7669a7665539a484815a7d5200651ba74df9a'],0,4,4,1348924,1,0,0,1,3468
81334cd7345d3b5af165aa875b733a491f1fd5c7,1,Jens Geyer,2020-04-13 18:11:03+02:00,['69642f389a06f5ba1b374de52c6b0e29892035d8'],18,25,43,1348967,4,1,1,0,3468
5f352754225158f60594a5f19ba8d03261854327,0,Jim King,2020-04-16 21:48:24-04:00,['81334cd7345d3b5af165aa875b733a491f1fd5c7'],56,57,113,1349080,3,0,0,1,3468
9e864d57026b4905862108418ba9482892fb1f65,0,GitHub,2020-04-17 19:53:39+01:00,['5f352754225158f60594a5f19ba8d03261854327'],1,21,22,1349102,2,0.764705882,1,1,3468
35a3942e7078bc55cd21890b12d206d9bf0514d3,0,Jens Geyer,2020-04-20 23:30:21+02:00,['9e864d57026b4905862108418ba9482892fb1f65'],20,0,20,1349122,2,,,,3468
dd7e11798ba524f7ae6204b68f073ee696deb595,0,Jens Geyer,2020-04-20 23:32:52+02:00,['35a3942e7078bc55cd21890b12d206d9bf0514d3'],2,1,3,1349125,2,,,,3468
57c2507208aede3ec60c7bab50aaeb093fe44eca,0,Jens Geyer,2020-04-21 23:29:14+02:00,['dd7e11798ba524f7ae6204b68f073ee696deb595'],62,63,125,1349250,7,0,0.75,0.875,3468
df2f5d2cf321f070a356872eea13dd3f68891043,0,Jens Geyer,2020-04-21 23:37:28+02:00,['57c2507208aede3ec60c7bab50aaeb093fe44eca'],1,23,24,1349274,2,1,1,1,3468
6064696ae08e9764f588143f8ffd380b95405aca,0,Jens Geyer,2020-04-22 21:15:14+02:00,['df2f5d2cf321f070a356872eea13dd3f68891043'],14,19,33,1349307,1,0.8,1,1,3468
93171d2482f98d77887874afc3bbb73f0bbb65c2,0,Jens Geyer,2020-04-22 21:17:33+02:00,['6064696ae08e9764f588143f8ffd380b95405aca'],1,114,115,1349422,7,,,,3470
d5a9bf2b30b4f9533f4ef13ee1a4fdce1036bbaa,0,GitHub,2020-04-23 21:58:00+01:00,['93171d2482f98d77887874afc3bbb73f0bbb65c2'],0,2,2,1349424,2,,,,3470
e98ba9cb841153fcbe2185ca44c77dbbc745ceb3,1,GitHub,2020-04-24 07:39:04+01:00,['d5a9bf2b30b4f9533f4ef13ee1a4fdce1036bbaa'],4,62,66,1349490,2,1,1,1,3470
ed0bad34301741c6ea7473e891d1c6886e8db9e1,0,GitHub,2020-04-24 07:50:43+01:00,['e98ba9cb841153fcbe2185ca44c77dbbc745ceb3'],1,24,25,1349515,7,0.916666667,1,1,3470
802793638b3e06d8b9031ae4d0b765735165c598,0,GitHub,2020-04-24 07:51:37+01:00,['ed0bad34301741c6ea7473e891d1c6886e8db9e1'],10,12,22,1349537,2,,,,3470
04574379a43dd2a05766f3e06eb9852a9b6fa5da,0,GitHub,2020-04-24 10:44:41+01:00,['802793638b3e06d8b9031ae4d0b765735165c598'],9,25,34,1349571,1,0,0,1,3470
b4711a617821a0610e377f048abf8dfe0c701773,1,GitHub,2020-04-24 14:43:03+01:00,['04574379a43dd2a05766f3e06eb9852a9b6fa5da'],97,33,130,1349701,15,1,1,1,3470
25f81d11c2adb60ce50425879962a3f68efc4afa,0,GitHub,2020-04-24 14:45:05+01:00,['b4711a617821a0610e377f048abf8dfe0c701773'],29,33,62,1349763,8,,,,3470
5ef8e3ec2ab39ea37f8437ae1b7ca1966287a934,0,GitHub,2020-04-24 15:34:02+01:00,['25f81d11c2adb60ce50425879962a3f68efc4afa'],12,1,13,1349776,3,,,,3470
2d2df9e89210a768134a185808769566e2cd9aa8,0,GitHub,2020-04-24 17:02:18+01:00,['5ef8e3ec2ab39ea37f8437ae1b7ca1966287a934'],8,26,34,1349810,3,1,1,1,3470
b94c16638555c4efa191092bf0f14ce45c3621b8,1,Jens Geyer,2020-04-26 13:25:08+02:00,['2d2df9e89210a768134a185808769566e2cd9aa8'],14,16,30,1349840,1,0,0,1,3470
b83ae2cedf8a345142c3b96e9b529a65fe41bc16,0,Jens Geyer,2020-04-26 13:29:48+02:00,['b94c16638555c4efa191092bf0f14ce45c3621b8'],0,65,65,1349905,1,0,1,1,3470
3127e4abd94728a60849c80bed84c2c338067a01,0,GitHub,2020-04-27 08:12:42+01:00,['b83ae2cedf8a345142c3b96e9b529a65fe41bc16'],1,2,3,1349908,2,,,,3470
b416ffa72dbcab8ed8a156c95cb8e480ed46a438,0,GitHub,2020-04-27 08:18:26+01:00,['3127e4abd94728a60849c80bed84c2c338067a01'],0,1,1,1349909,1,,,,3470
c3728122d2ddb2e0236b1e08bdb5e24b8baae9dd,0,GitHub,2020-04-27 08:48:19+01:00,['b416ffa72dbcab8ed8a156c95cb8e480ed46a438'],0,267,267,1350176,3,0,0.497237569,1,3471
7c4bdf9914fcba6c89e0f69ae48b9675578f084a,0,GitHub,2020-04-27 09:11:47+01:00,['c3728122d2ddb2e0236b1e08bdb5e24b8baae9dd'],1,1,2,1350178,1,,,,3471
52655cec793a5f2d276942e79de219e299436535,0,GitHub,2020-04-27 16:19:55+01:00,['7c4bdf9914fcba6c89e0f69ae48b9675578f084a'],0,3,3,1350181,1,0,0,1,3471
00c039adeb551b297276fcb88131f1cfe82be1cd,0,GitHub,2020-04-27 19:32:24+01:00,['52655cec793a5f2d276942e79de219e299436535'],1,435,436,1350617,8,0.582159624,0.812206573,0.948356808,3475
87462913428f9463c537223f2d23bbbf56cddb43,0,Jens Geyer,2020-04-27 22:56:21+02:00,['00c039adeb551b297276fcb88131f1cfe82be1cd'],4,24,28,1350645,1,,,,3475
371d92f159d4e518f1de81519b3a9de629ba8970,0,GitHub,2020-04-28 07:23:15+01:00,['87462913428f9463c537223f2d23bbbf56cddb43'],9,119,128,1350773,6,0.111111111,0,0.814814815,3477
39381695eb456349b02e68d9167181ae41656b73,0,GitHub,2020-04-28 07:24:58+01:00,['371d92f159d4e518f1de81519b3a9de629ba8970'],0,73,73,1350846,3,1,1,1,3478
809403d544a83b308f0c8f219719e44ba1ace4c0,0,Jens Geyer,2020-04-28 22:36:36+02:00,['39381695eb456349b02e68d9167181ae41656b73'],0,8,8,1350854,1,,,,3479
9c757973462d5db9ad7eaabc41d9f1a531ed32d2,0,Jens Geyer,2020-04-28 22:42:55+02:00,['809403d544a83b308f0c8f219719e44ba1ace4c0'],1,1,2,1350856,1,,,,3479
5cffef964a081314df70b76f8650bd17bfdd55e6,0,GitHub,2020-04-30 15:12:40+01:00,['9c757973462d5db9ad7eaabc41d9f1a531ed32d2'],10,149,159,1351015,4,1,1,0.833333333,3480
48730688fbf00b03f0dcdf3eb44963ad894bd98e,0,GitHub,2020-04-30 17:00:24+01:00,['5cffef964a081314df70b76f8650bd17bfdd55e6'],1,1,2,1351017,1,,,,3480
0c173bf9e02ee218ee7427aa0521845f674a3dd3,0,GitHub,2020-05-01 07:49:29+01:00,['48730688fbf00b03f0dcdf3eb44963ad894bd98e'],2,7,9,1351026,3,,,,3480
abc2ec60964538558fd99f72a4d4c16820e8bfb4,1,Jens Geyer,2020-05-08 09:14:26+02:00,['0c173bf9e02ee218ee7427aa0521845f674a3dd3'],21,35,56,1351082,2,1,1,1,3480
bbc5e06a2e36d788b095fb37a52c90fc4d54b211,0,Jens Geyer,2020-05-08 09:18:46+02:00,['abc2ec60964538558fd99f72a4d4c16820e8bfb4'],1,103,104,1351186,3,0.240740741,1,1,3481
9b9567b23378c821b460cfe54b70b9d189bf194d,1,Jens Geyer,2020-05-08 09:23:47+02:00,['bbc5e06a2e36d788b095fb37a52c90fc4d54b211'],6,10,16,1351202,5,0,0,1,3481
47e9d8f13e5194e0f69cea3942c00b8e3ea6be9f,0,David Mollitor,2020-05-11 10:30:17-04:00,['9b9567b23378c821b460cfe54b70b9d189bf194d'],3,5,8,1351210,1,1,1,0,3481
55680af8fa075868abd7830f9e52008585de4adc,0,GitHub,2020-05-11 21:58:48+01:00,['47e9d8f13e5194e0f69cea3942c00b8e3ea6be9f'],4,5,9,1351219,3,,,,3481
64ac65ea7e0763c32d6dca988a2c779f89bece84,0,Jens Geyer,2020-05-13 23:49:24+02:00,['55680af8fa075868abd7830f9e52008585de4adc'],1,2,3,1351222,1,,,,3481
26e6c84cde490a22d39c43ba3903dd94bbb8497f,0,Jens Geyer,2020-05-13 23:56:08+02:00,['64ac65ea7e0763c32d6dca988a2c779f89bece84'],0,292,292,1351514,3,0.01010101,0.45959596,0.98989899,3482
be3f7321cf0b7cff5d178ac09da02fc68dac6bd5,0,GitHub,2020-05-14 08:28:44+01:00,['26e6c84cde490a22d39c43ba3903dd94bbb8497f'],4,28,32,1351546,2,1,1,1,3482
ad3e440955c56627da01eb7149a19afe67ce2954,0,Jens Geyer,2020-05-15 21:59:15+02:00,['be3f7321cf0b7cff5d178ac09da02fc68dac6bd5'],2,1,3,1351549,1,1,0,1,3482
53239655b7f48e741d9112ae8ca739c622268d7c,0,Jens Geyer,2020-05-15 22:22:48+02:00,['ad3e440955c56627da01eb7149a19afe67ce2954'],2,2,4,1351553,1,,,,3482
261de348fe0e83ca2f4c7398f2f03ff28d3eb81e,0,Jens Geyer,2020-05-17 14:44:59+02:00,['53239655b7f48e741d9112ae8ca739c622268d7c'],3,10,13,1351566,2,,,,3482
dce229911cd61a441961df2219623fb166b5d139,0,Jens Geyer,2020-05-17 22:34:10+02:00,['261de348fe0e83ca2f4c7398f2f03ff28d3eb81e'],780,293,1073,1352639,20,0.333333333,0.596371882,0.058956916,3482
1ab096c80af1a2bca73aef78675de914a1834fd9,0,GitHub,2020-05-18 20:27:31+01:00,['dce229911cd61a441961df2219623fb166b5d139'],11,702,713,1353352,12,0.354085603,0.365758755,1,3485
506e311c381677928ab68fd62e441deb24f2f7c3,0,Jens Geyer,2020-05-19 00:00:29+02:00,['1ab096c80af1a2bca73aef78675de914a1834fd9'],4,4,8,1353360,2,,,,3485
1edf32926d980573d23a292ae72e96db92ac43c1,0,Jens Geyer,2020-05-20 00:28:58+02:00,['506e311c381677928ab68fd62e441deb24f2f7c3'],16,81,97,1353457,2,0.904761905,1,1,3486
a082592d439d6aa578507ff52198038e5e08006d,0,Jens Geyer,2020-05-20 00:39:49+02:00,['1edf32926d980573d23a292ae72e96db92ac43c1'],15,204,219,1353676,6,0.794117647,0.980392157,1,3487
4fd001c878e748a09713235725d8ad41de6ea6a1,0,Jens Geyer,2020-05-20 00:48:35+02:00,['a082592d439d6aa578507ff52198038e5e08006d'],5,24,29,1353705,4,0.75,0.75,0.75,3487
7de1f5d7f394b49624e7278937d7ff665bfc642a,0,Jens Geyer,2020-05-20 00:55:10+02:00,['4fd001c878e748a09713235725d8ad41de6ea6a1'],3,4,7,1353712,1,,,,3487
f8103c69eaaa23fe7fff4d8413240063b9ec56d2,0,David Mollitor,2020-05-20 09:26:36-04:00,['7de1f5d7f394b49624e7278937d7ff665bfc642a'],37,21,58,1353770,1,1,1,0,3487
dd34c5281344d0f1c10b2f7daddfb032bc6e5cb3,0,Jens Geyer,2020-05-21 12:32:27+02:00,['f8103c69eaaa23fe7fff4d8413240063b9ec56d2'],1,1,2,1353772,1,,,,3487
528c22f59d3a35934f4f4308746a78d833b759e8,0,Jens Geyer,2020-05-21 12:34:46+02:00,['dd34c5281344d0f1c10b2f7daddfb032bc6e5cb3'],13,14,27,1353799,1,,,,3487
348790deaf633f368a147c413e0f17eb7373a973,0,Jens Geyer,2020-05-21 12:49:57+02:00,['528c22f59d3a35934f4f4308746a78d833b759e8'],4,58,62,1353861,3,,,,3488
eb8e8437a59fe7c0ca522be53a69f4e34bedc4f1,0,Jens Geyer,2020-05-22 01:12:24+02:00,['348790deaf633f368a147c413e0f17eb7373a973'],0,16,16,1353877,1,,,,3488
e6d7d13c35f5c9fe57889d7e77b0ba63910b1052,0,Jens Geyer,2020-05-26 21:35:19+02:00,['eb8e8437a59fe7c0ca522be53a69f4e34bedc4f1'],156,8,164,1354041,4,,,,3488
797fe252e0df18a24aa025d00d1d53c288ef2d4f,0,Jens Geyer,2020-05-26 21:46:16+02:00,['e6d7d13c35f5c9fe57889d7e77b0ba63910b1052'],0,130,130,1354171,4,0.622222222,1,1,3490
0198542201a6bd7e09ebd5a8b1ac14d3cb2b2bb7,0,Jens Geyer,2020-05-26 21:52:05+02:00,['797fe252e0df18a24aa025d00d1d53c288ef2d4f'],3,3,6,1354177,1,,,,3490
d28f39fbc7bb9607a150544dd8f73f027c898c9b,0,Jens Geyer,2020-05-26 21:57:13+02:00,['0198542201a6bd7e09ebd5a8b1ac14d3cb2b2bb7'],1,1,2,1354179,1,,,,3490
05023e81b264f249affdacad4ebae788b3ada85c,1,GitHub,2020-05-26 23:31:20+01:00,['d28f39fbc7bb9607a150544dd8f73f027c898c9b'],25,483,508,1354687,7,0.394230769,0.471153846,0.9375,3495
affea7bee468d4abc751fbbd1c2692ba5c7ac0e4,1,Jens Geyer,2020-05-27 01:32:14+02:00,['05023e81b264f249affdacad4ebae788b3ada85c'],92,1435,1527,1356214,12,0.282377919,0.649681529,0.936305732,3497
98854c48744f20b3f551817273ed502835477f09,0,Jens Geyer,2020-05-28 21:32:33+02:00,['affea7bee468d4abc751fbbd1c2692ba5c7ac0e4'],0,66,66,1356280,1,,,,3497
b559359b0b875cd7d4919f3120a0089f6d74e09a,0,Jens Geyer,2020-05-28 21:32:34+02:00,['98854c48744f20b3f551817273ed502835477f09'],3,2,5,1356285,1,1,,,3497
36bf0a491e900f09b894b54dbe037262acec73e5,0,Jens Geyer,2020-05-30 14:59:48+02:00,['b559359b0b875cd7d4919f3120a0089f6d74e09a'],63,72,135,1356420,2,1,0,0,3497
68f2194dfa3150526445d37afd80ededb7bb4585,0,Jens Geyer,2020-05-30 15:07:56+02:00,['36bf0a491e900f09b894b54dbe037262acec73e5'],1,1,2,1356422,1,,,,3497
fa770f61e9fd26af6bd6f0f2f4c3f7815523d0d8,0,Jens Geyer,2020-06-02 13:55:03+02:00,['68f2194dfa3150526445d37afd80ededb7bb4585'],1,1,2,1356424,1,,,,3497
eac4d0c79a5fc550fb61bc18f20d3b5aae8f6e7f,0,Jens Geyer,2020-06-03 23:10:36+02:00,['fa770f61e9fd26af6bd6f0f2f4c3f7815523d0d8'],8,11,19,1356443,1,1,1,0,3497
bde5cbc0788b936aff516e2c0527ff950cc9b466,0,Jens Geyer,2020-06-04 21:18:01+02:00,['eac4d0c79a5fc550fb61bc18f20d3b5aae8f6e7f'],11,69,80,1356523,4,0.294117647,1,1,3497
b1628cf8bcbe6c87b117004beb3de6316417739c,0,Jens Geyer,2020-06-04 21:25:58+02:00,['bde5cbc0788b936aff516e2c0527ff950cc9b466'],1,4,5,1356528,1,0,0,1,3497
0acf23b7cf39922a2eee9b969e4e73989050f0d6,0,Jens Geyer,2020-06-04 21:43:30+02:00,['b1628cf8bcbe6c87b117004beb3de6316417739c'],3,38,41,1356569,1,0,0,1,3497
9fd134f269ccadd3a77a198d0c27c0a0d7c9c723,0,GitHub,2020-06-08 12:30:14+01:00,['0acf23b7cf39922a2eee9b969e4e73989050f0d6'],5,2,7,1356576,1,1,1,0,3497
c9890cb873f127137abd513a7ebdf0186ee8c88c,1,GitHub,2020-06-08 12:32:21+01:00,['9fd134f269ccadd3a77a198d0c27c0a0d7c9c723'],64,44,108,1356684,1,1,1,0,3497
e382275bad2bd11fb5df33dd7db520fd7596f4ac,0,GitHub,2020-06-08 14:06:17+01:00,['c9890cb873f127137abd513a7ebdf0186ee8c88c'],7,31,38,1356722,4,0.769230769,0.769230769,0.846153846,3497
cfbb905034c928f073639af00b30d74951744b61,0,GitHub,2020-06-09 21:07:38+01:00,['e382275bad2bd11fb5df33dd7db520fd7596f4ac'],25,23,48,1356770,4,0.230769231,0.230769231,0.153846154,3497
dabfea2f98a9ab605748dea55b1efbb1932b361f,0,Jens Geyer,2020-06-09 23:09:25+02:00,['cfbb905034c928f073639af00b30d74951744b61'],266,452,718,1357488,7,0.360655738,1,0.590163934,3498
3f78c70bbba82c733b1545d39eb5b489ac384e4c,0,Jens Geyer,2020-06-09 23:23:02+02:00,['dabfea2f98a9ab605748dea55b1efbb1932b361f'],2,2,4,1357492,1,,,,3498
26681fbdb77f6dfaf2f2613d4ad860a224e84b71,1,Jens Geyer,2020-06-14 14:17:11+02:00,['3f78c70bbba82c733b1545d39eb5b489ac384e4c'],511,511,1022,1358514,73,,,,3498
e79f764f09afdfe829a06ca721059d34244d7c20,1,Yuxuan 'fishy' Wang,2020-06-15 13:28:38-07:00,['3f78c70bbba82c733b1545d39eb5b489ac384e4c'],1256,1342,2598,1361112,28,0.283333333,0.083333333,0,3498
7b379944efe1f63511831f5555782310a4f3296d,0,Jens Geyer,2020-06-15 22:32:43+02:00,['26681fbdb77f6dfaf2f2613d4ad860a224e84b71'],0,5,5,1361117,1,,,,3498
210202e65c4d68303438a42763e5b50a67d44a7d,0,Jens Geyer,2020-06-16 22:04:23+02:00,['7b379944efe1f63511831f5555782310a4f3296d'],8,7,15,1361132,2,0,1,0,3498
7db2d0fa46fc7724eff9e0d5b85d28010265cf55,0,Jens Geyer,2020-06-18 00:37:40+02:00,['210202e65c4d68303438a42763e5b50a67d44a7d'],16,59,75,1361207,1,0.695652174,0.695652174,1,3498
1bed620c5f91cf60fd7c4e54f16714fd50ad807c,0,Jens Geyer,2020-06-18 11:22:33+02:00,['7db2d0fa46fc7724eff9e0d5b85d28010265cf55'],8,19,27,1361234,1,0.111111111,0.888888889,0,3498
8b8633e8d805905868f359adf85d18326204a5d5,0,Jens Geyer,2020-06-18 22:23:05+02:00,['1bed620c5f91cf60fd7c4e54f16714fd50ad807c'],2,5,7,1361241,1,0,0,0,3498
bcae3bb52f976ce245ad77dfb060e5776d67ce85,0,GitHub,2020-06-18 22:09:33+01:00,"['8b8633e8d805905868f359adf85d18326204a5d5', 'e79f764f09afdfe829a06ca721059d34244d7c20']",1256,1342,2598,1363839,28,,,,3498
283410126ccb3ac4990045e07cccb5df11ee2a16,0,Jens Geyer,2020-06-22 22:50:45+02:00,['bcae3bb52f976ce245ad77dfb060e5776d67ce85'],1,1,2,1363841,1,,,,3498
6e16c2bc542657954966f5fde98d16398853582c,1,Jens Geyer,2020-06-25 22:00:52+02:00,['283410126ccb3ac4990045e07cccb5df11ee2a16'],72,158,230,1364071,3,0.533333333,1,1,3499
24ca210fde0ad51769e359ad9f925ae30a6ed061,0,Jens Geyer,2020-06-25 22:06:13+02:00,['6e16c2bc542657954966f5fde98d16398853582c'],1,1,2,1364073,1,,,,3499
86cc6f095c5943cb382e5ef0e5cf889c6e09bd86,0,Jens Geyer,2020-06-27 15:25:06+02:00,['24ca210fde0ad51769e359ad9f925ae30a6ed061'],0,1,1,1364074,1,0,1,0,3499
0dd1363931ac1f9a531b48ded7f1178194fa4ef6,0,Jens Geyer,2020-06-28 16:55:16+02:00,['86cc6f095c5943cb382e5ef0e5cf889c6e09bd86'],0,28,28,1364102,2,0,1,0.8,3499
5dc1d268f5c63b804d0b185943467cfeb47859d5,1,Yuxuan 'fishy' Wang,2020-06-30 10:07:48-07:00,['0dd1363931ac1f9a531b48ded7f1178194fa4ef6'],19,43,62,1364164,3,1,1,0.210526316,3499
4db7a0af13ac9614e3e9758d42b2791040f4dc7e,1,Yuxuan 'fishy' Wang,2020-07-01 11:50:44-07:00,['5dc1d268f5c63b804d0b185943467cfeb47859d5'],4,118,122,1364286,4,0.038461538,0.038461538,1,3499
6c5f5c8a94b9f8b697d5bd51f9a4fcb70e96c248,0,Jens Geyer,2020-07-01 22:59:16+02:00,['4db7a0af13ac9614e3e9758d42b2791040f4dc7e'],12,61,73,1364359,1,1,1,0.454545455,3499
761a869e0508d2cf7975b040a6da54ae62a889b6,0,Jens Geyer,2020-07-01 23:18:03+02:00,['6c5f5c8a94b9f8b697d5bd51f9a4fcb70e96c248'],0,1,1,1364360,1,0,0,1,3499
dd0918713d8b5db0a2cf9c3bd7141c2e252bd7e4,0,Jens Geyer,2020-07-03 23:36:13+02:00,['761a869e0508d2cf7975b040a6da54ae62a889b6'],1,1,2,1364362,1,,,,3499
eb45c2a1e48cc50f70298a34702fb365c61b489d,0,Jens Geyer,2020-07-07 22:18:07+02:00,['dd0918713d8b5db0a2cf9c3bd7141c2e252bd7e4'],3,4,7,1364369,1,1,1,0,3499
ec57271d5b90ba06eaad99dda26dc0af9bd2af71,0,Jens Geyer,2020-07-13 23:42:45+02:00,['eb45c2a1e48cc50f70298a34702fb365c61b489d'],47,209,256,1364625,4,,,,3501
58e655e4b99e97a733057be78f614b4d9ddea560,0,Jens Geyer,2020-07-14 21:41:36+02:00,['ec57271d5b90ba06eaad99dda26dc0af9bd2af71'],1,1,2,1364627,1,,,,3501
363ee0001f45118067249ed75ddc348195bf5734,1,Jens Geyer,2020-07-16 08:51:20+02:00,['58e655e4b99e97a733057be78f614b4d9ddea560'],9,124,133,1364760,4,0.4,1,0.966666667,3503
23c8e52fa0708c53f74958944ecf04b293d1db73,1,Jens Geyer,2020-07-16 08:51:36+02:00,['363ee0001f45118067249ed75ddc348195bf5734'],17,24,41,1364801,3,1,1,1,3503
86352b4821085d63861deab59c46ef1042fbfe81,0,Jens Geyer,2020-07-25 12:13:53+02:00,['23c8e52fa0708c53f74958944ecf04b293d1db73'],151,1004,1155,1365956,46,0.592307692,0.933333333,0.571794872,3509
64f419b5ad40df233d34cc3715c68b8d85712699,0,Yuxuan 'fishy' Wang,2020-07-29 12:42:37-07:00,['86352b4821085d63861deab59c46ef1042fbfe81'],2,77,79,1366035,2,0.833333333,0.833333333,1,3509
b93fafd327f6de0f4c7496da5dfd5e8c5d8fe499,0,Yuxuan 'fishy' Wang,2020-08-03 10:48:24-07:00,['64f419b5ad40df233d34cc3715c68b8d85712699'],27,8,35,1366070,3,1,0.230769231,0,3509
68c1506715d834c5ab274a622a67bab207936ac7,1,Jens Geyer,2020-08-05 11:55:00+02:00,['b93fafd327f6de0f4c7496da5dfd5e8c5d8fe499'],14,76,90,1366160,6,0,0,0.612903226,3509
01d53f483a7531ad4899b522060e8913dca309fb,0,Yuxuan 'fishy' Wang,2020-08-06 08:27:55-07:00,['68c1506715d834c5ab274a622a67bab207936ac7'],1,83,84,1366244,3,0.317073171,1,1,3510
c80b8bbe703f593d1aa47941bd6b61f7726068bd,0,Jens Geyer,2020-08-07 16:54:14+02:00,['01d53f483a7531ad4899b522060e8913dca309fb'],40,2607,2647,1368891,27,0.033742331,0.72208589,0.635582822,3518
0503fc0112728bd17d9b5163716265c2a879404f,0,Jens Geyer,2020-08-25 21:58:10+02:00,['c80b8bbe703f593d1aa47941bd6b61f7726068bd'],2,3,5,1368896,1,,,,3518
22b6c0c8bbc7089ce714f782366c2914c5e9eac5,0,Yuxuan 'fishy' Wang,2020-08-29 09:38:13-07:00,['0503fc0112728bd17d9b5163716265c2a879404f'],84,4,88,1368984,5,0,0,0.076923077,3518
3a03da53af6969354d541bf225d9f670978c4118,0,Jens Geyer,2020-08-31 22:37:01+02:00,['22b6c0c8bbc7089ce714f782366c2914c5e9eac5'],3,3,6,1368990,3,,,,3518
cc41c29c08be3830104ef7bec2c181c99d40b1a3,1,Jens Geyer,2020-08-31 22:41:45+02:00,['3a03da53af6969354d541bf225d9f670978c4118'],1,1,2,1368992,1,,,,3518
21b3e46993005e86b05714e3806ee9eb53a1d0af,0,Jens Geyer,2020-08-31 22:46:43+02:00,['cc41c29c08be3830104ef7bec2c181c99d40b1a3'],1,1,2,1368994,1,,,,3518
021cb2707086a926ae49dcb9c1b7929472d0daa9,0,Jens Geyer,2020-08-31 22:52:39+02:00,['21b3e46993005e86b05714e3806ee9eb53a1d0af'],6,0,6,1369000,1,1,1,1,3518
073166f2c4b99b5ab4b425dd2dfc137b00a2e260,0,Jens Geyer,2020-09-02 08:49:42+02:00,['021cb2707086a926ae49dcb9c1b7929472d0daa9'],3,4,7,1369007,1,0,1,1,3518
935770c6b077fd96430684049078bdb9bdff50c5,0,Jens Geyer,2020-09-02 08:54:35+02:00,['073166f2c4b99b5ab4b425dd2dfc137b00a2e260'],7,3,10,1369017,2,0,0,0,3518
b0d14133d5071370905a1b54b37a1a7c86d50e6d,1,Jens Geyer,2020-09-02 09:03:40+02:00,['935770c6b077fd96430684049078bdb9bdff50c5'],353,355,708,1369725,35,1,0,0,3518
47d4a00f51de56d409fe016c5aa78d763128cbca,0,Jens Geyer,2020-09-12 18:52:22+02:00,['b0d14133d5071370905a1b54b37a1a7c86d50e6d'],70,5,75,1369800,4,0.926829268,0.926829268,1,3518
03715899d280c834f8cccbb0435fdedcc456c0e1,0,Jens Geyer,2020-09-12 19:01:36+02:00,['47d4a00f51de56d409fe016c5aa78d763128cbca'],26,55,81,1369881,4,0.423076923,0,0.692307692,3518
6b1cb30f48713f11c0b485d08f494d8cf607a05e,0,Jens Geyer,2020-09-12 19:07:28+02:00,['03715899d280c834f8cccbb0435fdedcc456c0e1'],11,11,22,1369903,11,,,,3518
413377bbbcacbf0b8db5ff456d71ef5fe3a9c2e3,1,Jens Geyer,2020-09-12 19:18:36+02:00,['6b1cb30f48713f11c0b485d08f494d8cf607a05e'],324,336,660,1370563,1,,,,3518
304f50b39fbb1f6a66c1bb76cf88a135d015fda9,0,GitHub,2020-09-14 09:11:07-07:00,['413377bbbcacbf0b8db5ff456d71ef5fe3a9c2e3'],1,1,2,1370565,1,,,,3518
40cd0215f15ccbd2462bb855389467b0fd05b66a,0,Jens Geyer,2020-09-15 09:03:56+02:00,['304f50b39fbb1f6a66c1bb76cf88a135d015fda9'],2,29,31,1370596,2,0,0,1,3518
dd6c8c1069d74f47e81f47dc89285edf906a464e,0,Jens Geyer,2020-09-15 20:39:44+02:00,['40cd0215f15ccbd2462bb855389467b0fd05b66a'],2,8,10,1370606,1,1,1,1,3518
63213c17ad3fece91fdaaca8f59165ca3f41c5c1,1,zeshuai007,2020-09-16 18:37:40+08:00,['dd6c8c1069d74f47e81f47dc89285edf906a464e'],335,1217,1552,1372158,62,0.680161943,0.815789474,0.870445344,3522
dbc4fbf4fe43ba8effd8e4d7cc5c993625cb1d11,0,Jens Geyer,2020-09-17 09:55:07+02:00,['dd6c8c1069d74f47e81f47dc89285edf906a464e'],12,12,24,1372182,1,,,,3522
0d6a2d36ea02839313e63421fb1ba4a9de2604ea,0,Jens Geyer,2020-09-17 11:30:32+02:00,['dbc4fbf4fe43ba8effd8e4d7cc5c993625cb1d11'],0,35,35,1372217,2,,,,3522
c77941c60da01f466827ff619d571055ff76351f,0,Jens Geyer,2020-09-17 11:34:17+02:00,['0d6a2d36ea02839313e63421fb1ba4a9de2604ea'],42,41,83,1372300,1,0,0,1,3522
119030848c4296ddef43d66ffa0cca1354fb357b,0,GitHub,2020-09-18 16:05:44+08:00,"['c77941c60da01f466827ff619d571055ff76351f', '63213c17ad3fece91fdaaca8f59165ca3f41c5c1']",335,1217,1552,1373852,62,,,,3522
e6d97c0f66118c43f43bb71644c18d330a3ae522,0,zeshuai007,2020-09-19 09:23:58+08:00,['c80b8bbe703f593d1aa47941bd6b61f7726068bd'],0,1,1,1373853,1,0,1,1,3522
d5e5fd0c54891e9225a2ce5becd8d8b683f32f06,0,GitHub,2020-09-19 11:59:11+08:00,"['119030848c4296ddef43d66ffa0cca1354fb357b', 'e6d97c0f66118c43f43bb71644c18d330a3ae522']",0,1,1,1373854,1,,,,3522
25f8d5385f4f972fc125273c05e92592116c4606,0,Jens Geyer,2020-09-20 19:07:04+02:00,['d5e5fd0c54891e9225a2ce5becd8d8b683f32f06'],12,12,24,1373878,1,,,,3522
e29c39f921a45ecb87d0f628e2a9babbbc5adbf2,0,Jens Geyer,2020-09-20 19:11:39+02:00,['25f8d5385f4f972fc125273c05e92592116c4606'],17,0,17,1373895,1,0,0,0,3522
4750f361c88a8e7d2fc204d139684b5547ee0425,0,David Suárez,2020-09-21 11:36:36+02:00,['b0d14133d5071370905a1b54b37a1a7c86d50e6d'],69,158,227,1374122,7,1,1,0,3524
03f4729f7c19abb206fae439e27c1dda7250fdcd,0,GitHub,2020-09-22 09:35:39+08:00,"['e29c39f921a45ecb87d0f628e2a9babbbc5adbf2', '4750f361c88a8e7d2fc204d139684b5547ee0425']",69,158,227,1374349,7,,,,3524
a2c44665b416522477cffa6752c2f323768d0507,1,Yuxuan 'fishy' Wang,2020-09-22 16:48:38-07:00,['03f4729f7c19abb206fae439e27c1dda7250fdcd'],17,128,145,1374494,4,0.961038961,0.961038961,1,3524
6dcd64ee5c0886697b38278956335ae4e945341b,0,Yuxuan 'fishy' Wang,2020-09-23 09:16:42-07:00,['a2c44665b416522477cffa6752c2f323768d0507'],9,54,63,1374557,2,1,1,1,3524
c553155af8330a54212eefefaf877b1725a449bc,0,Jens Geyer,2020-09-25 22:04:41+02:00,['6dcd64ee5c0886697b38278956335ae4e945341b'],1,94,95,1374652,1,0.5,0.884615385,0.461538462,3524
6fd830d69024435290ff0e92936b89ebc9603678,0,Jens Geyer,2020-09-27 12:04:43+02:00,['c553155af8330a54212eefefaf877b1725a449bc'],1,2,3,1374655,1,0,0,0,3524
062521f3b6f578d2b78f0ba189cf5d7968074cb1,0,Zezeng Wang,2020-09-28 14:31:07+08:00,['6fd830d69024435290ff0e92936b89ebc9603678'],0,24,24,1374679,1,,,,3524
077b5fce825e79d84592fff893639b92b637eec7,0,GitHub,2020-09-30 07:25:51+01:00,['062521f3b6f578d2b78f0ba189cf5d7968074cb1'],2,13,15,1374694,1,1,1,1,3524
b1a5cd6542f4591563d39ed2021be9fc4690528f,0,Yuxuan 'fishy' Wang,2020-09-30 10:20:19-07:00,['077b5fce825e79d84592fff893639b92b637eec7'],1,1,2,1374696,1,,,,3524
03f01fba18979128cc80cfc03ccdb0f4ffece47b,0,Jens Geyer,2020-10-01 22:43:54+02:00,['b1a5cd6542f4591563d39ed2021be9fc4690528f'],0,8,8,1374704,2,,,,3524
fa22f34e7466d0654dd207ab2e593c5337a1eac5,0,Jens Geyer,2020-10-01 23:00:11+02:00,['03f01fba18979128cc80cfc03ccdb0f4ffece47b'],3,3,6,1374710,2,,,,3524
44b0b5d3c9b2bcaae43470bfe98721d0281958e5,0,Jens Geyer,2020-10-01 23:02:51+02:00,['fa22f34e7466d0654dd207ab2e593c5337a1eac5'],2,2,4,1374714,2,,,,3524
1d68bfe3c4b72370e3db50f164c5241f15fc119c,0,Jens Geyer,2020-10-01 23:11:11+02:00,['44b0b5d3c9b2bcaae43470bfe98721d0281958e5'],0,4,4,1374718,1,0,0,1,3524
330482b02e14955b7a760c59214de3e1b6d03dce,0,Jens Geyer,2020-10-02 21:52:43+02:00,['1d68bfe3c4b72370e3db50f164c5241f15fc119c'],0,1116,1116,1375834,5,0.111922141,0.234793187,0.96836983,3525
5751ddf2ac8df7845c88154a9cc498c46402730d,0,Jens Geyer,2020-10-02 22:02:56+02:00,['330482b02e14955b7a760c59214de3e1b6d03dce'],9,11,20,1375854,1,0,1,1,3525
d89b427d19a07d556c8a6193e81bd1ed948ac5b5,0,Jens Geyer,2020-10-04 22:18:13+02:00,['5751ddf2ac8df7845c88154a9cc498c46402730d'],0,3,3,1375857,2,0,0,1,3525
6d570260caa550741f4da9615cae1b14f328a553,0,Jens Geyer,2020-10-06 22:17:42+02:00,['d89b427d19a07d556c8a6193e81bd1ed948ac5b5'],11,20,31,1375888,3,,,,3525
daf620915714b76fce517b376b963440d1f34089,0,Yuxuan 'fishy' Wang,2020-10-07 22:25:19-07:00,['6d570260caa550741f4da9615cae1b14f328a553'],1,6,7,1375895,2,,,,3525
64c2a4b87ab356e05033045492e51f1ad73a795b,0,Yuxuan 'fishy' Wang,2020-10-14 10:14:03-07:00,['daf620915714b76fce517b376b963440d1f34089'],61,261,322,1376217,6,0.728643216,0.422110553,1,3525
2676327f6ea7851459081047c21138e192b0de65,0,Yuxuan 'fishy' Wang,2020-10-19 14:21:44-07:00,['64c2a4b87ab356e05033045492e51f1ad73a795b'],2,149,151,1376368,1,1,1,0.88372093,3525
22671db01f5c349f2fa54b393581cb4d61bdd895,0,Zezeng Wang,2020-10-24 10:55:27+08:00,['2676327f6ea7851459081047c21138e192b0de65'],0,1,1,1376369,1,,,,3525
6762cad25cad7997d09931ba942212d2d0ef61f1,0,Jens Geyer,2020-10-30 18:26:21+01:00,['22671db01f5c349f2fa54b393581cb4d61bdd895'],1,3,4,1376373,2,,,,3525
997e2d42db27e606bd67be6c91af5e6ef11434aa,0,Zezeng Wang,2020-10-31 09:13:37+08:00,['6762cad25cad7997d09931ba942212d2d0ef61f1'],34,35,69,1376442,9,1,0,0,3525
dca58db2b0bd101d4c2ea83bd6cd8eca0e886751,0,Jens Geyer,2020-11-01 18:08:38+01:00,['997e2d42db27e606bd67be6c91af5e6ef11434aa'],1,1,2,1376444,1,,,,3525
196254ba393a7e70e91fcf3c35026c82fb64f7fa,0,Jens Geyer,2020-11-01 18:12:34+01:00,['dca58db2b0bd101d4c2ea83bd6cd8eca0e886751'],4,50,54,1376498,2,1,1,1,3525
05bb55148608b4324a8c91c21cf9a6a0dff282fa,0,Jens Geyer,2020-11-01 18:17:18+01:00,['196254ba393a7e70e91fcf3c35026c82fb64f7fa'],1,1,2,1376500,1,,,,3525
20205b85fa4541a4276328fc31b1cd2ff8310d42,0,Jens Geyer,2020-11-10 21:34:43+01:00,['05bb55148608b4324a8c91c21cf9a6a0dff282fa'],39,39,78,1376578,10,,,,3525
7ddbcc07ec98349da59bb023d0fed8db37097c18,0,Allen George,2020-11-12 08:47:42-05:00,['22671db01f5c349f2fa54b393581cb4d61bdd895'],180,146,326,1376904,28,0,1,0.236526946,3525
6cd5366b5fe10940d28baff9c7067e3045c3c019,0,GitHub,2020-11-18 10:24:41-05:00,"['20205b85fa4541a4276328fc31b1cd2ff8310d42', '7ddbcc07ec98349da59bb023d0fed8db37097c18']",180,146,326,1377230,28,,,,3525
47e4923a9967b6ba3bbb5377809075c1940ecfc1,0,Jens Geyer,2020-11-19 22:23:35+01:00,['6cd5366b5fe10940d28baff9c7067e3045c3c019'],18,17,35,1377265,2,,,,3525
6e6bb84be9d8ace4be9744d5637fbb59f58db463,0,Jens Geyer,2020-11-19 22:35:37+01:00,['47e4923a9967b6ba3bbb5377809075c1940ecfc1'],45,81,126,1377391,9,1,1,1,3525
384a29616eb01854f85b353cd30d57cb5b83c4fc,0,Zezeng Wang,2020-11-20 09:19:45+08:00,['6e6bb84be9d8ace4be9744d5637fbb59f58db463'],1,1,2,1377393,1,,,,3525
a8770a9dd2f8d50cd0e67e18d7da69c45e5bd606,0,Zezeng Wang,2020-11-20 09:19:45+08:00,['384a29616eb01854f85b353cd30d57cb5b83c4fc'],1,1,2,1377395,1,,,,3525
b6c886c940ff307a824b876c995676a894edb032,0,Zezeng Wang,2020-11-20 09:19:45+08:00,['a8770a9dd2f8d50cd0e67e18d7da69c45e5bd606'],1,5,6,1377401,2,,,,3525
c8dab1f37a74cc52090ba4ce018a0d552dcc637d,0,Zezeng Wang,2020-11-20 09:19:45+08:00,['b6c886c940ff307a824b876c995676a894edb032'],1,2,3,1377404,1,,,,3525
966da2992f8ed8e52bbbb84f266ceb5b9c159480,0,Zezeng Wang,2020-11-20 09:19:45+08:00,['c8dab1f37a74cc52090ba4ce018a0d552dcc637d'],8,11,19,1377423,2,,,,3525
1506661e92df5568c9e537bd68cd1c59dc55f38a,1,Jens Geyer,2020-11-21 15:17:33+01:00,['966da2992f8ed8e52bbbb84f266ceb5b9c159480'],3,13,16,1377439,1,0,0.1,0.3,3525
828ffa8963efe14efd70e1c5c0688bab9f6714db,0,Jens Geyer,2020-11-21 15:19:02+01:00,['1506661e92df5568c9e537bd68cd1c59dc55f38a'],14,8,22,1377461,1,1,1,0,3525
71e972c9708b0b41e7e51ed681a7edd71721ec3e,1,Jens Geyer,2020-11-21 15:27:07+01:00,['828ffa8963efe14efd70e1c5c0688bab9f6714db'],1,1,2,1377463,1,,,,3525
b72b674efc5114b733e0b7ae7ba68ce3933fa051,0,Zezeng Wang,2020-11-28 18:04:38+08:00,['71e972c9708b0b41e7e51ed681a7edd71721ec3e'],3,2,5,1377468,2,,,,3525
c981cf8891cab7277ddb083282c27549da5a9dda,0,Jens Geyer,2020-12-01 22:38:51+01:00,['b72b674efc5114b733e0b7ae7ba68ce3933fa051'],2,2,4,1377472,1,,,,3525
c0619235bdaaaf16941abbf8ba77a84a06708178,0,Jens Geyer,2020-12-03 23:01:53+01:00,['c981cf8891cab7277ddb083282c27549da5a9dda'],1,1,2,1377474,1,,,,3525
66777ad21551d5d2f213fe06b53336988fe29136,0,Jens Geyer,2020-12-04 21:03:01+01:00,['c0619235bdaaaf16941abbf8ba77a84a06708178'],1,9,10,1377484,1,,,,3525
12f6c31c8df739ccff271c8b81345d9a630c8921,1,Jens Geyer,2020-12-04 21:05:43+01:00,['66777ad21551d5d2f213fe06b53336988fe29136'],9,130,139,1377623,6,,,,3529
fb4b5aa17b0542f6f75d9744ecfe904f57431331,0,Zezeng Wang,2020-12-05 14:36:43+08:00,['12f6c31c8df739ccff271c8b81345d9a630c8921'],0,14,14,1377637,2,0.076923077,0,0.692307692,3529
10f2556733b8ee34f2c3695f09c1dff717fdafc8,0,Jens Geyer,2020-12-08 22:19:33+01:00,['fb4b5aa17b0542f6f75d9744ecfe904f57431331'],8,15,23,1377660,2,1,1,1,3529
494a845dd972fc0e68f6937e27ae74efd444b848,0,Jens Geyer,2020-12-09 22:05:36+01:00,['10f2556733b8ee34f2c3695f09c1dff717fdafc8'],2,4,6,1377666,1,1,1,1,3529
70792f2191e5e7345bf08f766638e166d5937f32,0,Jens Geyer,2020-12-09 22:12:14+01:00,['494a845dd972fc0e68f6937e27ae74efd444b848'],1,2,3,1377669,1,,,,3529
4461728f18542eba5d211f9fc412557aab61c491,1,GitHub,2020-12-15 07:35:57+00:00,['70792f2191e5e7345bf08f766638e166d5937f32'],5,63,68,1377737,2,0.104166667,0.125,1,3529
e872b350ab0cfd2402340b8ca82b02dc299db69e,0,Jens Geyer,2020-12-15 21:04:14+01:00,['4461728f18542eba5d211f9fc412557aab61c491'],16,78,94,1377831,3,0,0,0,3529
1e243a76b186142f551a3cb8419131a468ff54ff,0,Zezeng Wang,2020-12-16 11:11:13+08:00,['e872b350ab0cfd2402340b8ca82b02dc299db69e'],1,6,7,1377838,1,,,,3529
dda80547b10d698784713eb62a04f6f42eae107b,0,Yuxuan 'fishy' Wang,2020-12-16 09:27:25-08:00,['1e243a76b186142f551a3cb8419131a468ff54ff'],9,5,14,1377852,1,0,0,0,3529
37c2ceb737cb40377346c63a05f407da1c119ba0,0,Yuxuan 'fishy' Wang,2020-12-16 09:31:18-08:00,['dda80547b10d698784713eb62a04f6f42eae107b'],42,184,226,1378078,3,0.088888889,0.977777778,1,3529
3b9259d88b6ceb13bb6b8c6afe676fed707dcd4e,0,Zezeng Wang,2020-12-19 14:22:13+08:00,['37c2ceb737cb40377346c63a05f407da1c119ba0'],0,32,32,1378110,1,0,0,1,3529
13662dd7be9aa3ffdbbc49bd1c3b77c4549569bd,0,Jens Geyer,2020-12-22 02:11:09+01:00,['3b9259d88b6ceb13bb6b8c6afe676fed707dcd4e'],1,1,2,1378112,1,,,,3529
1c35d6ba954bc441e9e603599965e0121eb5132d,0,GitHub,2021-01-04 11:27:01-08:00,['13662dd7be9aa3ffdbbc49bd1c3b77c4549569bd'],7,14,21,1378133,2,1,1,1,3529
c4e899a6d64aa97430ec9f7608d38db2095f6159,0,Zezeng Wang,2021-01-09 17:38:16+08:00,['1c35d6ba954bc441e9e603599965e0121eb5132d'],1,1,2,1378135,1,,,,3529
c4d1c0d80067986dbee124887bcb402ee1c6538e,1,Yuxuan 'fishy' Wang,2021-01-17 12:24:13-08:00,['c4e899a6d64aa97430ec9f7608d38db2095f6159'],182,1234,1416,1379551,18,0.685358255,0.947040498,1,3531
d831230929bb332189c9509d07102e4be9e7f681,1,Yuxuan 'fishy' Wang,2021-01-17 15:19:44-08:00,['c4d1c0d80067986dbee124887bcb402ee1c6538e'],38,162,200,1379751,11,0.283783784,0.527027027,0.851351351,3531
7f9abb1cc0f4b2793a48f45ddfcf0d2b287cc50c,0,Mario Emmenlauer,2021-01-18 08:16:26+01:00,['d831230929bb332189c9509d07102e4be9e7f681'],7,7,14,1379765,1,,,,3531
0e68e8c51b2924d211a47978c80c6753f45e8af3,0,Yuxuan 'fishy' Wang,2021-01-19 10:46:29-08:00,['7f9abb1cc0f4b2793a48f45ddfcf0d2b287cc50c'],24,50,74,1379839,3,1,1,1,3531
e27e82c46ba4d46c2c3267701191cdc26614f739,0,Yuxuan 'fishy' Wang,2021-01-20 09:11:02-08:00,['0e68e8c51b2924d211a47978c80c6753f45e8af3'],65,71,136,1379975,17,0,0.363636364,0.636363636,3532
d9fcdd3dbafbe1a8296018d0d6c55d972f607a42,0,Yuxuan 'fishy' Wang,2021-01-20 11:49:24-08:00,['e27e82c46ba4d46c2c3267701191cdc26614f739'],3,0,3,1379978,1,,,,3532
8dd04f4adfaea08699b1745c79f122bf9cbd6f07,0,Yuxuan 'fishy' Wang,2021-01-22 20:49:57-08:00,['d9fcdd3dbafbe1a8296018d0d6c55d972f607a42'],12,29,41,1380019,2,1,1,0,3532
c2ddaf0766499ab522cb7c0ca011d579707fcb5f,0,Yuxuan 'fishy' Wang,2021-01-22 20:50:27-08:00,['8dd04f4adfaea08699b1745c79f122bf9cbd6f07'],34,60,94,1380113,7,0,0.344827586,0.724137931,3532
bee96a1ff02d682c955707406f21164cd8d66552,1,Jens Geyer,2021-01-24 12:31:58+01:00,['c2ddaf0766499ab522cb7c0ca011d579707fcb5f'],1,1,2,1380115,1,,,,3532
0f21e39c9ba1b20a50d035f01c14836885678d08,0,Jens Geyer,2021-01-24 12:33:48+01:00,['bee96a1ff02d682c955707406f21164cd8d66552'],0,26,26,1380141,1,1,1,0.8,3532
1f73455940c440cd9b4226c92e01ae0f0378705c,0,Mario Emmenlauer,2021-02-03 13:35:36+01:00,['0f21e39c9ba1b20a50d035f01c14836885678d08'],21,21,42,1380183,2,,,,3532
93d20993f911795b4bcfbcb8143397dad77267bc,0,GitHub,2021-02-03 17:26:05+01:00,"['0f21e39c9ba1b20a50d035f01c14836885678d08', '1f73455940c440cd9b4226c92e01ae0f0378705c']",21,21,42,1380225,2,,,,3532
4aaef75819aea3f79ec812393dbe13bb62bd6c45,0,Yuxuan 'fishy' Wang,2021-02-03 21:05:22-08:00,['93d20993f911795b4bcfbcb8143397dad77267bc'],9,549,558,1380783,4,0.108401084,0.471544715,0.582655827,3534
55016bff2b19f2c5d3c85ae9985c49527ffffabb,0,Jens Geyer,2021-02-04 10:21:36+01:00,['4aaef75819aea3f79ec812393dbe13bb62bd6c45'],4,5,9,1380792,1,,,,3534
ebc2ab558dce946b2a3134028b08ed59d49cd1e3,0,GitHub,2021-02-04 09:14:11-05:00,['55016bff2b19f2c5d3c85ae9985c49527ffffabb'],5,46,51,1380843,2,1,1,1,3534
7ae1ec3f1eb3218f8b623232436bc986e3f1f5c8,1,Jens Geyer,2021-02-04 16:39:48+01:00,['ebc2ab558dce946b2a3134028b08ed59d49cd1e3'],130,64,194,1381037,2,0.574074074,0.574074074,0,3534
de523c79b38bfd74aed812532ad6557d704bc945,0,Jens Geyer,2021-02-04 17:41:23+01:00,['7ae1ec3f1eb3218f8b623232436bc986e3f1f5c8'],6,298,304,1381341,1,,,,3534
518163afbd7c4f6733d12fa6f2de3db612fda947,0,Jens Geyer,2021-02-04 20:49:45+01:00,['de523c79b38bfd74aed812532ad6557d704bc945'],2,2,4,1381345,1,,,,3534
ebfa771a26e406da947f72ae8d87602c892435cc,0,Jens Geyer,2021-02-04 22:10:30+01:00,['518163afbd7c4f6733d12fa6f2de3db612fda947'],0,12,12,1381357,2,,,,3534
705f37783343ebc5aaee0e504c31ea4abe149cd5,0,Jens Geyer,2021-02-04 22:13:17+01:00,['ebfa771a26e406da947f72ae8d87602c892435cc'],0,11,11,1381368,2,,,,3534
0be1b7d7580f90cfdc3206f7fd7cf4306dcf5817,0,Jens Geyer,2021-02-04 23:36:10+01:00,['705f37783343ebc5aaee0e504c31ea4abe149cd5'],0,1,1,1381369,1,,,,3534
8411e189b0af09e5baad34031555870cf692c1ad,0,Jens Geyer,2021-02-05 00:13:59+01:00,['0be1b7d7580f90cfdc3206f7fd7cf4306dcf5817'],115,155,270,1381639,21,,,,3534
2ef0113d69527cf2b8b6d6df0ecd2650d6f7bf38,0,Jens Geyer,2021-02-05 12:58:49+01:00,['ebfa771a26e406da947f72ae8d87602c892435cc'],115,156,271,1381910,21,,,,3534
897652e5f08147efad9db66b86c3036b3d3826db,0,Jens Geyer,2021-02-10 20:25:47+01:00,['2ef0113d69527cf2b8b6d6df0ecd2650d6f7bf38'],88,51,139,1382049,1,,,,3534
b89316d54bb0253493b48446cb510755fb3196d2,0,Jens Geyer,2021-02-10 20:27:08+01:00,['897652e5f08147efad9db66b86c3036b3d3826db'],1,17596,17597,1399646,122,0.359792536,0.528808208,0.752283234,3647
876aee506b937d64b1fb035ff65e5e52def04c04,0,Jens Geyer,2021-02-10 20:27:08+01:00,['b89316d54bb0253493b48446cb510755fb3196d2'],28,261,289,1399935,16,,,,3651
b5fe1dbc0cac81ab99ec5d71de70f4389b234888,0,Jens Geyer,2021-02-11 22:49:49+01:00,['876aee506b937d64b1fb035ff65e5e52def04c04'],17857,29,17886,1417821,137,0.640207464,0.471191792,0.247716766,3651
3fc0b8d061fb1adcae49862e0c63ce94f0a0ee0f,0,Jens Geyer,2021-02-11 23:17:45+01:00,['b5fe1dbc0cac81ab99ec5d71de70f4389b234888'],64,73,137,1417958,56,,,,3651
4fa710ea761f44ff202c0372a633afaf32958c52,0,Mario Emmenlauer,2021-02-12 11:10:15+01:00,['3fc0b8d061fb1adcae49862e0c63ce94f0a0ee0f'],3,18,21,1417979,1,,,,3651
0db67ab7511748c3bfc33dcf186366518cb7cc32,0,Mario Emmenlauer,2021-02-12 11:10:15+01:00,['4fa710ea761f44ff202c0372a633afaf32958c52'],2,7,9,1417988,1,,,,3651
7553fc5d52b75af8e1b2b3c5f1807bdf24868f2b,0,Mario Emmenlauer,2021-02-12 11:10:15+01:00,['0db67ab7511748c3bfc33dcf186366518cb7cc32'],24,20,44,1418032,6,,,,3651
e5e7d1d5fc43f3f01fd0eecc34d48bcb611475bc,0,GitHub,2021-02-12 13:04:06+01:00,"['3fc0b8d061fb1adcae49862e0c63ce94f0a0ee0f', '7553fc5d52b75af8e1b2b3c5f1807bdf24868f2b']",29,45,74,1418106,7,,,,3651
037916b45d28fea865ab22e55a23e3702b70da73,0,Mario Emmenlauer,2021-02-12 13:05:19+01:00,['e5e7d1d5fc43f3f01fd0eecc34d48bcb611475bc'],10,21,31,1418137,2,,,,3651
1d905de6442be17bb70ce7f306b6abc4b46dfc83,0,GitHub,2021-02-12 15:33:57+01:00,"['e5e7d1d5fc43f3f01fd0eecc34d48bcb611475bc', '037916b45d28fea865ab22e55a23e3702b70da73']",10,21,31,1418168,2,,,,3651
d270b35e58e018478dda996efc5d2f4d315811ec,0,Mario Emmenlauer,2021-02-12 15:35:11+01:00,['1d905de6442be17bb70ce7f306b6abc4b46dfc83'],24,69,93,1418261,11,,,,3652
102e83413bd1b6b3ea254d2ab508d20f192aa31e,0,GitHub,2021-02-12 17:57:25+01:00,"['1d905de6442be17bb70ce7f306b6abc4b46dfc83', 'd270b35e58e018478dda996efc5d2f4d315811ec']",24,69,93,1418354,11,,,,3652
2af1037b8ec3609d15525a9981cb75d52997ddd6,0,Jens Geyer,2021-02-13 12:21:31+01:00,['102e83413bd1b6b3ea254d2ab508d20f192aa31e'],22,33,55,1418409,1,,,,3652
d446f0248f68216ec1ef9bfcc23e634d15cc6e38,0,Jens Geyer,2021-02-13 12:22:06+01:00,['8411e189b0af09e5baad34031555870cf692c1ad'],22,33,55,1418464,1,,,,3652
b51a62b9686bad1db949735025ca6823c3c8462b,0,Jens Geyer,2021-02-13 15:15:09+01:00,['2af1037b8ec3609d15525a9981cb75d52997ddd6'],0,3,3,1418467,1,0,0,0,3652
cb094b80f2b5a6752063124a50c05f070e95c7a7,0,Jens Geyer,2021-02-14 11:18:01+01:00,['b51a62b9686bad1db949735025ca6823c3c8462b'],5776,10,5786,1424253,60,0.901667625,0.70960322,0.393904543,3652
b04e39a7e91d7828cce9168c4660b89400930ee5,0,Jens Geyer,2021-02-14 11:34:38+01:00,['cb094b80f2b5a6752063124a50c05f070e95c7a7'],17,101,118,1424371,4,0,0,0,3654
47b3d3b148c5181c02f4f871444fe93ad4ec65f2,0,Jens Geyer,2021-02-14 11:38:54+01:00,['b04e39a7e91d7828cce9168c4660b89400930ee5'],1,2,3,1424374,1,,,,3654
2e7f39f6b69d98fccba714266f3fa92bbce934cd,0,Jens Geyer,2021-02-14 11:40:14+01:00,['47b3d3b148c5181c02f4f871444fe93ad4ec65f2'],3,15,18,1424392,1,,,,3654
8461365378328735066e5597af65d1e99aea611a,0,Jens Geyer,2021-02-15 03:46:08+01:00,"['2e7f39f6b69d98fccba714266f3fa92bbce934cd', 'd446f0248f68216ec1ef9bfcc23e634d15cc6e38']",0,12,12,1424404,3,,,,3654
526a1acf3b870d3b292423e19b9bb9bb0d18c0c3,1,Jens Geyer,2021-02-15 09:12:56+01:00,['8461365378328735066e5597af65d1e99aea611a'],71,223,294,1424698,29,0.111111111,0,0.666666667,3657
055fe67ec1856d25f7ad3b98b5cd172fdf8e2c70,0,Yuxuan 'fishy' Wang,2021-02-16 16:31:00-08:00,['526a1acf3b870d3b292423e19b9bb9bb0d18c0c3'],2,7,9,1424707,3,1,1,1,3657
36bd59ff8260b2d5bd5825d3361121423022948e,0,Jens Geyer,2021-02-17 19:51:36+01:00,['055fe67ec1856d25f7ad3b98b5cd172fdf8e2c70'],1,1,2,1424709,1,,,,3657
011eb22e32eea4a3220dcea6fd63f608e682ba2c,0,Jens Geyer,2021-02-17 19:53:04+01:00,['d446f0248f68216ec1ef9bfcc23e634d15cc6e38'],1,1,2,1424711,1,,,,3657
a2522c0c8329a76bab42af251f06bd348ad0ecbd,0,Yuxuan 'fishy' Wang,2021-02-17 18:50:47-08:00,['36bd59ff8260b2d5bd5825d3361121423022948e'],8,23,31,1424742,2,0,0,1,3657
f9177f34e6a49e359193feac75762ae0bb53077f,0,Yuxuan 'fishy' Wang,2021-02-18 13:54:04-08:00,['a2522c0c8329a76bab42af251f06bd348ad0ecbd'],3,4,7,1424749,1,0,1,1,3657
2c0f932301231c8d9996dc21c183c586e0a80d08,0,Jens Geyer,2021-02-19 00:08:16+01:00,['011eb22e32eea4a3220dcea6fd63f608e682ba2c'],0,3,3,1424752,1,0,0,0,3657
c15e75d4acaa9cd804dd3f6c5e732508f9118f64,0,Jens Geyer,2021-02-19 00:28:39+01:00,['f9177f34e6a49e359193feac75762ae0bb53077f'],0,1,1,1424753,1,1,1,1,3657
62f1bd556110e3e3795a1145c876a33d9dca2d37,0,Jens Geyer,2021-02-19 09:00:56+01:00,['c15e75d4acaa9cd804dd3f6c5e732508f9118f64'],1,5,6,1424759,1,0,1,1,3657
8a1743df9eb62cf98121f158a6553d1065b990b5,0,Allen George,2021-02-19 23:34:33-05:00,['62f1bd556110e3e3795a1145c876a33d9dca2d37'],19,457,476,1425235,1,0.063829787,1,0.987841945,3657
489051002273fc15af6becc2810c18bb66b1e111,0,Allen George,2021-02-20 08:47:01-05:00,['8a1743df9eb62cf98121f158a6553d1065b990b5'],54,11,65,1425300,1,0.566666667,0,0,3657
6813b1914bf32b8d37d10207f10a092064ba36d7,0,GitHub,2021-02-21 13:35:37-05:00,"['62f1bd556110e3e3795a1145c876a33d9dca2d37', '489051002273fc15af6becc2810c18bb66b1e111']",18,413,431,1425731,1,,,,3657
b0b353191aeaa1b427d105892efa7facea6d4f1f,1,Yuxuan 'fishy' Wang,2021-02-22 10:02:48-08:00,['6813b1914bf32b8d37d10207f10a092064ba36d7'],17,105,122,1425853,6,,,,3659
cee3ddb0e0a18d0aa1a1f5b06e643604c5c4ee86,0,Yuxuan 'fishy' Wang,2021-02-22 10:02:58-08:00,['2c0f932301231c8d9996dc21c183c586e0a80d08'],2,7,9,1425862,3,1,1,1,3659
abb8fa8c44caaa0e46038f7a0840e559cd3b51be,0,Yuxuan 'fishy' Wang,2021-02-22 10:02:58-08:00,['cee3ddb0e0a18d0aa1a1f5b06e643604c5c4ee86'],8,23,31,1425893,2,0,0,1,3659
bb8fec7930a3a6789d0b9602412ee57a56ad551c,0,Yuxuan 'fishy' Wang,2021-02-22 10:02:58-08:00,['abb8fa8c44caaa0e46038f7a0840e559cd3b51be'],17,105,122,1426015,6,,,,3661
e89b3e11eed32ac7aa34d566ee1a8f45710a270b,0,Yuxuan 'fishy' Wang,2021-02-22 10:02:58-08:00,['bb8fec7930a3a6789d0b9602412ee57a56ad551c'],3,4,7,1426022,1,0,1,1,3661
13f9e9e86471b45189eb40ca00fdb5a2a7fa0f26,0,Jens Geyer,2021-02-24 20:40:45+01:00,['e89b3e11eed32ac7aa34d566ee1a8f45710a270b'],2,4,6,1426028,1,,,,3661
e254b21c73c9894410f07304461057af9a8fe86b,0,Jens Geyer,2021-02-24 22:31:45+01:00,['b0b353191aeaa1b427d105892efa7facea6d4f1f'],2,4,6,1426034,1,,,,3661
4a8b0f9ecc06356639ed538324c5dd0f9936d757,0,Jens Geyer,2021-02-24 23:05:04+01:00,['13f9e9e86471b45189eb40ca00fdb5a2a7fa0f26'],1,1,2,1426036,1,,,,3661
6140fb27e0b15de2ba042401073435b049482389,0,Jens Geyer,2021-02-24 23:05:19+01:00,['e254b21c73c9894410f07304461057af9a8fe86b'],1,1,2,1426038,1,,,,3661
93ae7af5ba6b70530e4d812b50fed4afa0827f44,0,Jens Geyer,2021-02-26 21:06:46+01:00,['6140fb27e0b15de2ba042401073435b049482389'],2,15,17,1426055,2,,,,3661
65fb49bb41f852375b278c9057d52c9472f0cb3a,0,Jens Geyer,2021-02-26 21:07:11+01:00,['4a8b0f9ecc06356639ed538324c5dd0f9936d757'],2,15,17,1426072,2,,,,3661
5cff2793c0ee3139a76e0d685aa64491299bba8d,0,Allen George,2021-02-28 17:20:41-05:00,['93ae7af5ba6b70530e4d812b50fed4afa0827f44'],41,18,59,1426131,2,0,0,0,3661
4f6439b30953865fd1ec23729cbf17292c0ad17d,0,GitHub,2021-02-28 20:33:08-05:00,"['93ae7af5ba6b70530e4d812b50fed4afa0827f44', '5cff2793c0ee3139a76e0d685aa64491299bba8d']",41,18,59,1426190,2,,,,3661
2e90ef569c1b38f6e0f1279e3f25d2a7f6b5ff99,0,GitHub,2021-03-01 14:47:04-05:00,['4f6439b30953865fd1ec23729cbf17292c0ad17d'],72,159,231,1426421,7,0,0.837209302,0.837209302,3661
1ab156ab17b6f3268a1ba57034b4d4dc96f4f306,0,Jens Geyer,2021-03-01 22:59:33+01:00,['2e90ef569c1b38f6e0f1279e3f25d2a7f6b5ff99'],488,725,1213,1427634,43,,,,3662
55c3e4c2eff86b61eae1b098803e72d682bdaafb,0,GitHub,2021-03-01 23:19:52-05:00,['1ab156ab17b6f3268a1ba57034b4d4dc96f4f306'],308,256,564,1428198,21,1,1,0.5,3663
a8c041dd580ff37f3e32b0eaafed542f496d5d58,0,Jens Geyer,2021-03-02 20:14:53+01:00,['55c3e4c2eff86b61eae1b098803e72d682bdaafb'],7,6,13,1428211,4,,,,3663
65291dac391080d8aa8188ea62f428f4398425cc,0,Jens Geyer,2021-03-02 21:02:34+01:00,['65fb49bb41f852375b278c9057d52c9472f0cb3a'],66,71,137,1428348,51,,,,3663
c1e33a8436d716c49501417a5c8755ffd56c8719,0,Jens Geyer,2021-03-03 01:43:08+01:00,['65291dac391080d8aa8188ea62f428f4398425cc'],0,33,33,1428381,1,,,,3663
99c3aa27e6f6daa062b905a65495315c0c2ded90,0,GitHub,2021-03-06 14:11:56-05:00,['a8c041dd580ff37f3e32b0eaafed542f496d5d58'],17,24,41,1428422,6,1,1,0,3663
b4d108d47e76258438a19b6db79667775986e277,0,Jens Geyer,2021-03-06 22:48:41+01:00,['99c3aa27e6f6daa062b905a65495315c0c2ded90'],0,17,17,1428439,1,,,,3663
7482f1130eea597a0f28054a748636c969df9710,0,Jens Geyer,2021-03-06 23:06:18+01:00,['b4d108d47e76258438a19b6db79667775986e277'],0,34,34,1428473,2,,,,3663
a194276fab1bbdbf6e9e45bbfd2db0b4cd327648,0,GitHub,2021-03-06 17:39:02-05:00,['7482f1130eea597a0f28054a748636c969df9710'],62,120,182,1428655,3,0.05,0,0,3663
372ada90df60c7c4d0cc48da5f09c6988950049c,0,GitHub,2021-03-07 09:03:52-05:00,['a194276fab1bbdbf6e9e45bbfd2db0b4cd327648'],4,17,21,1428676,1,0,1,1,3663
0d12832d92351f2cbb2c59edaeb114f789c0ec9b,1,Jens Geyer,2021-03-08 09:04:28+01:00,['372ada90df60c7c4d0cc48da5f09c6988950049c'],224,266,490,1429166,13,1,1,0.181818182,3663
83370694d03c68e81c76dc38b17b272b51dd1e35,0,Jens Geyer,2021-03-09 23:35:57+01:00,['0d12832d92351f2cbb2c59edaeb114f789c0ec9b'],0,15,15,1429181,1,,,,3663
f926d84a4824b136611f95b78e4064fda5966b9e,0,Jens Geyer,2021-03-10 23:05:06+01:00,['83370694d03c68e81c76dc38b17b272b51dd1e35'],0,15,15,1429196,1,,,,3664
de6f61aed04e4de8e51ae44fa634451e77f17a52,0,GitHub,2021-03-11 08:25:26-05:00,['f926d84a4824b136611f95b78e4064fda5966b9e'],8,956,964,1430160,24,0.25,0.716666667,0.933333333,3684
cc70b4e89a1579559bc50fb8216c471a5c550926,0,Jens Geyer,2021-03-11 22:41:44+01:00,['de6f61aed04e4de8e51ae44fa634451e77f17a52'],2,35,37,1430197,6,0,1,1,3684
62beb6751d3c70f8db8fed4a3bb76e4ff3765c22,0,Yuxuan 'fishy' Wang,2021-03-15 09:28:27-07:00,['cc70b4e89a1579559bc50fb8216c471a5c550926'],2,5,7,1430204,1,0,0,0,3684
2dcefadba853c9ad0ab5e908894213826ec3b43a,1,Jens Geyer,2021-03-17 20:42:29+01:00,['62beb6751d3c70f8db8fed4a3bb76e4ff3765c22'],757,1172,1929,1432133,44,0.25,1,0,3688
cd2fae091b9bafd0977ef290f722532c36a64d2e,0,Jens Geyer,2021-03-18 16:53:32+01:00,['2dcefadba853c9ad0ab5e908894213826ec3b43a'],1,6,7,1432140,1,0,0,1,3688
66d897667c451ef6560d89b979b7001c57a3eda6,0,Jens Geyer,2021-03-22 09:42:38+01:00,['cd2fae091b9bafd0977ef290f722532c36a64d2e'],7272,2,7274,1439414,80,0.908056042,0.6882662,0.160245184,3688
65ea75279aa8c4678075d29063e3d5b0658ef155,0,Yuxuan 'fishy' Wang,2021-03-24 10:03:20-07:00,['66d897667c451ef6560d89b979b7001c57a3eda6'],1,212,213,1439627,5,0.333333333,0.636363636,0.595959596,3691
b71f11e251a711604cea8caad7d493ea57fe8a8f,1,Yuxuan 'fishy' Wang,2021-03-24 13:32:14-07:00,['65ea75279aa8c4678075d29063e3d5b0658ef155'],144,169,313,1439940,46,,,,3693
149c8d09b11328c0cd6da79fd9267520b800fefc,0,Jens Geyer,2021-03-24 22:20:41+01:00,['b71f11e251a711604cea8caad7d493ea57fe8a8f'],5,5,10,1439950,1,,,,3693
b87873222a509f5c6ba07e9d7c78d7b20909f805,0,Jens Geyer,2021-03-24 22:34:12+01:00,['149c8d09b11328c0cd6da79fd9267520b800fefc'],26,1,27,1439977,4,1,1,0.5,3693
3761f0048d0dcf901b683329b4b29cdbd47708fb,0,Yuxuan 'fishy' Wang,2021-03-26 07:57:09-07:00,['b87873222a509f5c6ba07e9d7c78d7b20909f805'],3,15,18,1439995,3,,,,3694
eb0f1175a7e966812e8ddfc44006a7fc8df6102a,0,Jens Geyer,2021-03-26 22:19:05+01:00,['3761f0048d0dcf901b683329b4b29cdbd47708fb'],12,1,13,1440008,3,,,,3694
2f158431656a59aa87fbe640562cc402da7a06d6,0,Jens Geyer,2021-03-26 22:25:04+01:00,['eb0f1175a7e966812e8ddfc44006a7fc8df6102a'],1,57,58,1440066,2,1,1,1,3695
638ffbc5e6e4a74746ee7099f4365d85a6e1c52f,0,Jens Geyer,2021-03-26 22:55:47+01:00,['2f158431656a59aa87fbe640562cc402da7a06d6'],19,38,57,1440123,1,,,,3695
e1eb1dc3e400daf1d654f0d045c6990a5c1ada6e,0,Jens Geyer,2021-03-27 01:03:25+01:00,['638ffbc5e6e4a74746ee7099f4365d85a6e1c52f'],5,5,10,1440133,5,,,,3695
5bae216dbcb4ccbf8e59f7af38808a04988f7b25,0,Jens Geyer,2021-03-27 01:03:26+01:00,['e1eb1dc3e400daf1d654f0d045c6990a5c1ada6e'],0,42,42,1440175,1,,,,3695
fafcea7b5c83668424a90cd1d0ec5e985ad446f5,0,Jens Geyer,2021-03-27 10:58:49+01:00,['5bae216dbcb4ccbf8e59f7af38808a04988f7b25'],1,62,63,1440238,4,,,,3697
7f1fc276d476c79e3e4fcadc26a9b0533b63624c,0,Jens Geyer,2021-03-27 11:17:08+01:00,['fafcea7b5c83668424a90cd1d0ec5e985ad446f5'],3,3,6,1440244,1,,,,3697
7054b315f4fc84d95461268a5e47b67f4ff6801d,0,Jens Geyer,2021-03-27 11:17:55+01:00,['7f1fc276d476c79e3e4fcadc26a9b0533b63624c'],27,18,45,1440289,3,,,,3697
7e537505f014d8ede86f30a7500136c2f3e99505,0,Jens Geyer,2021-03-29 08:51:52+02:00,['7054b315f4fc84d95461268a5e47b67f4ff6801d'],40,134,174,1440463,1,0.024390244,0.048780488,0.475609756,3697
cc8c2c630393f109779816b7650a33f50b7763b5,0,Jens Geyer,2021-03-29 22:59:58+02:00,['7e537505f014d8ede86f30a7500136c2f3e99505'],2,11,13,1440476,2,,,,3697
589ee5b160f808fdee18ae9657d7c9e2f70014f0,0,Jens Geyer,2021-03-29 22:59:58+02:00,['cc8c2c630393f109779816b7650a33f50b7763b5'],6,41,47,1440523,3,,,,3697
036665edc1b1567e521472f295ce039a10d06b73,0,Jens Geyer,2021-03-29 22:59:59+02:00,['589ee5b160f808fdee18ae9657d7c9e2f70014f0'],0,1,1,1440524,1,,,,3697
66f9536e2cd3899a9dbbb740eff44ec0271787c3,1,Jens Geyer,2021-03-29 22:59:59+02:00,['036665edc1b1567e521472f295ce039a10d06b73'],131,1405,1536,1442060,25,,,,3705
fa87d0ea424da50930c2843e1117a5c2abe20593,0,Jens Geyer,2021-03-30 21:35:30+02:00,['66f9536e2cd3899a9dbbb740eff44ec0271787c3'],3,15,18,1442078,2,1,1,1,3705
037753eb6b5c56db0c2b9f4d932377f06452022b,0,Jens Geyer,2021-04-01 23:34:47+02:00,['fa87d0ea424da50930c2843e1117a5c2abe20593'],6,1969,1975,1444053,12,0.191452991,0.742735043,0.760683761,3711
20a86d68e9f6ac8774308bd491f93d476b10203d,0,Jens Geyer,2021-04-02 11:41:09+02:00,['037753eb6b5c56db0c2b9f4d932377f06452022b'],20,77,97,1444150,2,,,,3711
ef0cb01abed2558a2a15ed6675e9156d765ff81e,0,Jens Geyer,2021-04-02 19:05:59+02:00,['20a86d68e9f6ac8774308bd491f93d476b10203d'],13,40,53,1444203,3,0.583333333,0.583333333,0.083333333,3711
97fb3c4b2aca0e8de0c5f6f229c535a861456f98,0,Jens Geyer,2021-04-09 08:58:16+02:00,['ef0cb01abed2558a2a15ed6675e9156d765ff81e'],20,27,47,1444250,1,1,1,1,3711
6583f4e52345c3b05a76f0b188836599628356e8,1,Yuxuan 'fishy' Wang,2021-04-09 11:22:33-07:00,['97fb3c4b2aca0e8de0c5f6f229c535a861456f98'],32,87,119,1444369,5,0.19047619,0,1,3711
6228b907e0a01659515e8e4715c70f540fe07589,1,Jens Geyer,2021-04-10 10:09:44+02:00,['6583f4e52345c3b05a76f0b188836599628356e8'],18,21,39,1444408,3,0,0,0,3711
2b2ea622b67c9b0be4e6baf09cc604fad887cae4,0,Jens Geyer,2021-04-10 10:10:27+02:00,['6228b907e0a01659515e8e4715c70f540fe07589'],218,228,446,1444854,10,0.294117647,1,0.588235294,3712
430e540ef99b2072125897ff6a666b9ec679926f,0,Jens Geyer,2021-04-10 10:19:43+02:00,['2b2ea622b67c9b0be4e6baf09cc604fad887cae4'],0,1,1,1444855,1,,,,3712
d4e1eb98525faffafdba4f36f44e3e7382cc0fd0,0,Jens Geyer,2021-04-15 19:05:24+02:00,['430e540ef99b2072125897ff6a666b9ec679926f'],15,12,27,1444882,3,0,0,0,3712
80415f05d621c861aeaa791fa93a1c3bee8b84bc,0,Jens Geyer,2021-04-16 09:47:28+02:00,['d4e1eb98525faffafdba4f36f44e3e7382cc0fd0'],2,6,8,1444890,1,1,0,1,3712
fe3f8a1279660b2e3a47798fa2c8a7bd6800e4e9,1,Yuxuan 'fishy' Wang,2021-04-28 18:49:58-07:00,['80415f05d621c861aeaa791fa93a1c3bee8b84bc'],5,18,23,1444913,4,0,0,1,3712
0f735583bb258ce8ec141eb2e9aad3ce51052322,0,Yuxuan 'fishy' Wang,2021-04-28 18:49:58-07:00,['fe3f8a1279660b2e3a47798fa2c8a7bd6800e4e9'],2,5,7,1444920,3,,,,3712
c821d250976c690ebc45ae4f769d51951c0bfda4,0,Jens Geyer,2021-04-29 08:57:43+02:00,['0f735583bb258ce8ec141eb2e9aad3ce51052322'],2,2,4,1444924,1,,,,3712
9fab23876ba88b5ed744aaaa900861a0e3400d76,0,Mario Emmenlauer,2021-05-05 10:41:48+02:00,['c821d250976c690ebc45ae4f769d51951c0bfda4'],57,54,111,1445035,2,,,,3712
ecf273f0609151115a31e8fdedcff285305ffa66,0,Jens Geyer,2021-05-05 20:34:34+02:00,['c821d250976c690ebc45ae4f769d51951c0bfda4'],0,52,52,1445087,3,0,0,0.8,3712
aeb8964dda7128a1f6090c3fc3d8091f6f0b45c4,0,Jens Geyer,2021-05-05 20:43:44+02:00,['ecf273f0609151115a31e8fdedcff285305ffa66'],7,9,16,1445103,6,,,,3712
32f54667bef5da6c40b1d45edfef71643d8f3e60,0,Jens Geyer,2021-05-06 22:30:59+02:00,['aeb8964dda7128a1f6090c3fc3d8091f6f0b45c4'],1,1,2,1445105,1,,,,3712
728ba7f8934c2dcc6108ab1f63c33f67979f788f,0,Jens Geyer,2021-05-13 21:06:48+02:00,['32f54667bef5da6c40b1d45edfef71643d8f3e60'],1,1,2,1445107,1,,,,3712
348de16250f043236a26e0856150301eac3e6477,0,Jens Geyer,2021-05-13 21:17:08+02:00,['728ba7f8934c2dcc6108ab1f63c33f67979f788f'],1,1,2,1445109,1,,,,3712
bc18a925193e1a43e6b22cc6dde66ce04384dd5e,1,Jens Geyer,2021-05-15 00:45:16+02:00,['348de16250f043236a26e0856150301eac3e6477'],56,72,128,1445237,1,0,0.25,0.6875,3712
33b7f48ba4673a40bd69212bc5baec2a34d38d22,0,Jens Geyer,2021-05-15 21:58:17+02:00,['bc18a925193e1a43e6b22cc6dde66ce04384dd5e'],0,1,1,1445238,1,1,1,1,3712
8101302c568bf7631448f11f7a5f6a22287d5cbe,0,Jens Geyer,2021-05-17 22:27:25+02:00,['33b7f48ba4673a40bd69212bc5baec2a34d38d22'],2,9,11,1445249,1,0,0,1,3712
c54cfcb8d213180986ce14e63abe122c1a4ec86f,0,Jens Geyer,2021-05-20 22:38:23+02:00,['8101302c568bf7631448f11f7a5f6a22287d5cbe'],1,15,16,1445265,1,0,0,1,3712
346c72c0d05b83489b4bec10bb4920c9c9ae8bc3,0,Jens Geyer,2021-05-20 22:41:31+02:00,['c54cfcb8d213180986ce14e63abe122c1a4ec86f'],7,3,10,1445275,1,1,1,1,3712
70992f1e74e525461121fb9e607000b19f31a4ca,0,Jens Geyer,2021-05-20 22:50:22+02:00,['346c72c0d05b83489b4bec10bb4920c9c9ae8bc3'],0,7,7,1445282,1,,,,3712
63d114de97f8ddb67c1fb33d75ccb91a3b487b92,0,Jens Geyer,2021-05-26 09:25:39+02:00,['70992f1e74e525461121fb9e607000b19f31a4ca'],10,31,41,1445323,2,0,0,1,3712
9a4802ab411f1f45b58a8eae015707502e36b8ed,0,Jens Geyer,2021-05-26 22:34:18+02:00,['63d114de97f8ddb67c1fb33d75ccb91a3b487b92'],8,8,16,1445339,1,,,,3712
4abc5cfb4b3dea54484ca49a584b472a7373f3c5,0,Jens Geyer,2021-05-27 23:12:53+02:00,['9a4802ab411f1f45b58a8eae015707502e36b8ed'],8,40,48,1445387,3,,,,3712
323f0325edb387a447e5b5fedc852bb6971a0286,0,ubuntu,2021-05-31 18:56:05+05:18,['4abc5cfb4b3dea54484ca49a584b472a7373f3c5'],0,47,47,1445434,5,1,1,1,3712
be20ad7e08fab200391e3eab41acde9da2a4fd07,0,Yuxuan 'fishy' Wang,2021-06-03 22:16:32-07:00,['4abc5cfb4b3dea54484ca49a584b472a7373f3c5'],0,3,3,1445437,1,0,1,0,3712
ea456f665466cf4d9a412bba0a2770ee895bd836,0,GitHub,2021-06-04 09:55:01+02:00,"['be20ad7e08fab200391e3eab41acde9da2a4fd07', '9fab23876ba88b5ed744aaaa900861a0e3400d76']",57,54,111,1445548,2,,,,3712
016dbac94d5fd1ca82e78663416c221388e26db3,0,Mario Emmenlauer,2021-06-04 10:01:54+02:00,['ea456f665466cf4d9a412bba0a2770ee895bd836'],9,25,34,1445582,2,0,0.9,1,3712
f726ae31b9c49b4b3ce9c2f8261760ff9692641a,0,Jens Geyer,2021-06-04 11:46:18+02:00,['ea456f665466cf4d9a412bba0a2770ee895bd836'],48,87,135,1445717,7,,,,3712
29fb3464c948f26474a69cf345d29584f15513a0,0,GitHub,2021-06-04 11:50:38+02:00,"['f726ae31b9c49b4b3ce9c2f8261760ff9692641a', '016dbac94d5fd1ca82e78663416c221388e26db3']",9,25,34,1445751,2,,,,3712
ad76a18db73b038f94e4e6f891abea6ee7b1876b,0,ubuntu,2021-06-07 08:09:05+05:18,['323f0325edb387a447e5b5fedc852bb6971a0286'],24,27,51,1445802,6,,,,3712
93a316c51d491d9ea51506bba1ab90bca5766b6e,0,Jens Geyer,2021-06-07 23:20:03+02:00,['29fb3464c948f26474a69cf345d29584f15513a0'],2,2,4,1445806,2,,,,3712
43faa2d22b1d200921fe339fb20af167944d257f,0,GitHub,2021-06-09 16:38:56+02:00,"['93a316c51d491d9ea51506bba1ab90bca5766b6e', 'ad76a18db73b038f94e4e6f891abea6ee7b1876b']",0,50,50,1445856,5,,,,3712
d604602064e9218cc1f0153a4f83dff22fa1b44e,0,Jens Geyer,2021-06-11 00:38:44+02:00,['c1e33a8436d716c49501417a5c8755ffd56c8719'],3,15,18,1445874,2,1,1,1,3712
63e86ce23a28b990c68fb908971ac95ea30444c6,0,Jens Geyer,2021-06-11 00:55:22+02:00,['d604602064e9218cc1f0153a4f83dff22fa1b44e'],60,78,138,1446012,51,,,,3712
57e24caa86afa8bacf444e66a9aef6203831416c,0,Jens Geyer,2021-06-12 18:52:58+02:00,['63e86ce23a28b990c68fb908971ac95ea30444c6'],32,87,119,1446131,5,0.19047619,0,1,3712
c19d05eeef493a46557fa56bfa3b5193ef3544a4,1,Jens Geyer,2021-06-15 23:48:17+02:00,['43faa2d22b1d200921fe339fb20af167944d257f'],0,11,11,1446142,1,,,,3712
46693f7f5ed16370a6f6fa33c48a64fcafbb0f99,0,Jens Geyer,2021-06-16 09:00:13+02:00,['c19d05eeef493a46557fa56bfa3b5193ef3544a4'],4,6,10,1446152,1,0,0.5,0,3712
3ccef5cecd131077782038cf2be3a6a471c467c5,0,Jens Geyer,2021-06-16 21:29:01+02:00,['46693f7f5ed16370a6f6fa33c48a64fcafbb0f99'],1,3,4,1446156,1,1,1,1,3712
fcfa34108dbf064e71704b4ffa8479e184cef94e,0,Jens Geyer,2021-06-17 22:59:32+02:00,"['3ccef5cecd131077782038cf2be3a6a471c467c5', '57e24caa86afa8bacf444e66a9aef6203831416c']",0,22,22,1446178,2,,,,3712
58fa7b4610dc78cad434fcdc535c79082a53160b,0,Jens Geyer,2021-06-23 20:30:55+02:00,['fcfa34108dbf064e71704b4ffa8479e184cef94e'],12,54,66,1446244,2,0,1,1,3712
ab72ebe564f890f5e37a9a7f892dc590d3d98834,0,Jens Geyer,2021-06-23 20:51:20+02:00,['58fa7b4610dc78cad434fcdc535c79082a53160b'],0,4,4,1446248,1,0,0,1,3712
80e0d53d90881c80cbd4ed0bd4e53ff4d3a0d902,0,Jens Geyer,2021-06-23 21:07:42+02:00,['ab72ebe564f890f5e37a9a7f892dc590d3d98834'],47,53,100,1446348,2,,,,3712
598ee9864beb51af18ee467e34340d4c9d462b6e,0,Jens Geyer,2021-06-25 17:33:12+02:00,['80e0d53d90881c80cbd4ed0bd4e53ff4d3a0d902'],3,4,7,1446355,1,,,,3712
5cada6a3202a0e5e11ff36dfbb925f0e037bf856,0,GitHub,2021-06-30 09:08:34-04:00,['598ee9864beb51af18ee467e34340d4c9d462b6e'],1,3,4,1446359,1,1,1,1,3712
3c3a389c8ac546623d21e2d151c402503b358bc9,0,Jens Geyer,2021-06-30 22:01:20+02:00,['5cada6a3202a0e5e11ff36dfbb925f0e037bf856'],35,44,79,1446438,2,1,1,1,3712
582293bb5ee268fc64ecefe710a5bcf253df1a6e,0,Jens Geyer,2021-06-30 22:05:38+02:00,['3c3a389c8ac546623d21e2d151c402503b358bc9'],0,3,3,1446441,1,,,,3712
7391a3103224a02519d0f976874163bf90531456,0,Jens Geyer,2021-06-30 22:22:37+02:00,['582293bb5ee268fc64ecefe710a5bcf253df1a6e'],0,4,4,1446445,1,0,0,1,3712
3b686533f7cf8c949c389bdaadc2d67f43cac3bd,0,Jens Geyer,2021-07-01 23:32:12+02:00,['7391a3103224a02519d0f976874163bf90531456'],19,25,44,1446489,6,,,,3712
4434ee92d5141578cecac95ee53e3563101b9ecd,0,Jens Geyer,2021-07-02 00:35:47+02:00,['3b686533f7cf8c949c389bdaadc2d67f43cac3bd'],11,8,19,1446508,3,,,,3712
44e8a431a3bb45fd46e2959b308ea96b1ee3c702,0,Jens Geyer,2021-07-06 23:52:19+02:00,['4434ee92d5141578cecac95ee53e3563101b9ecd'],1,1,2,1446510,1,,,,3712
d8c4345ecfcbf506d9e973ae19ee857e6d5378dd,0,Jens Geyer,2021-07-09 21:56:46+02:00,['44e8a431a3bb45fd46e2959b308ea96b1ee3c702'],0,2,2,1446512,1,1,1,1,3712
b98e06df19497bb961a3ed160f4c3b8e0678ff86,0,Jens Geyer,2021-07-09 22:00:46+02:00,['d8c4345ecfcbf506d9e973ae19ee857e6d5378dd'],1,1,2,1446514,1,,,,3712
c06ab4ccc97942f5956112713a0b3800a15cb6cc,0,Jens Geyer,2021-07-09 22:05:44+02:00,['b98e06df19497bb961a3ed160f4c3b8e0678ff86'],3,3,6,1446520,1,,,,3712
8bd82305cf725a62fff5837e3ad4d18c6391b277,0,Jens Geyer,2021-07-09 22:12:42+02:00,['c06ab4ccc97942f5956112713a0b3800a15cb6cc'],2,5,7,1446527,1,0,0,1,3712
fb1d50dfc542424dd2c2b44739178ed8d96cc514,0,Jens Geyer,2021-07-17 14:41:52+02:00,['8bd82305cf725a62fff5837e3ad4d18c6391b277'],1,1,2,1446529,1,,,,3712
47bf0e46e72b3f4d64ed13c8a03a878df17ab046,1,Jens Geyer,2021-07-24 10:18:44+02:00,['fb1d50dfc542424dd2c2b44739178ed8d96cc514'],63,91,154,1446683,2,0,0,0,3712
68c0272a0af55f8a50296f5fa3ba672c08937d98,0,Yuxuan 'fishy' Wang,2021-07-26 10:15:42-07:00,['47bf0e46e72b3f4d64ed13c8a03a878df17ab046'],6,4,10,1446693,1,,,,3712
f6955351222f51e5662ce41de43c75b7c3e640e1,1,Yuxuan 'fishy' Wang,2021-07-30 08:47:45-07:00,['68c0272a0af55f8a50296f5fa3ba672c08937d98'],11,361,372,1447065,5,0.714285714,0.714285714,0.714285714,3715
273607d1f40bbd346ad030eadf8150bd81b9e4b1,1,Jens Geyer,2021-08-01 12:01:27+02:00,['f6955351222f51e5662ce41de43c75b7c3e640e1'],62,112,174,1447239,6,1,0.285714286,0.392857143,3717
c8ae621a0969e00febcc80128d29e38d7f277601,0,Jens Geyer,2021-08-01 13:04:33+02:00,['273607d1f40bbd346ad030eadf8150bd81b9e4b1'],110,122,232,1447471,3,0.8,0.8,0.8,3717
2c78047fcbd2783e88cab0ebc7245598695477ae,0,Yuxuan 'fishy' Wang,2021-08-01 10:07:45-07:00,['c8ae621a0969e00febcc80128d29e38d7f277601'],9,135,144,1447615,7,0,1,1,3720
f7e6c654bde5d9832bede2b48b460c3e1bbbbb92,0,Jens Geyer,2021-08-03 22:21:05+02:00,['2c78047fcbd2783e88cab0ebc7245598695477ae'],67,66,133,1447748,54,,,,3720
9a815fa0a22d39254d41fc2c98e9baffe7f31a4e,0,Jens Geyer,2021-08-03 22:58:12+02:00,['2c78047fcbd2783e88cab0ebc7245598695477ae'],5,153,158,1447906,3,,,,3720
82a9c67405602ff053146a8df6bd566d90a9bf03,0,GitHub,2021-08-10 07:14:05+01:00,['f7e6c654bde5d9832bede2b48b460c3e1bbbbb92'],40,71,111,1448017,11,,,,3720
e14ac85d9e49356a58c6154b7c7bf10231e60ba0,0,Mario Emmenlauer,2021-08-11 19:25:54+02:00,['82a9c67405602ff053146a8df6bd566d90a9bf03'],84,74,158,1448175,14,,,,3720
9e3ac856eef29d0317b8aaec8c3ae810a14a2108,0,Mario Emmenlauer,2021-08-11 19:25:54+02:00,['e14ac85d9e49356a58c6154b7c7bf10231e60ba0'],56,31,87,1448262,20,,,,3720
166786eea8243b3bae90ffc2a5a60bd121fb22e2,0,Mario Emmenlauer,2021-08-11 19:25:54+02:00,['9e3ac856eef29d0317b8aaec8c3ae810a14a2108'],43,40,83,1448345,3,,,,3720
ce64880dd88a2692e85131986263ff7c7708d8d3,0,Mario Emmenlauer,2021-08-11 19:25:54+02:00,['166786eea8243b3bae90ffc2a5a60bd121fb22e2'],128,100,228,1448573,9,,,,3720
22bb550f49cd91dc9eec69fab35a4b7485485009,0,Mario Emmenlauer,2021-08-11 19:27:24+02:00,['ce64880dd88a2692e85131986263ff7c7708d8d3'],16,20,36,1448609,12,,,,3720
c371e4ad3561b4ab38807f0de10aaa93b552e999,0,Mario Emmenlauer,2021-08-11 19:27:56+02:00,['22bb550f49cd91dc9eec69fab35a4b7485485009'],8,8,16,1448625,6,,,,3720
ffc7bb9f591bcd4a3edac5f474cfadd18f204acf,0,Mario Emmenlauer,2021-08-11 19:28:09+02:00,['c371e4ad3561b4ab38807f0de10aaa93b552e999'],768,468,1236,1449861,23,,,,3723
fcb07b18c81b8fb329614eac75fdd1c15fc750e0,0,Mario Emmenlauer,2021-08-11 19:29:38+02:00,['ffc7bb9f591bcd4a3edac5f474cfadd18f204acf'],5,7,12,1449873,1,,,,3723
6dfaf9c6d82773e77ac628b2ea959bea238bf9d6,0,Mario Emmenlauer,2021-08-11 19:30:25+02:00,['fcb07b18c81b8fb329614eac75fdd1c15fc750e0'],2,4,6,1449879,1,,,,3723
fb539ae41297c369439bea6edf39186f92f408dc,0,Yuxuan 'fishy' Wang,2021-08-11 11:08:49-07:00,['82a9c67405602ff053146a8df6bd566d90a9bf03'],31,43,74,1449953,7,0.833333333,0.833333333,0.666666667,3723
efff4a26916d1f0fa77bf43fdf57d5944e86f730,0,Yuxuan 'fishy' Wang,2021-08-11 11:11:54-07:00,['9a815fa0a22d39254d41fc2c98e9baffe7f31a4e'],31,44,75,1450028,7,0.833333333,0.833333333,0.666666667,3723
4cf1e35733decbece55d8b7692767b915031f318,0,GitHub,2021-08-11 21:39:17+02:00,"['fb539ae41297c369439bea6edf39186f92f408dc', '6dfaf9c6d82773e77ac628b2ea959bea238bf9d6']",916,558,1474,1451502,31,,,,3723
e664ac4903aafcf34442296d57edd42a2a7f36cf,0,Mario Emmenlauer,2021-08-12 22:26:43+02:00,['4cf1e35733decbece55d8b7692767b915031f318'],2,7,9,1451511,1,,,,3723
82504b395e2d3e67f506a75ad51aa5734a9ad98a,0,GitHub,2021-08-13 10:01:21+02:00,"['4cf1e35733decbece55d8b7692767b915031f318', 'e664ac4903aafcf34442296d57edd42a2a7f36cf']",2,7,9,1451520,1,,,,3723
431368a368c189bb97cfe69ad3daf4d6640beae6,0,Mario Emmenlauer,2021-08-13 10:14:01+02:00,['82504b395e2d3e67f506a75ad51aa5734a9ad98a'],9,9,18,1451538,1,,,,3723
b31377f0a1813d3b0cb9afd0efc67b61ca021c67,0,Mario Emmenlauer,2021-08-13 10:14:01+02:00,['431368a368c189bb97cfe69ad3daf4d6640beae6'],0,1,1,1451539,1,0,0,1,3723
654968a24b7eeb23962ed7e6aa918da53b96637a,0,Mario Emmenlauer,2021-08-13 10:14:01+02:00,['b31377f0a1813d3b0cb9afd0efc67b61ca021c67'],1,4,5,1451544,1,,,,3723
b01368164ffface56d78107fdca96831bd9246fe,0,Mario Emmenlauer,2021-08-13 10:14:01+02:00,['654968a24b7eeb23962ed7e6aa918da53b96637a'],1,1,2,1451546,1,,,,3723
464339dbb53d94347d6ff8bdb11606b738159fba,0,Mario Emmenlauer,2021-08-13 10:14:01+02:00,['b01368164ffface56d78107fdca96831bd9246fe'],12,2,14,1451560,1,,,,3723
04aabcb808eb877db6563f39062b36e98b6ec6c0,0,Mario Emmenlauer,2021-08-13 10:14:01+02:00,['464339dbb53d94347d6ff8bdb11606b738159fba'],0,1,1,1451561,1,,,,3723
29b083e9f8f5b6fa6d35b300263e866835796f48,0,Mario Emmenlauer,2021-08-13 10:14:22+02:00,['04aabcb808eb877db6563f39062b36e98b6ec6c0'],4,7,11,1451572,4,,,,3723
a484b5c7e45e150b03e6db91281d7a4a0343ac1c,0,Mario Emmenlauer,2021-08-13 10:14:52+02:00,['29b083e9f8f5b6fa6d35b300263e866835796f48'],26,48,74,1451646,4,0.375,0.375,1,3723
a142709baeda76c2a76b21e0ae2b4aa0dff5132a,0,GitHub,2021-08-13 14:48:54+02:00,"['82504b395e2d3e67f506a75ad51aa5734a9ad98a', 'a484b5c7e45e150b03e6db91281d7a4a0343ac1c']",53,73,126,1451772,13,,,,3723
a265236febefca37d3aa74b544112a2f724b3ea8,0,Yuxuan 'fishy' Wang,2021-08-19 14:09:24-07:00,['a142709baeda76c2a76b21e0ae2b4aa0dff5132a'],13,50,63,1451835,11,,,,3724
57b9aa0dd5ef2abd2825c9050783dafc75cc1698,0,Yuxuan 'fishy' Wang,2021-08-19 14:09:57-07:00,['efff4a26916d1f0fa77bf43fdf57d5944e86f730'],13,50,63,1451898,11,,,,3725
72f04b4e2ca46306ff88b33eda25a7e14df5e895,0,Jens Geyer,2021-08-22 18:38:49+02:00,['a265236febefca37d3aa74b544112a2f724b3ea8'],1,1,2,1451900,1,,,,3725
db7ad5b1a127ab99b45ef076d07ac6c28d0cb84c,0,Jens Geyer,2021-08-22 18:43:11+02:00,['72f04b4e2ca46306ff88b33eda25a7e14df5e895'],17,68,85,1451985,9,,,,3725
77afa017ce625449435f43481e2839957a409beb,0,Jens Geyer,2021-08-22 18:46:08+02:00,['db7ad5b1a127ab99b45ef076d07ac6c28d0cb84c'],2,8,10,1451995,2,,,,3725
ace8613f0f21601296744eedc1ce80dd1ca0fdae,0,Jens Geyer,2021-08-22 19:00:10+02:00,['77afa017ce625449435f43481e2839957a409beb'],14,16,30,1452025,2,,,,3725
db997bde47674ed61acb93dea1522b4f16f8e489,0,Mario Emmenlauer,2021-08-25 11:55:05+02:00,['ace8613f0f21601296744eedc1ce80dd1ca0fdae'],36,43,79,1452104,7,,,,3725
70ef9846558a815b5f8d0f5e9d5c2e825c81e630,0,Mario Emmenlauer,2021-08-25 11:56:06+02:00,['db997bde47674ed61acb93dea1522b4f16f8e489'],0,1,1,1452105,1,,,,3725
d53f056427a093f782c234d6dff85881cff0f5fb,0,GitHub,2021-08-25 19:13:51+02:00,"['ace8613f0f21601296744eedc1ce80dd1ca0fdae', '70ef9846558a815b5f8d0f5e9d5c2e825c81e630']",36,44,80,1452185,7,,,,3725
17373a3f357cc81ab03fd02c316ad66b9c5ea260,0,Yuxuan 'fishy' Wang,2021-08-27 09:28:08-07:00,['d53f056427a093f782c234d6dff85881cff0f5fb'],293,197,490,1452675,33,0,0,0,3726
5f829f143c40a125c611d03244b235a6d1a35d47,0,Yuxuan 'fishy' Wang,2021-08-27 09:28:37-07:00,['57b9aa0dd5ef2abd2825c9050783dafc75cc1698'],293,197,490,1453165,33,0,0,0,3727
96ed727098396af1813ffbd0c869fa529e9103b7,0,Mario Emmenlauer,2021-08-30 11:25:55+02:00,['17373a3f357cc81ab03fd02c316ad66b9c5ea260'],8,23,31,1453196,5,,,,3727
6762a907c164f09d3d3ed40283f11e745f3b68af,0,GitHub,2021-08-30 11:40:33+02:00,"['17373a3f357cc81ab03fd02c316ad66b9c5ea260', '96ed727098396af1813ffbd0c869fa529e9103b7']",8,23,31,1453227,5,,,,3727
ee6521514305365b0f95d26dd6e3f46efe338021,0,Mario Emmenlauer,2021-08-30 11:41:54+02:00,['6762a907c164f09d3d3ed40283f11e745f3b68af'],1,1,2,1453229,1,,,,3727
5a64c7101762535ecce0d43dce717b396748ddac,0,Mario Emmenlauer,2021-08-30 11:41:54+02:00,['ee6521514305365b0f95d26dd6e3f46efe338021'],5,20,25,1453254,3,,,,3727
5b25b99cda8d24a1720e543d79dac9cfa2525449,0,GitHub,2021-08-31 14:52:40+02:00,"['6762a907c164f09d3d3ed40283f11e745f3b68af', '5a64c7101762535ecce0d43dce717b396748ddac']",6,21,27,1453281,4,,,,3727
18bf59153521a813296142929308fbb0c3f4db65,0,Mario Emmenlauer,2021-08-31 14:53:14+02:00,['5b25b99cda8d24a1720e543d79dac9cfa2525449'],65,69,134,1453415,5,0,0.428571429,1,3727
0f5aebb52c05d6f323b06e8a0f46c7c4ef5e3fc2,0,GitHub,2021-09-01 11:04:55+02:00,"['5b25b99cda8d24a1720e543d79dac9cfa2525449', '18bf59153521a813296142929308fbb0c3f4db65']",65,69,134,1453549,5,,,,3727
dd0bf89ca39e3b342183342df31f9e89525ef6af,0,Mario Emmenlauer,2021-09-01 15:30:35+02:00,['0f5aebb52c05d6f323b06e8a0f46c7c4ef5e3fc2'],50,104,154,1453703,3,0,0,1,3727
b8069cbe9c83a2ac094a91c5bc59a545caabb652,0,GitHub,2021-09-02 08:51:06+02:00,"['0f5aebb52c05d6f323b06e8a0f46c7c4ef5e3fc2', 'dd0bf89ca39e3b342183342df31f9e89525ef6af']",50,104,154,1453857,3,,,,3727
034c9359e978d2465f0ce8530f62c146ef18e935,0,Mario Emmenlauer,2021-09-02 08:53:36+02:00,['b8069cbe9c83a2ac094a91c5bc59a545caabb652'],4,7,11,1453868,4,,,,3727
bdb54bc1c985f6fc72712017c4776590c68ec940,0,Mario Emmenlauer,2021-09-02 08:54:42+02:00,['b8069cbe9c83a2ac094a91c5bc59a545caabb652'],112,111,223,1454091,10,,,,3727
e66814e6bce22ee698d6fddd6c0c90bf620f9e0b,0,GitHub,2021-09-02 14:07:53+02:00,"['b8069cbe9c83a2ac094a91c5bc59a545caabb652', '034c9359e978d2465f0ce8530f62c146ef18e935']",4,7,11,1454102,4,,,,3727
f83ebeae9d0a7b6c0f1005b430184ba02d9b8d50,0,GitHub,2021-09-02 14:10:01+02:00,"['e66814e6bce22ee698d6fddd6c0c90bf620f9e0b', 'bdb54bc1c985f6fc72712017c4776590c68ec940']",112,111,223,1454325,10,,,,3727
cdbcff99958c024d224de98a0dfc2e98d6d779b6,0,Yuxuan 'fishy' Wang,2021-09-03 22:24:25-07:00,['f83ebeae9d0a7b6c0f1005b430184ba02d9b8d50'],1,18,19,1454344,2,0,0,1,3727
67bf304de18e025a768e21f1c39dd8aede882637,0,Yuxuan 'fishy' Wang,2021-09-03 22:25:33-07:00,['5f829f143c40a125c611d03244b235a6d1a35d47'],1,18,19,1454363,2,0,0,1,3727
8317ec43ea2425b6f8e24e4dc4f5b2360f717eb4,0,Jens Geyer,2021-09-04 20:45:55+02:00,['67bf304de18e025a768e21f1c39dd8aede882637'],91,91,182,1454545,1,,,,3727
0cc06506b807a2d7fa5183a207e1ce3f9727cf00,0,GitHub,2021-09-08 22:43:00-04:00,['cdbcff99958c024d224de98a0dfc2e98d6d779b6'],2,2,4,1454549,1,,,,3727
38bd636a1883dbbf4d22ada48e856eaf6243d32e,0,Yuxuan 'fishy' Wang,2021-09-09 22:19:17-07:00,['0cc06506b807a2d7fa5183a207e1ce3f9727cf00'],2,7,9,1454558,2,,,,3727
7e07267379cab41ea35acc508c0d417bca479167,0,GitHub,2021-09-11 11:30:34-04:00,['38bd636a1883dbbf4d22ada48e856eaf6243d32e'],0,3,3,1454561,3,,,,3727
e3be32112aa8029577b88a9ee431ef67f8a357db,0,Jens Geyer,2021-09-11 23:00:25+02:00,"['7e07267379cab41ea35acc508c0d417bca479167', '8317ec43ea2425b6f8e24e4dc4f5b2360f717eb4']",41,192,233,1454794,3,,,,3727
ab2f23a2a9cd8d170e6d45ae6ad0e693052e3599,0,Yuxuan 'fishy' Wang,2021-09-20 13:43:30-07:00,['e3be32112aa8029577b88a9ee431ef67f8a357db'],4,6,10,1454804,2,,,,3727
7ecc9ef02110b66e6a734ff5c11e103c4b9fbc1e,0,Jim King,2021-09-25 22:09:31-04:00,['ab2f23a2a9cd8d170e6d45ae6ad0e693052e3599'],1,17,18,1454822,2,0.6,1,1,3727
cb808fcb79d03028c6138891381689e1ef4e4a94,0,Jim King,2021-09-26 07:46:16-04:00,['7ecc9ef02110b66e6a734ff5c11e103c4b9fbc1e'],1,1,2,1454824,1,,,,3727
91be87a76f747b9069bb07357483b2d8a19addcf,0,Jens Geyer,2021-10-14 23:16:57+02:00,['cb808fcb79d03028c6138891381689e1ef4e4a94'],11,18,29,1454853,9,,,,3727
e394cb4c9f57e97ddeb2803cede07fc0070c6d9d,0,Jens Geyer,2021-10-14 23:23:59+02:00,['91be87a76f747b9069bb07357483b2d8a19addcf'],3,23,26,1454879,1,0.5,0,0.5,3727
e5c636defe2fdf0a59824542ca1cc1e5f7fe1f81,0,Jens Geyer,2021-10-14 23:28:09+02:00,['e394cb4c9f57e97ddeb2803cede07fc0070c6d9d'],1,1,2,1454881,1,,,,3727
353e810199ab1d5cbad74fb44ce033b935e14d60,0,Jens Geyer,2021-10-15 03:22:24+02:00,['e5c636defe2fdf0a59824542ca1cc1e5f7fe1f81'],1,1,2,1454883,1,,,,3727
2b691ee3bf6d70112e1e06f29e8e8a06e3105f33,0,Jens Geyer,2021-10-15 20:33:25+02:00,['353e810199ab1d5cbad74fb44ce033b935e14d60'],4,1,5,1454888,1,1,0,0,3727
152dab945cbf5377595e07e87b336a9871aa5949,0,Jens Geyer,2021-10-18 22:03:49+02:00,['2b691ee3bf6d70112e1e06f29e8e8a06e3105f33'],0,12,12,1454900,1,1,1,0,3727
2145741a9db80b2127e88ee5c792fe74d73b19dd,0,Jens Geyer,2021-10-18 22:04:29+02:00,['152dab945cbf5377595e07e87b336a9871aa5949'],1,1,2,1454902,1,,,,3727
50dd262f282dfaf3847b61b433dcbfea6d20ac4f,0,Jens Geyer,2021-10-18 22:08:49+02:00,['2145741a9db80b2127e88ee5c792fe74d73b19dd'],2,2,4,1454906,1,,,,3727
6a7278b9db78777f146b09fdfe42eb342faec171,0,Jens Geyer,2021-10-18 22:10:16+02:00,['50dd262f282dfaf3847b61b433dcbfea6d20ac4f'],1,1,2,1454908,1,,,,3727
0f760537c3f17502e7694c61417dafc02fc3aa3a,0,Jens Geyer,2021-10-18 23:00:55+02:00,['6a7278b9db78777f146b09fdfe42eb342faec171'],1,5,6,1454914,1,0,0,0,3727
839a1daf5a2d99307e4a3175a32fb2b7bf9c6175,0,Jens Geyer,2021-10-21 22:57:04+02:00,['0f760537c3f17502e7694c61417dafc02fc3aa3a'],0,22,22,1454936,2,0,0,1,3727
2b8be5154fc4f017fe98ca2e19d6526b265ca121,0,Jens Geyer,2021-10-23 13:41:38+02:00,['839a1daf5a2d99307e4a3175a32fb2b7bf9c6175'],2914,960,3874,1458810,6,,,,3727
007b99b72adcc97a0715b92d5f495620bee35715,0,Jens Geyer,2021-10-27 16:43:12+02:00,['2b8be5154fc4f017fe98ca2e19d6526b265ca121'],10,18,28,1458838,2,1,1,1,3727
3f1fd599251027931ccde7aff893f6d64e8a840f,0,Jens Geyer,2021-10-28 23:02:12+02:00,['007b99b72adcc97a0715b92d5f495620bee35715'],7,14,21,1458859,4,,,,3728
591575a8a891717b002abecef57f99830a8c6752,0,Jens Geyer,2021-10-31 12:03:12+01:00,['3f1fd599251027931ccde7aff893f6d64e8a840f'],7,15,22,1458881,4,0,1,0,3728
ea39a14a1fbc8a7683e91ab4bdd23f8b207c8d5d,0,Jens Geyer,2021-11-14 00:20:19+01:00,['591575a8a891717b002abecef57f99830a8c6752'],0,1,1,1458882,1,1,1,1,3728
da1e19b72bceb1c5a094613c286c1331ff1a6c1b,0,Jens Geyer,2021-11-14 00:54:12+01:00,['ea39a14a1fbc8a7683e91ab4bdd23f8b207c8d5d'],0,5,5,1458887,1,1,1,1,3728
7156940c1da6f7e0c4e8b830cea1e37f770db173,0,Jens Geyer,2021-11-14 12:35:30+01:00,['da1e19b72bceb1c5a094613c286c1331ff1a6c1b'],105,30,135,1459022,5,0.987012987,0.935064935,0,3728
ea1e8ff1407112342ed17cb95087bbda4e9b2cc0,0,Jens Geyer,2021-11-14 12:35:30+01:00,['7156940c1da6f7e0c4e8b830cea1e37f770db173'],80,81,161,1459183,2,1,0,0.5,3728
50f97135ccc328aeb84b75d5374016abaa269da1,0,Jens Geyer,2021-11-14 12:35:52+01:00,['ea1e8ff1407112342ed17cb95087bbda4e9b2cc0'],0,1,1,1459184,1,,,,3728
443a03c558fdef6e6908e8fb47f7011c2d7ff9f6,0,Jens Geyer,2021-11-15 19:31:21+01:00,['50f97135ccc328aeb84b75d5374016abaa269da1'],1,1,2,1459186,1,,,,3728
2c0927826d1e7f7e902f29a925e22058f949f535,0,Jens Geyer,2021-11-15 19:32:18+01:00,['443a03c558fdef6e6908e8fb47f7011c2d7ff9f6'],0,2,2,1459188,1,,,,3728
5a9d139be4ef1a790da4c6f25377b8ab6573a325,1,Jens Geyer,2021-11-20 00:57:57+01:00,['2c0927826d1e7f7e902f29a925e22058f949f535'],10,5171,5181,1464369,29,0.511668408,0.844653431,0.589690003,3750
4637f6d5f8df752291f5e3c8923824e819a2b60f,0,Jens Geyer,2021-11-23 21:54:05+01:00,['5a9d139be4ef1a790da4c6f25377b8ab6573a325'],15,15,30,1464399,1,,,,3750
4c7b9fd38ad614dbf37c37e45569790b44868458,0,Jens Geyer,2021-12-05 13:05:58+01:00,['4637f6d5f8df752291f5e3c8923824e819a2b60f'],155,167,322,1464721,22,1,0,0.166666667,3750
2853af2d02dc1c4e42175e76d5ccefe9e797c4c4,0,Jens Geyer,2021-12-06 23:00:37+01:00,['4c7b9fd38ad614dbf37c37e45569790b44868458'],2,2,4,1464725,1,,,,3750
98be76fc033f1d66bcfd09d4a22b86e8061e89c2,0,Jens Geyer,2021-12-06 23:01:25+01:00,['2853af2d02dc1c4e42175e76d5ccefe9e797c4c4'],0,16,16,1464741,1,0.5,0.5,1,3750
b597043146bdcd2b18c73314aafbf4b46937dbd5,0,Jens Geyer,2021-12-13 08:55:45+01:00,['98be76fc033f1d66bcfd09d4a22b86e8061e89c2'],3,3,6,1464747,3,,,,3750
c6c5a0596ffc441e6cd1ad60130cdcdcb2e319e4,0,Jens Geyer,2021-12-13 08:56:54+01:00,['b597043146bdcd2b18c73314aafbf4b46937dbd5'],27,4,31,1464778,3,0,0,0,3750
b724787d373de99fee2222ab0eb2e052f8c8d3ed,0,Yuxuan 'fishy' Wang,2021-12-16 13:12:44-08:00,['c6c5a0596ffc441e6cd1ad60130cdcdcb2e319e4'],1,93,94,1464872,5,1,1,0.625,3751
d582a861426c43c869e71d8d6ce598a33cbab316,0,Yuxuan 'fishy' Wang,2021-12-17 10:24:19-08:00,['b724787d373de99fee2222ab0eb2e052f8c8d3ed'],20,133,153,1465025,3,0.75,0.75,1,3752
999e6e3bce217acb35b44440fd656cf169d47ed8,0,Yuxuan 'fishy' Wang,2022-01-05 14:21:58-08:00,['d582a861426c43c869e71d8d6ce598a33cbab316'],23,150,173,1465198,3,0.012345679,0.407407407,1,3752
e12fbe88e2f734cbcb010f0f820a6e43e94c8ec2,0,Yuxuan 'fishy' Wang,2022-01-06 22:06:41-08:00,['999e6e3bce217acb35b44440fd656cf169d47ed8'],19,8,27,1465225,2,,,,3752
9d7d627b518f84d6f7bfee76f1d7410e63c4fe7c,0,Yuxuan 'fishy' Wang,2022-01-08 00:17:27-08:00,['e12fbe88e2f734cbcb010f0f820a6e43e94c8ec2'],4,0,4,1465229,1,0,0,1,3752
39d7278ddffce27d45380c483a84d013f6db4d7b,0,Yuxuan 'fishy' Wang,2022-01-08 23:10:21-08:00,['9d7d627b518f84d6f7bfee76f1d7410e63c4fe7c'],19,14,33,1465262,3,0,0,0,3752
98a232577fa56bb703ea96b88cc6c5b9391178f0,0,Jens Geyer,2022-01-09 21:57:30+01:00,['39d7278ddffce27d45380c483a84d013f6db4d7b'],79,110,189,1465451,16,0.666666667,1,1,3752
bbc7c5f65eaaf027c4d141300235870e5c3c5824,0,Yuxuan 'fishy' Wang,2022-01-11 13:44:23-08:00,['98a232577fa56bb703ea96b88cc6c5b9391178f0'],11,11,22,1465473,4,,,,3752
e07cdcce8d0c4238b21f61a809849e082e0c616b,0,Mario Emmenlauer,2022-01-17 19:14:56+01:00,['bbc7c5f65eaaf027c4d141300235870e5c3c5824'],1,0,1,1465474,1,,,,3752
16b490ce1fd1e102ef27363c78cccedb16d4fbe2,0,GitHub,2022-01-17 14:02:34-08:00,"['bbc7c5f65eaaf027c4d141300235870e5c3c5824', 'e07cdcce8d0c4238b21f61a809849e082e0c616b']",1,0,1,1465475,1,,,,3752
b3cf1980582d026def0fc262de8a788d5b34ca85,0,Dirk Sandbrink,2022-01-17 23:23:50+01:00,['16b490ce1fd1e102ef27363c78cccedb16d4fbe2'],6,0,6,1465481,3,,,,3752
d3f13f0907dda34dff1ecc7dd7bc4fec2b26f168,0,Dirk Sandbrink,2022-01-17 23:25:42+01:00,['16b490ce1fd1e102ef27363c78cccedb16d4fbe2'],0,2,2,1465483,1,0,1,1,3752
11dc245c402fbacf263833618724b013ee203f5b,0,GitHub,2022-01-18 00:08:37-08:00,"['16b490ce1fd1e102ef27363c78cccedb16d4fbe2', 'd3f13f0907dda34dff1ecc7dd7bc4fec2b26f168']",0,2,2,1465485,1,,,,3752
b1dc2aeb48f08052971eeb643026c7999766cc73,0,GitHub,2022-01-18 00:09:30-08:00,"['11dc245c402fbacf263833618724b013ee203f5b', 'b3cf1980582d026def0fc262de8a788d5b34ca85']",6,0,6,1465491,3,,,,3752
7a6829531f00f7e95f904d5794d632acee62ddf0,0,Jens Geyer,2022-01-20 20:48:15+01:00,['b1dc2aeb48f08052971eeb643026c7999766cc73'],1,1,2,1465493,1,,,,3752
6868ebbb31cf32dbde018b03831d167565ba51d8,0,Jens Geyer,2022-01-20 21:02:02+01:00,['7a6829531f00f7e95f904d5794d632acee62ddf0'],65,76,141,1465634,55,,,,3752
86763a1681638eb5adaf33d1dd7d7143824bae2c,0,Jens Geyer,2022-01-20 22:13:40+01:00,['6868ebbb31cf32dbde018b03831d167565ba51d8'],1,1,2,1465636,1,,,,3752
fa5c37ab5f4e8196cb353cd4f884dcf362809cc0,0,Jens Geyer,2022-01-20 22:15:36+01:00,['7a6829531f00f7e95f904d5794d632acee62ddf0'],1,1,2,1465638,1,,,,3752
febc5121ea425d92623512367d7e365c13be31c4,0,Jens Geyer,2022-01-21 09:38:55+01:00,['86763a1681638eb5adaf33d1dd7d7143824bae2c'],47,123,170,1465808,1,,,,3752
fb87b440cdba9ba53b0db88296c86a92a3ae2503,0,Jens Geyer,2022-01-21 09:39:09+01:00,['fa5c37ab5f4e8196cb353cd4f884dcf362809cc0'],47,123,170,1465978,1,,,,3752
5f16344311a57ac016190984dd1aaa44e19a6487,0,Jens Geyer,2022-01-26 22:56:08+01:00,['febc5121ea425d92623512367d7e365c13be31c4'],1,1,2,1465980,1,,,,3752
bf0967537bdf189a8806fe05a2710e1011370956,0,Jens Geyer,2022-01-26 23:00:04+01:00,['5f16344311a57ac016190984dd1aaa44e19a6487'],1,1,2,1465982,1,,,,3752
561bc9ab7918bfddcfd0ecc722b162e43a9bc46b,0,Jens Geyer,2022-01-27 08:51:15+01:00,['bf0967537bdf189a8806fe05a2710e1011370956'],40,62,102,1466084,17,1,0,0.75,3753
1ef362cc62a761811294f390e0ead2785e12c9b0,0,Jens Geyer,2022-01-27 08:55:19+01:00,['fb87b440cdba9ba53b0db88296c86a92a3ae2503'],40,62,102,1466186,17,1,0,0.75,3754
d68f03c0edc539bc1757b2ac358dbd43c44bc651,0,Jens Geyer,2022-01-27 08:55:23+01:00,['1ef362cc62a761811294f390e0ead2785e12c9b0'],10,12,22,1466208,1,,,,3754
c4f2ba11738e3f48b36a32359965dc08cc5c5d7d,0,Yuxuan 'fishy' Wang,2022-01-27 07:38:24-08:00,['561bc9ab7918bfddcfd0ecc722b162e43a9bc46b'],0,1,1,1466209,1,,,,3754
eadbd9cd3634260cd7f54e74ea7af37826e3135b,0,Jens Geyer,2022-01-29 18:50:01+01:00,['c4f2ba11738e3f48b36a32359965dc08cc5c5d7d'],1,1,2,1466211,1,,,,3754
a0cd3cfc848536210631f5f10c9019f81e45ab66,0,Jens Geyer,2022-01-30 01:09:06+01:00,['eadbd9cd3634260cd7f54e74ea7af37826e3135b'],9,9,18,1466229,1,,,,3754
69b66a51f2d86746b78300fdf43dd098d6eac7cb,0,Jens Geyer,2022-01-30 01:09:06+01:00,['a0cd3cfc848536210631f5f10c9019f81e45ab66'],0,1,1,1466230,1,1,1,1,3754
9a16c755b1734185772bd4eb1280005348911c91,0,Jens Geyer,2022-02-01 08:55:05+01:00,['69b66a51f2d86746b78300fdf43dd098d6eac7cb'],1,1,2,1466232,1,,,,3754
f99375ef87a0540e7af6cf167522ba0cbb1a0b21,0,Jens Geyer,2022-02-01 08:58:42+01:00,['d68f03c0edc539bc1757b2ac358dbd43c44bc651'],1,1,2,1466234,1,,,,3754
af453f33c455d5330a3da24efb28bb1bda179d33,0,Jens Geyer,2022-02-01 23:51:00+01:00,['9a16c755b1734185772bd4eb1280005348911c91'],16,7,23,1466257,1,1,0.857142857,0.571428571,3754
a10d401996690d3e5387341c1248b7d1028d9ac7,0,Jens Geyer,2022-02-02 22:58:16+01:00,['f99375ef87a0540e7af6cf167522ba0cbb1a0b21'],0,18,18,1466275,10,,,,3754
48d1a707d1690bf79f1eb280d88580652d81a3cc,0,Jens Geyer,2022-02-02 23:03:58+01:00,['a10d401996690d3e5387341c1248b7d1028d9ac7'],1,1,2,1466277,1,,,,3754
f087ec48a2d043a93db36dfa44b69785b5dff1e2,0,Jens Geyer,2022-02-02 23:14:52+01:00,['48d1a707d1690bf79f1eb280d88580652d81a3cc'],1,3,4,1466281,2,,,,3754
b9fe9c2417f26fa6e1d9383b8fa9d50ff9a96d65,0,Jens Geyer,2022-02-03 22:27:15+01:00,['f087ec48a2d043a93db36dfa44b69785b5dff1e2'],1,5,6,1466287,1,0,1,1,3754
6f33b047067966d73397b95e6a54fc39901169eb,0,Yuxuan 'fishy' Wang,2022-02-03 16:11:20-08:00,['af453f33c455d5330a3da24efb28bb1bda179d33'],1,12,13,1466300,1,1,1,1,3754
56a840aa176494c5875cba7faff9dfc16bf8f831,0,Yuxuan 'fishy' Wang,2022-02-03 16:12:06-08:00,['b9fe9c2417f26fa6e1d9383b8fa9d50ff9a96d65'],1,12,13,1466313,1,1,1,1,3754
cbb6530228895bab3b0556df59574c46d9ea49d9,0,GitHub,2022-02-04 09:55:19+01:00,['6f33b047067966d73397b95e6a54fc39901169eb'],0,12,12,1466325,1,,,,3754
6b5b6c479b047ea9953d74e14e9430b235f4c735,0,GitHub,2022-02-04 14:03:51+01:00,"['6f33b047067966d73397b95e6a54fc39901169eb', 'cbb6530228895bab3b0556df59574c46d9ea49d9']",0,12,12,1466337,1,,,,3754
f18a8f34e21b09a389e93114ae75375b53724b39,0,Jens Geyer,2022-02-04 22:38:03+01:00,['56a840aa176494c5875cba7faff9dfc16bf8f831'],0,1,1,1466338,1,,,,3754
2d667f34767b32d242687b5e31f65284f82ce16d,0,Jens Geyer,2022-02-05 03:04:41+01:00,['6b5b6c479b047ea9953d74e14e9430b235f4c735'],1,5,6,1466344,1,0,1,1,3754
3cac3204519bbdfe02beb9d863e9b873cdaf9d07,1,Jens Geyer,2022-02-08 17:45:10+01:00,['2d667f34767b32d242687b5e31f65284f82ce16d'],403,713,1116,1467460,16,0.088,0.16,0.844,3754
50819ce8ef72ad7ccf79c6c3fb3b77a91ab8e540,0,Jens Geyer,2022-02-08 20:33:32+01:00,['3cac3204519bbdfe02beb9d863e9b873cdaf9d07'],7,7,14,1467474,7,,,,3754
acd19a8439911f5a3a742bad72ea4d231d1aeec3,0,Yuxuan 'fishy' Wang,2022-02-08 16:40:12-08:00,['50819ce8ef72ad7ccf79c6c3fb3b77a91ab8e540'],2,6,8,1467482,1,,0,,3754
303139410616ab3e580aa6aead1001118adee243,0,Yuxuan 'fishy' Wang,2022-02-08 16:40:47-08:00,['f18a8f34e21b09a389e93114ae75375b53724b39'],2,6,8,1467490,1,,0,,3754
0b29261a4f3c6882ef3b09aae47914f0012b0472,0,Yuxuan 'fishy' Wang,2022-02-09 08:56:04-08:00,['acd19a8439911f5a3a742bad72ea4d231d1aeec3'],5,5,10,1467500,1,,,,3754
a8e3b758af65feefcc55b5d46024a102a3ff494b,0,Yuxuan 'fishy' Wang,2022-02-09 08:57:06-08:00,['303139410616ab3e580aa6aead1001118adee243'],5,5,10,1467510,1,,,,3754
2a93df80f27739ccabb5b885cb12a8dc7595ecdf,0,Jens Geyer,2022-02-09 20:46:41+01:00,['a8e3b758af65feefcc55b5d46024a102a3ff494b'],0,1,1,1467511,1,,,,3754
52d263e77c48bbf7cbabd03161107557d1e410b1,0,Jens Geyer,2022-02-10 23:11:23+01:00,['0b29261a4f3c6882ef3b09aae47914f0012b0472'],10,4,14,1467525,1,0,0,1,3754
d2c28b349d94e99327a402ce52bcb66f8ab9c769,0,Jens Geyer,2022-02-12 01:15:16+01:00,['52d263e77c48bbf7cbabd03161107557d1e410b1'],5,18,23,1467548,1,0,1,1,3754
d8ed39803abea8603e9935f525e748b1c515fe7f,0,Jens Geyer,2022-02-15 22:26:08+01:00,"['d2c28b349d94e99327a402ce52bcb66f8ab9c769', '2a93df80f27739ccabb5b885cb12a8dc7595ecdf']",10,34,44,1467592,12,,,,3754
f0563a5c4929d169090ca8180e06895339c136bb,0,Jens Geyer,2022-02-16 08:50:47+01:00,['d8ed39803abea8603e9935f525e748b1c515fe7f'],16,1,17,1467609,1,,,,3754
6266dc0777e54b169e5c2a41541d586078633195,0,Jens Geyer,2022-02-16 08:52:43+01:00,['f0563a5c4929d169090ca8180e06895339c136bb'],1,1,2,1467611,1,,,,3754
2fa907e84b5bf29c263c4cde657e99c2e894562f,0,Yuxuan 'fishy' Wang,2022-02-16 14:14:40-10:00,['6266dc0777e54b169e5c2a41541d586078633195'],7,210,217,1467828,4,0.107142857,1,0.964285714,3754
ff746966584816988a3babf25debc8a87c50581d,0,Jens Geyer,2022-02-17 21:53:40+01:00,['2fa907e84b5bf29c263c4cde657e99c2e894562f'],2,2,4,1467832,1,,,,3754
103a11c9c28ac963a3b2591ecac641db3cbaa113,0,Jens Geyer,2022-02-21 19:19:42+01:00,['ff746966584816988a3babf25debc8a87c50581d'],4,7,11,1467843,1,0,0,0,3754
9bee877e663f11f4cbdd3a4f02938c8ab9fe8976,0,Yuxuan 'fishy' Wang,2022-02-23 09:17:50-08:00,['103a11c9c28ac963a3b2591ecac641db3cbaa113'],43,249,292,1468135,4,0.298245614,0.578947368,1,3756
8fea4ea0c1469bef5c06efd9a125b94f3bf66922,0,Jens Geyer,2022-02-23 18:23:46+01:00,['9bee877e663f11f4cbdd3a4f02938c8ab9fe8976'],1,1,2,1468137,1,,,,3756
fa44e9048ac45de25f8a726694a13ac25d2c73fe,0,Jens Geyer,2022-02-26 12:58:32+01:00,['8fea4ea0c1469bef5c06efd9a125b94f3bf66922'],3,3,6,1468143,1,,,,3756
79f89e0cec046ae7e6ed4a31ccfadd907be8baed,0,Jens Geyer,2022-02-26 13:19:09+01:00,['fa44e9048ac45de25f8a726694a13ac25d2c73fe'],4,0,4,1468147,1,,,,3756
8ab86c3303a8157ecfed6ff588d71e6e13dd7017,0,Jens Geyer,2022-03-01 23:20:50+01:00,['79f89e0cec046ae7e6ed4a31ccfadd907be8baed'],1,2,3,1468150,1,,,,3756
c9b7bd7b1285e8feb902daa208eacd7655a380ee,0,Jens Geyer,2022-03-02 22:14:55+01:00,['8ab86c3303a8157ecfed6ff588d71e6e13dd7017'],0,769,769,1468919,8,0.722814499,0.773987207,0.68869936,3761
4bd1fd80791380de443bb217d7456b7ade56cf8a,0,Jens Geyer,2022-03-02 22:20:50+01:00,['c9b7bd7b1285e8feb902daa208eacd7655a380ee'],3,5,8,1468927,2,,,,3761
5a44db88b200892ff899a74b53d8a482ababb265,0,Jens Geyer,2022-03-02 22:23:19+01:00,['4bd1fd80791380de443bb217d7456b7ade56cf8a'],3,5,8,1468935,2,,,,3761
7ce2216e3601252c46ae4a617e0630c06dc5b083,0,Jens Geyer,2022-03-05 09:58:27+01:00,['5a44db88b200892ff899a74b53d8a482ababb265'],11,47,58,1468993,1,0,0,0.676470588,3761
a0ccc7e5fae124d6fb43f77bf1f0e7bb12c176f9,0,Jens Geyer,2022-03-05 09:58:27+01:00,['7ce2216e3601252c46ae4a617e0630c06dc5b083'],1,1,2,1468995,1,,,,3761
b89f07977a2f2007fdac493ce1e3e342ce9c4f3f,0,Jens Geyer,2022-03-05 09:58:27+01:00,['a0ccc7e5fae124d6fb43f77bf1f0e7bb12c176f9'],1,2,3,1468998,1,,,,3761
411df3aacb4e472f1ddeeada501cadadf4f5c9c2,0,Jens Geyer,2022-03-05 09:58:27+01:00,['b89f07977a2f2007fdac493ce1e3e342ce9c4f3f'],3,3,6,1469004,1,,,,3761
c4e5dbac2ad1c0020a58dae4968d0ac7dcc188f1,0,Jens Geyer,2022-03-05 09:58:27+01:00,['411df3aacb4e472f1ddeeada501cadadf4f5c9c2'],1,2,3,1469007,1,0,0,0,3761
8d6694d60787e2c5e16378e3738a4b31382b6834,0,Jens Geyer,2022-03-05 09:58:27+01:00,['c4e5dbac2ad1c0020a58dae4968d0ac7dcc188f1'],3,3,6,1469013,1,0,1,1,3761
d0e49f01ca40154348d2deaf229541e2f9ee2988,0,Jens Geyer,2022-03-05 09:58:27+01:00,['8d6694d60787e2c5e16378e3738a4b31382b6834'],2,18,20,1469033,3,0.9,1,1,3761
b8920b01cb72af93a716bb203fcd8a1202936b97,0,Jens Geyer,2022-03-05 09:58:27+01:00,['d0e49f01ca40154348d2deaf229541e2f9ee2988'],1,9,10,1469043,1,,,,3761
66ac7b46fab85f175aec601cb48ea05408a1c186,0,Jens Geyer,2022-03-06 12:30:30+01:00,['b8920b01cb72af93a716bb203fcd8a1202936b97'],5,36,41,1469084,4,0.866666667,0.933333333,0.6,3761
d88d4f93b3390989bd47a43f3941ca7d576750f6,0,Jens Geyer,2022-03-06 14:58:37+01:00,['66ac7b46fab85f175aec601cb48ea05408a1c186'],1913,1,1914,1470998,33,0.705882353,0.524064171,0.184491979,3761
7594da8d7ac8d3525aa736d8fef89e465c63533e,0,Aki Sukegawa,2022-03-08 16:06:00-05:00,['d88d4f93b3390989bd47a43f3941ca7d576750f6'],29,43,72,1471070,7,,,,3761
aa27cdadd00481d1c08dc4fb73e3aaf14d95c07b,0,Jens Geyer,2022-03-09 11:39:48+01:00,['7594da8d7ac8d3525aa736d8fef89e465c63533e'],0,15,15,1471085,1,1,1,1,3761
20e2ceb8233217a61a77e37cccaf2cc119fb0c48,0,Jens Geyer,2022-03-10 23:14:22+01:00,['aa27cdadd00481d1c08dc4fb73e3aaf14d95c07b'],1,1,2,1471087,1,,,,3761
649dcfd4a06dbe529870015e7f838d5f46426648,0,Jens Geyer,2022-03-10 23:15:19+01:00,['20e2ceb8233217a61a77e37cccaf2cc119fb0c48'],12,8,20,1471107,3,,,,3761
8ef4ed1b2a0b28f27d35516cfb56a16c2583de0c,0,Jens Geyer,2022-03-12 00:02:38+01:00,['649dcfd4a06dbe529870015e7f838d5f46426648'],1,3,4,1471111,1,0,0,1,3761
bbea728aaa9f72bb3b58a1c5448b4e917eaf5796,0,Jens Geyer,2022-03-13 18:59:54+01:00,['8ef4ed1b2a0b28f27d35516cfb56a16c2583de0c'],0,265,265,1471376,2,0.304,0.304,0.952,3762
b941b1124834d38daaa0e4355655b4ce63b80d3e,0,Jens Geyer,2022-03-14 12:36:23+01:00,['bbea728aaa9f72bb3b58a1c5448b4e917eaf5796'],122,129,251,1471627,1,0,0,1,3762
6433994ee794fa4cd0d7dd862f83cedbfb72c23b,0,Yuxuan 'fishy' Wang,2022-03-15 21:39:38-07:00,['b941b1124834d38daaa0e4355655b4ce63b80d3e'],0,319,319,1471946,3,1,1,0.887387387,3763
37f26bbd1143a586134acfbaab6d2b816143a966,0,Jens Geyer,2022-03-16 23:57:48+01:00,['6433994ee794fa4cd0d7dd862f83cedbfb72c23b'],1,1,2,1471948,1,,,,3763
19f60f200ba7cc67244e64905b53663d6e43046c,0,Jens Geyer,2022-03-17 09:48:29+01:00,['37f26bbd1143a586134acfbaab6d2b816143a966'],0,17,17,1471965,2,0.666666667,0.666666667,1,3763
cd810bba7cb2d8c37f48f48a895713c2b2b42a6c,0,Jens Geyer,2022-03-19 11:15:18+01:00,['19f60f200ba7cc67244e64905b53663d6e43046c'],0,4,4,1471969,1,0,1,1,3763
56ec69e9f85d5937645e619a79eff3d4872c8f26,0,Jens Geyer,2022-03-19 13:30:16+01:00,['cd810bba7cb2d8c37f48f48a895713c2b2b42a6c'],4,10,14,1471983,1,1,1,0,3763
f0336417cae1c32f4ea59a9f9851a15f269340f7,0,GitHub,2022-03-30 05:39:08-04:00,['56ec69e9f85d5937645e619a79eff3d4872c8f26'],69,256,325,1472308,9,0,0.732283465,0.622047244,3763
e165fa3c85d00cb984f4d9635ed60909a1266ce1,0,Yuxuan 'fishy' Wang,2022-03-31 14:48:55-07:00,['f0336417cae1c32f4ea59a9f9851a15f269340f7'],1,2,3,1472311,1,,,,3763
15cc0c4da218a375cadc67e541a99fdc6c5083f2,0,Jens Geyer,2022-04-01 18:53:15+02:00,['e165fa3c85d00cb984f4d9635ed60909a1266ce1'],1,1,2,1472313,1,,,,3763
b3b3dc2ab8c590b360a58f34b0d6cc4b0aaed8d8,0,Jens Geyer,2022-04-11 21:48:43+02:00,['15cc0c4da218a375cadc67e541a99fdc6c5083f2'],0,1,1,1472314,1,0,0,1,3763
2f6ddc91456aaa18e017ba1aa95dbd5f98525fce,0,GitHub,2022-04-11 23:58:27-04:00,['b3b3dc2ab8c590b360a58f34b0d6cc4b0aaed8d8'],293,373,666,1472980,1,0.048780488,0.524390244,1,3763
aa82214dbc1ee981040719067a6d4eb7791fe7ec,0,Jens Geyer,2022-04-13 21:49:21+02:00,['2f6ddc91456aaa18e017ba1aa95dbd5f98525fce'],2,127,129,1473109,3,0.229885057,0.965517241,0.965517241,3764
9f81161a9ce1942b4730df74381ef3abc65e2861,0,Jens Geyer,2022-04-13 21:50:32+02:00,['aa82214dbc1ee981040719067a6d4eb7791fe7ec'],15,15,30,1473139,1,,,,3764
07061b83ec933df1b897573df27b5b76e0e65a8a,0,Jens Geyer,2022-04-13 21:59:36+02:00,['9f81161a9ce1942b4730df74381ef3abc65e2861'],34,67,101,1473240,1,0.125,0.34375,0.90625,3764
8d9b9c97c64ba6eb28eccba6c9fc04054d64e390,0,Jens Geyer,2022-04-14 19:13:32+02:00,['07061b83ec933df1b897573df27b5b76e0e65a8a'],16,16,32,1473272,1,,,,3764
3fe71800deee18875b51f9364d6967892983e604,0,Jens Geyer,2022-04-14 19:13:53+02:00,['8d9b9c97c64ba6eb28eccba6c9fc04054d64e390'],3,3,6,1473278,1,,,,3764
8d69216e812a163cde74af8804600acde4b22f75,0,Jens Geyer,2022-04-14 19:13:58+02:00,['3fe71800deee18875b51f9364d6967892983e604'],24,12,36,1473314,1,,,,3764
272c2a96319df84bc5e28ec811b99b686c9d9b70,0,Jens Geyer,2022-04-14 19:14:11+02:00,['8d69216e812a163cde74af8804600acde4b22f75'],24,6,30,1473344,1,,,,3764
2e0a80599897a57e05127b28640a1b5956ba744d,0,Jens Geyer,2022-04-14 19:20:30+02:00,['272c2a96319df84bc5e28ec811b99b686c9d9b70'],11,33,44,1473388,2,0,0,0.4,3764
1eb361a89372b8676a5f48c2ee4038f6d2d8b4b7,0,Jens Geyer,2022-04-16 09:58:32+02:00,['2e0a80599897a57e05127b28640a1b5956ba744d'],28,214,242,1473630,17,0.192307692,0.41025641,0.897435897,3766
1a5d6b6f07200e75e110d910ecfc3b6152bb2bf8,0,Jens Geyer,2022-04-16 10:01:35+02:00,['1eb361a89372b8676a5f48c2ee4038f6d2d8b4b7'],27,3,30,1473660,1,,,,3766
90ea2e8398eda32da8be0b3514516e7ad932a869,0,Jens Geyer,2022-04-16 10:01:44+02:00,['1a5d6b6f07200e75e110d910ecfc3b6152bb2bf8'],10,12,22,1473682,1,,,,3766
6bdefc47c3408dc4f9b6eefb6d3449c596109bb3,0,GitHub,2022-04-18 12:50:35-04:00,['90ea2e8398eda32da8be0b3514516e7ad932a869'],114,115,229,1473911,7,1,1,1,3766
ceffb5a934782cf449a382dfd21b4a9529ade8e7,0,Jens Geyer,2022-04-19 11:42:16+02:00,['6bdefc47c3408dc4f9b6eefb6d3449c596109bb3'],3,3,6,1473917,1,,,,3766
35d22c526e5fcf7eae826e873184c5d3dc51b5c0,0,Jens Geyer,2022-04-19 11:43:23+02:00,['ceffb5a934782cf449a382dfd21b4a9529ade8e7'],5,8,13,1473930,1,0.25,0.75,0.75,3766
a8fded497635f2a319ece3882b234f510d84cacd,0,Jens Geyer,2022-04-19 18:27:41+02:00,['35d22c526e5fcf7eae826e873184c5d3dc51b5c0'],2,3,5,1473935,1,,,,3766
5d220eb3321aa571b316da942feb72c29c7386c1,0,Jens Geyer,2022-04-19 18:40:52+02:00,['a8fded497635f2a319ece3882b234f510d84cacd'],359,51,410,1474345,14,,,,3766
edcad983d9896adc559f7305549492db85629f4c,0,Jens Geyer,2022-04-19 18:51:18+02:00,['5d220eb3321aa571b316da942feb72c29c7386c1'],3,249,252,1474597,1,0,1,1,3766
8987820e84ac26392293ab40480cf8f2971fb314,0,Jens Geyer,2022-04-20 23:28:55+02:00,['edcad983d9896adc559f7305549492db85629f4c'],0,9,9,1474606,1,0,0,0,3766
eac5103f8204021f7b5436001319c2b17ed5644f,0,Jens Geyer,2022-04-20 23:37:58+02:00,['8987820e84ac26392293ab40480cf8f2971fb314'],38,7,45,1474651,244,,,,3766
49b2d6b888a2a96fc0948da81a779a90b4624170,0,Jens Geyer,2022-04-20 23:49:33+02:00,['eac5103f8204021f7b5436001319c2b17ed5644f'],3,4181,4184,1478835,24,0.162390386,0.457616109,0.829165313,3779
625367f2169848802c9b885249571d8e4b3fcc6e,0,Jens Geyer,2022-04-21 09:07:23+02:00,['49b2d6b888a2a96fc0948da81a779a90b4624170'],2,17,19,1478854,1,0,0,0.666666667,3779
0dc52985ca06cb948eae251dce789f7f863fc243,0,Jens Geyer,2022-04-21 09:08:22+02:00,['625367f2169848802c9b885249571d8e4b3fcc6e'],21,16,37,1478891,1,1,0,0,3779
b664cfe2533e4bbf00fd5e7e0211bf7161ee2a04,0,Jens Geyer,2022-04-21 09:13:52+02:00,['0dc52985ca06cb948eae251dce789f7f863fc243'],0,4,4,1478895,1,0,0,1,3779
88a45ac77518eafb57db08938ecdf38c5fcf7a31,0,Jens Geyer,2022-04-23 10:30:46+02:00,['b664cfe2533e4bbf00fd5e7e0211bf7161ee2a04'],2,44,46,1478941,1,0,0.027777778,0.972222222,3779
8045d82f0d5359cbdc196414f0c1aa4679c4124f,0,Yuxuan 'fishy' Wang,2022-04-25 16:00:53-07:00,['88a45ac77518eafb57db08938ecdf38c5fcf7a31'],20,56,76,1479017,14,,1,1,3779
4302aa07b094316ffca1665da346f495d88eb065,0,Jens Geyer,2022-04-27 12:49:55+02:00,['8045d82f0d5359cbdc196414f0c1aa4679c4124f'],1,4,5,1479022,1,,,,3779
9042cc298c6d02d88a44b125a1ebaabb9416cd04,0,Jens Geyer,2022-04-27 12:49:55+02:00,['4302aa07b094316ffca1665da346f495d88eb065'],7,8,15,1479037,2,,,,3779
40496a7c432d0a39df8ff180e9cb0e0a94af9b44,0,Jens Geyer,2022-04-27 12:49:55+02:00,['9042cc298c6d02d88a44b125a1ebaabb9416cd04'],8,7,15,1479052,2,,,,3779
684ee0717472e1c084f4858f3faf650b6f17b451,0,Jens Geyer,2022-04-27 12:49:55+02:00,['40496a7c432d0a39df8ff180e9cb0e0a94af9b44'],1,1,2,1479054,1,,,,3779
6a61c4ee992c6e4f0be4f065cfccf1757212f6de,0,GitHub,2022-04-28 13:25:39-04:00,['684ee0717472e1c084f4858f3faf650b6f17b451'],0,47,47,1479101,1,,,,3780
c77d91a65bf31c70127f3fd51139f1c464b55591,0,GitHub,2022-05-03 08:55:50-04:00,['6a61c4ee992c6e4f0be4f065cfccf1757212f6de'],17,95,112,1479213,1,,,,3780
7fb21ebff73d6d1f87c67d7d0285ef39f704bce6,0,Jens Geyer,2022-05-05 10:02:34+02:00,['c77d91a65bf31c70127f3fd51139f1c464b55591'],2,0,2,1479215,1,1,0,0,3780
ada086529730b13eedb74a975db5167f405d18af,0,GitHub,2022-05-05 15:19:57-04:00,['7fb21ebff73d6d1f87c67d7d0285ef39f704bce6'],11,170,181,1479396,5,0.508196721,0.950819672,0.885245902,3782
0c9c9df7637154029a88ca6923e1fc2c0a9fd188,0,GitHub,2022-05-05 15:30:52-04:00,['ada086529730b13eedb74a975db5167f405d18af'],2062,2203,4265,1483661,70,1,0.494505495,0.505494505,3782
3df6a03a2fea77ece9c09c12c413297bc09b06c1,0,Christopher Tubbs,2022-05-05 16:57:30-04:00,['0c9c9df7637154029a88ca6923e1fc2c0a9fd188'],2,2,4,1483665,2,,,,3782
bf5c6dd77c597ace417d7283a1d2805fc647b091,0,Christopher Tubbs,2022-05-05 23:51:18-04:00,['3df6a03a2fea77ece9c09c12c413297bc09b06c1'],6,7,13,1483678,1,,,,3782
45471decdf572156189e66db59c8a1e82085299f,0,GitHub,2022-05-06 00:40:45-04:00,['bf5c6dd77c597ace417d7283a1d2805fc647b091'],2,0,2,1483680,2,,,,3782
23b86364ef3dbccc19f5f3828e6d115f7b015651,0,GitHub,2022-05-06 00:42:18-04:00,['45471decdf572156189e66db59c8a1e82085299f'],108,86,194,1483874,6,,,,3782
53ec08228a14130909d4dd6fc2c98f47a09d76b0,0,GitHub,2022-05-06 00:56:42-04:00,['23b86364ef3dbccc19f5f3828e6d115f7b015651'],7691,8308,15999,1499873,227,0,0.921794872,0.747435897,3782
6c002b61e591b712fca2713eefd3e99c5782bb21,0,GitHub,2022-05-06 12:40:03-04:00,['53ec08228a14130909d4dd6fc2c98f47a09d76b0'],54,285,339,1500212,11,0.283185841,0.610619469,0.982300885,3785
bcac978ce97e9808866ed639f88095473ba5c261,0,GitHub,2022-05-06 20:35:09-04:00,['6c002b61e591b712fca2713eefd3e99c5782bb21'],7,18,25,1500237,1,,,,3785
eb62fa8d13f9860c4c877d0252e67ef21b013488,0,GitHub,2022-05-08 01:01:41-04:00,['bcac978ce97e9808866ed639f88095473ba5c261'],45,180,225,1500462,13,,,,3788
891c521528beb57fef0c362f535e3e355b52cd1c,0,GitHub,2022-05-08 01:31:21-04:00,['eb62fa8d13f9860c4c877d0252e67ef21b013488'],18,12,30,1500492,1,1,0,0,3788
5fdfd0cae0abaa89a26fa0015d31b6d369b32777,0,GitHub,2022-05-08 22:52:26-04:00,['891c521528beb57fef0c362f535e3e355b52cd1c'],1161,838,1999,1502491,10,0.996583144,1,0,3788
ab83ffc894c00f0a8feade2f54cb444c22e16461,0,GitHub,2022-05-09 13:56:30-04:00,['5fdfd0cae0abaa89a26fa0015d31b6d369b32777'],4,115,119,1502610,5,,,,3788
a24bcd39a50e3472b5f1bf9fb5b8526fccf7911e,0,GitHub,2022-05-10 07:11:07-04:00,['ab83ffc894c00f0a8feade2f54cb444c22e16461'],199,517,716,1503326,18,1,1,0.561403509,3790
dae1437ca03834527b654cf5bc8d7f41c9412a20,0,Yuxuan 'fishy' Wang,2022-05-10 08:57:22-07:00,['a24bcd39a50e3472b5f1bf9fb5b8526fccf7911e'],4,17,21,1503347,3,0.4,0.4,0.4,3790
5b158389b01d028e98e59f0ea41c01d625a84242,0,GitHub,2022-05-11 12:20:37-04:00,['dae1437ca03834527b654cf5bc8d7f41c9412a20'],201,197,398,1503745,31,1,1,1,3790
71ba05ba2dd50aff11f1e88df0712aa9f6df8c9d,0,Yuxuan 'fishy' Wang,2022-05-12 13:28:14-07:00,['5b158389b01d028e98e59f0ea41c01d625a84242'],1,1,2,1503747,1,,,,3790
8e217dca69081016b6b7df344fbf957342243c7f,0,Yuxuan 'fishy' Wang,2022-05-12 13:28:14-07:00,['71ba05ba2dd50aff11f1e88df0712aa9f6df8c9d'],9,0,9,1503756,1,1,1,1,3790
c4e96c75758d94a79dae925b1daae0c950823057,0,GitHub,2022-05-18 15:03:07-04:00,['8e217dca69081016b6b7df344fbf957342243c7f'],47,35,82,1503838,6,1,1,0,3790
162cbb4894548ac4d016f8e63a15f994b17c4dba,0,Yuxuan 'fishy' Wang,2022-05-21 10:08:32-07:00,['c4e96c75758d94a79dae925b1daae0c950823057'],11,37,48,1503886,2,1,1,1,3790
c6f18a596e108f7913185a09c0c0f7d29893611b,0,GitHub,2022-05-21 16:01:43-04:00,['162cbb4894548ac4d016f8e63a15f994b17c4dba'],0,37,37,1503923,1,,,,3791
b90f2bcb8696e2da40aeadf6e6f3eb4904f868e5,0,GitHub,2022-05-23 12:08:47-04:00,['c6f18a596e108f7913185a09c0c0f7d29893611b'],10,12,22,1503945,1,,,,3791
4646a3557b822c3893dc6773882a689118b77611,0,GitHub,2022-05-24 05:19:41-04:00,['b90f2bcb8696e2da40aeadf6e6f3eb4904f868e5'],0,0,0,1503945,66,,,,3791
80018c544d921da6ee75567fbfe628337977628e,0,Jens Geyer,2022-05-26 10:17:13+02:00,['4646a3557b822c3893dc6773882a689118b77611'],1,1,2,1503947,1,,,,3791
84616697942bcfb57b6a4bb4d15d03c0a000093d,0,Jens Geyer,2022-05-29 13:31:34+02:00,['80018c544d921da6ee75567fbfe628337977628e'],11,11,22,1503969,1,,,,3791
7a182feb4d523cf8ae6207fd21fd9c7bd054f269,0,Jens Geyer,2022-05-29 13:31:46+02:00,['84616697942bcfb57b6a4bb4d15d03c0a000093d'],28,8,36,1504005,1,,,,3791
aad75837f4e12a9b37fd38bee51b96df595997d8,0,Jens Geyer,2022-06-01 22:30:59+02:00,['7a182feb4d523cf8ae6207fd21fd9c7bd054f269'],2,2,4,1504009,2,,,,3791
0b1eb6bcabebe02d61be614eab0eb6c4d2d972c3,0,Jens Geyer,2022-06-06 01:44:16+02:00,['aad75837f4e12a9b37fd38bee51b96df595997d8'],107,22,129,1504138,10,1,1,0,3791
ce1d314ef3e9c9b3999641da77fdc90f563b3226,0,Jens Geyer,2022-06-07 08:56:54+02:00,['0b1eb6bcabebe02d61be614eab0eb6c4d2d972c3'],271,72,343,1504481,21,1,1,0.666666667,3791
c7d2e3b244f18b0030f305fa3f13c4d3047d5b29,0,Jens Geyer,2022-06-08 18:22:36+02:00,['ce1d314ef3e9c9b3999641da77fdc90f563b3226'],48,73,121,1504602,5,,,,3791
4959a92385e2a6d7a4b8419784f85e5762c714cf,0,Jens Geyer,2022-06-08 18:43:20+02:00,['c7d2e3b244f18b0030f305fa3f13c4d3047d5b29'],41,86,127,1504729,5,,,,3791
e3eb9afb20a0535d44c203a4195db9822f8861fc,0,Yuxuan 'fishy' Wang,2022-06-10 08:41:25-07:00,['4959a92385e2a6d7a4b8419784f85e5762c714cf'],0,6,6,1504735,3,0,0,0.6,3791
7628392dff65d747a026fd5183466c4460047c92,0,Jens Geyer,2022-06-13 23:05:02+02:00,['e3eb9afb20a0535d44c203a4195db9822f8861fc'],149,294,443,1505178,17,1,1,1,3792
3a6f8a228f7008f033d609bdef2df952e2e2fc54,0,Jens Geyer,2022-06-21 22:27:41+02:00,['7628392dff65d747a026fd5183466c4460047c92'],25,20,45,1505223,3,1,0,0,3792
511acca6cbf47b3965b9569175134528ba64cddb,0,Jens Geyer,2022-06-22 21:39:12+02:00,['3a6f8a228f7008f033d609bdef2df952e2e2fc54'],3,3,6,1505229,1,,,,3792
54765854873e19b8ba50a0ec8080dd92d8323851,0,Jens Geyer,2022-07-01 14:46:47+02:00,['511acca6cbf47b3965b9569175134528ba64cddb'],312,455,767,1505996,11,,,,3792
2055636709de678b2c18bc1bd3804431daadf3f0,0,GitHub,2022-07-01 11:34:36-04:00,['54765854873e19b8ba50a0ec8080dd92d8323851'],1,1,2,1505998,1,,,,3792
b18964e1352bf0e051f6a3d3b8a34e5f34b42543,0,Jens Geyer,2022-07-01 21:14:12+02:00,['2055636709de678b2c18bc1bd3804431daadf3f0'],0,137,137,1506135,2,,,,3794
7a5f29d48d6b99f14190d9d7bff0e63170965087,0,Jens Geyer,2022-07-01 21:15:57+02:00,['b18964e1352bf0e051f6a3d3b8a34e5f34b42543'],0,18,18,1506153,1,,,,3794
