sha,is_bug,committer_name,commit_time,parents,all_del,all_add,all_change_lines,all_lines,files_change_nums,dmm_unit_size,dmm_unit_complexity,dmm_unit_interfacing,file_nums
31275a67f8fa261dec38e0c5b6445d2b3d88975c,0,Owen O'Malley,2008-05-19 17:51:27+00:00,[],0,0,0,0,0,,,,0
047d9258a4730791b85cc81b0e1435465a32acbf,1,Benjamin Reed,2007-11-03 04:41:15+00:00,['31275a67f8fa261dec38e0c5b6445d2b3d88975c'],0,16741,16741,16741,85,0.365946357,0.502986209,0.891301987,85
e048893ec04a250fcb50853d6b47594fa81b0ea2,1,Benjamin Reed,2007-11-03 04:47:33+00:00,['047d9258a4730791b85cc81b0e1435465a32acbf'],35,179,214,16955,2,,,,86
bbc3fdc9973cf02256539a794b617c9b0da5b81f,0,Benjamin Reed,2007-11-06 17:15:39+00:00,['e048893ec04a250fcb50853d6b47594fa81b0ea2'],3,3,6,16961,1,,,,86
3eed1f68e7fcf50b54e67afff46c205c7762da7e,0,Andrew Kornev,2007-11-08 01:01:42+00:00,['bbc3fdc9973cf02256539a794b617c9b0da5b81f'],706,728,1434,18395,1,0,1,0,86
03b424d305d37caffb28dcb35122380c83d953d3,1,Andrew Kornev,2007-11-08 01:02:20+00:00,['3eed1f68e7fcf50b54e67afff46c205c7762da7e'],0,83,83,18478,1,0.12195122,0.12195122,1,87
2cc64f54fdf857437ac7325639afdb67bbfb0388,1,Benjamin Reed,2007-11-09 00:36:20+00:00,['03b424d305d37caffb28dcb35122380c83d953d3'],0,1914,1914,20392,10,0.277737491,0.49311095,0.939086294,97
11d2d6fd92acf9abc762c41e0f7b91c5acc89f4f,0,Benjamin Reed,2007-11-09 01:42:34+00:00,['2cc64f54fdf857437ac7325639afdb67bbfb0388'],3,3,6,20398,3,,,,97
1d2cb51508281a281bc47d6bf93fbf264cc20540,0,,2007-11-09 19:01:38+00:00,['11d2d6fd92acf9abc762c41e0f7b91c5acc89f4f'],0,0,0,20398,1,,,,98
fce72e5323cccbacd9f1a0dadc7dbd58a2899771,0,,2007-11-09 19:44:30+00:00,['1d2cb51508281a281bc47d6bf93fbf264cc20540'],0,5,5,20403,1,,,,98
a1c481ceca909e32ec49ff9738b5355eb1c367a7,0,,2007-11-09 19:47:39+00:00,['fce72e5323cccbacd9f1a0dadc7dbd58a2899771'],3,2,5,20408,1,,,,98
18a282789c4723e3c2a41960174ea55594e43d7a,1,Benjamin Reed,2007-11-12 17:50:53+00:00,['a1c481ceca909e32ec49ff9738b5355eb1c367a7'],1,1,2,20410,1,,,,98
7563bfe9f8caa1a3acdedb32db9e7af7aa3c76ae,0,,2007-11-12 20:19:46+00:00,['18a282789c4723e3c2a41960174ea55594e43d7a'],1,6,7,20417,2,,,,99
925c425a73910bab9e40bc044329136379adadaa,0,,2007-11-12 23:43:44+00:00,['7563bfe9f8caa1a3acdedb32db9e7af7aa3c76ae'],8,8,16,20433,2,,,,99
50d018f409aa2b47c47e5c219e09e17b9d5ad501,1,Benjamin Reed,2007-11-13 23:36:36+00:00,['925c425a73910bab9e40bc044329136379adadaa'],1,205,206,20639,2,,,,100
7beb7dad9505746944744c20dbabca0b46d76585,1,,2007-11-19 21:45:23+00:00,['50d018f409aa2b47c47e5c219e09e17b9d5ad501'],1,5618,5619,26258,13,0.277167739,0.459295721,0.629307081,111
87be48dc97ad6e6a0e49d6b665df56d4f86b6808,0,Andrew Kornev,2007-11-21 06:17:38+00:00,['7beb7dad9505746944744c20dbabca0b46d76585'],4,4,8,26266,1,,,,111
ca3993e5b10ed20ddfe04d0c57c2fb149223804b,0,Andrew Kornev,2007-11-21 06:21:16+00:00,['87be48dc97ad6e6a0e49d6b665df56d4f86b6808'],0,0,0,26266,0,,,,111
667c6c4bb85800feb0f31037ee3eb9a36043f79a,0,Andrew Kornev,2007-11-21 06:29:17+00:00,['ca3993e5b10ed20ddfe04d0c57c2fb149223804b'],0,0,0,26266,0,,,,111
b07de9a00b2e2bdb0f839c467181657fdee942af,0,Andrew Kornev,2007-11-21 06:31:39+00:00,['667c6c4bb85800feb0f31037ee3eb9a36043f79a'],0,0,0,26266,0,,,,111
9cb5cf3a21c6185727044e9d5ba52feba0da0973,0,Andrew Kornev,2007-11-21 07:09:12+00:00,['b07de9a00b2e2bdb0f839c467181657fdee942af'],10,12,22,26288,1,,,,111
c67fef7ea93c505bdf94096fb852da87f4fb2c50,0,Andrew Kornev,2007-11-21 18:54:35+00:00,['9cb5cf3a21c6185727044e9d5ba52feba0da0973'],1,1,2,26290,1,,,,111
9201659e2882da8eda910cd3449e14fd9d7d31bd,0,Andrew Kornev,2007-11-22 00:22:59+00:00,['c67fef7ea93c505bdf94096fb852da87f4fb2c50'],0,2,2,26292,1,,,,111
992946b900b3b4cbaf1cf9a77555b57413d64b76,0,Andrew Kornev,2007-11-28 00:27:09+00:00,['9201659e2882da8eda910cd3449e14fd9d7d31bd'],13,9,22,26314,1,,,,111
771116b87df2b83f6923a997d064f006422a3adb,1,Andrew Kornev,2007-11-28 00:28:12+00:00,['992946b900b3b4cbaf1cf9a77555b57413d64b76'],19,20,39,26353,1,,,,111
e6a03538f9b7b88d5e0523882c26de0a05b0f801,1,Andrew Kornev,2007-11-28 00:29:44+00:00,['771116b87df2b83f6923a997d064f006422a3adb'],13,22,35,26388,3,0,0,0,111
6c1b271c933c53a882e84cd9317f2dbf5d78bdfa,0,Andrew Kornev,2007-11-28 00:31:07+00:00,['e6a03538f9b7b88d5e0523882c26de0a05b0f801'],36,0,36,26424,1,,,,111
2d61e7ebf2a75e227a140644357a073fe758ddbf,1,Andrew Kornev,2007-11-28 00:32:07+00:00,['6c1b271c933c53a882e84cd9317f2dbf5d78bdfa'],0,427,427,26851,5,,,,116
efa6ab6e89270f43355066c2bfd9343a02cb5a27,0,Andrew Kornev,2007-11-28 00:33:59+00:00,['2d61e7ebf2a75e227a140644357a073fe758ddbf'],0,0,0,26851,0,,,,116
1061ac279cd4785951219c1c1631c4156de913fc,1,Andrew Kornev,2007-11-28 00:35:29+00:00,['efa6ab6e89270f43355066c2bfd9343a02cb5a27'],10,11,21,26872,3,0,1,1,116
21d54c374dc24a4128d468a2bdecd30eb94bf4be,0,Andrew Kornev,2007-11-28 19:05:18+00:00,['1061ac279cd4785951219c1c1631c4156de913fc'],10,13,23,26895,1,,,,116
df25a810ee7ff41509965102e1475fc353ecb012,0,Andrew Kornev,2007-11-28 19:10:46+00:00,['21d54c374dc24a4128d468a2bdecd30eb94bf4be'],0,1,1,26896,1,,,,116
3347bf0ddf0598c16f954470d786b2101f64a472,0,Andrew Kornev,2007-11-28 19:11:32+00:00,['df25a810ee7ff41509965102e1475fc353ecb012'],0,202,202,27098,1,,,,117
b0df85d1f1e26bfaced8a003a6b09bede5867a9f,0,Andrew Kornev,2007-11-28 19:13:26+00:00,['3347bf0ddf0598c16f954470d786b2101f64a472'],1,1,2,27100,1,,,,117
2a447187b125e3226dbaccd29e974c887db1ee7a,0,Andrew Kornev,2007-11-28 19:14:04+00:00,['b0df85d1f1e26bfaced8a003a6b09bede5867a9f'],0,1,1,27101,1,,,,117
c62c6d2aba9b97ccc1588ae933d4e7021010a50c,0,Andrew Kornev,2007-11-28 19:19:55+00:00,['2a447187b125e3226dbaccd29e974c887db1ee7a'],0,6,6,27107,1,,,,118
7dc0c2249281c9c7361b25276f91685016e453b0,0,Andrew Kornev,2007-11-28 19:21:40+00:00,['c62c6d2aba9b97ccc1588ae933d4e7021010a50c'],2,2,4,27111,1,,,,118
4e7258d6e3d8e93605893546d337f0586e7a149d,0,Andrew Kornev,2007-11-28 20:53:01+00:00,['7dc0c2249281c9c7361b25276f91685016e453b0'],136,136,272,27383,5,,,,118
4d96d937fd834e30dfb182f483efffdeb26b828a,0,Andrew Kornev,2007-11-28 21:58:31+00:00,['4e7258d6e3d8e93605893546d337f0586e7a149d'],0,0,0,27383,0,,,,118
e655cad3c57b98be9ccd5645a712ff5a57dc0480,0,Benjamin Reed,2007-11-29 18:24:51+00:00,['4d96d937fd834e30dfb182f483efffdeb26b828a'],29,17,46,27429,4,0,0,1,118
70cc907a3e23252eec852c5473c80873e27da9f4,1,,2007-12-01 00:09:08+00:00,['e655cad3c57b98be9ccd5645a712ff5a57dc0480'],0,189,189,27618,1,,,,118
4594025287271b5057b992da66291a6faac8ec7a,0,Andrew Kornev,2007-12-01 04:18:21+00:00,['70cc907a3e23252eec852c5473c80873e27da9f4'],0,4,4,27622,1,,,,118
4729a9eefad0d9c5ed4d4f69cbee38d393fbb40f,1,Andrew Kornev,2007-12-03 23:49:33+00:00,['4594025287271b5057b992da66291a6faac8ec7a'],2,14,16,27638,1,0,0,1,118
16801baebba047544af01682beda5c86de6e9fc7,0,Andrew Kornev,2007-12-03 23:51:18+00:00,['4729a9eefad0d9c5ed4d4f69cbee38d393fbb40f'],1,6,7,27645,1,1,1,1,118
8bf848da45f9b337461e6114c2a4dce204b5b25b,0,Andrew Kornev,2007-12-03 23:53:19+00:00,['16801baebba047544af01682beda5c86de6e9fc7'],83,79,162,27807,1,1,1,0,118
32a39726ce62aa1f73913d499aa03c86bf868bed,0,Benjamin Reed,2007-12-04 23:12:25+00:00,['8bf848da45f9b337461e6114c2a4dce204b5b25b'],7,22,29,27836,5,0.375,0.375,1,118
db09d03ec03761e3e0715e6478daf1fe771f8b7a,0,Andrew Kornev,2007-12-05 00:07:29+00:00,['32a39726ce62aa1f73913d499aa03c86bf868bed'],0,12,12,27848,1,0,1,1,118
e98264c167bb375aba379ed2090aa6dcb4caf407,0,,2007-12-05 18:56:23+00:00,['db09d03ec03761e3e0715e6478daf1fe771f8b7a'],2,2,4,27852,1,,,,118
d8ba75f2190f83118116c29f17dac29cf79927ec,1,Benjamin Reed,2007-12-05 23:31:14+00:00,['e98264c167bb375aba379ed2090aa6dcb4caf407'],11,16,27,27879,2,0,0,0,118
8ee17324ceb0fd0ace7d87c3bd095ee20c0466aa,1,Benjamin Reed,2007-12-05 23:34:16+00:00,['d8ba75f2190f83118116c29f17dac29cf79927ec'],36,261,297,28176,18,0.306306306,0.468468468,0.711711712,118
e77adca71ac461a1c3ea2fd3fec362592d302294,1,Andrew Kornev,2007-12-06 18:47:08+00:00,['8ee17324ceb0fd0ace7d87c3bd095ee20c0466aa'],70,109,179,28355,8,0.5,0.5,1,120
b1dcfbc2c4f7c43691627151dd04e0b49c2b5b49,0,,2007-12-08 01:13:51+00:00,['e77adca71ac461a1c3ea2fd3fec362592d302294'],2,2,4,28359,1,,,,120
12fffd996f2289a2e6c05bbff166f935ae405488,1,Andrew Kornev,2007-12-10 21:20:33+00:00,['b1dcfbc2c4f7c43691627151dd04e0b49c2b5b49'],17,536,553,28912,6,,,,122
70dfa2969bc9c49efb9bca3288934bc1f7e1627f,0,Andrew Kornev,2007-12-10 21:22:42+00:00,['12fffd996f2289a2e6c05bbff166f935ae405488'],19,38,57,28969,1,0.416666667,1,1,122
6fa1e1bfd6b4bf2bbac2d58394b1966afb998d1e,0,Andrew Kornev,2007-12-10 21:30:06+00:00,['70dfa2969bc9c49efb9bca3288934bc1f7e1627f'],1,3,4,28973,1,0,0,1,122
551012dac1494b57e829bcbd9bafb51b280a03fa,0,,2007-12-10 22:40:04+00:00,['6fa1e1bfd6b4bf2bbac2d58394b1966afb998d1e'],0,29,29,29002,1,0,1,1,122
4efff2dfd774dc9acd5ed84d1586afd911271b1d,1,Benjamin Reed,2007-12-11 18:48:14+00:00,['551012dac1494b57e829bcbd9bafb51b280a03fa'],0,1,1,29003,1,0,0,1,122
2af055275751847a8202926173a76367f6f5d853,1,,2007-12-12 20:09:20+00:00,['4efff2dfd774dc9acd5ed84d1586afd911271b1d'],12,33,45,29048,5,1,1,0.307692308,122
bdd911367253b67aa3d1665ed3262735d2f7ad20,0,,2007-12-13 23:20:51+00:00,['2af055275751847a8202926173a76367f6f5d853'],1,8,9,29057,1,1,1,1,122
344a30792bb30430a5949fa20ae69872c42394e0,1,,2007-12-14 18:57:37+00:00,['bdd911367253b67aa3d1665ed3262735d2f7ad20'],15,262,277,29334,10,0.005882353,0.188235294,1,122
35ccdb8896e6d835b89ba604c595e2e760f090cb,0,,2007-12-14 18:59:25+00:00,['344a30792bb30430a5949fa20ae69872c42394e0'],1,0,1,29335,1,0,0,0,122
d89952550caf2360904befbb8f9eccd8d29dbf95,0,Benjamin Reed,2007-12-14 20:09:07+00:00,['35ccdb8896e6d835b89ba604c595e2e760f090cb'],7,8,15,29350,3,,,,122
31399a0ac7c64244d4dfab42b86e93987226451f,1,Andrew Kornev,2008-01-10 00:39:30+00:00,['d89952550caf2360904befbb8f9eccd8d29dbf95'],0,4,4,29354,1,0,1,1,122
62d5b08a2593c0ca772714cef7e933786208281f,1,Andrew Kornev,2008-01-10 01:08:47+00:00,['31399a0ac7c64244d4dfab42b86e93987226451f'],0,2746,2746,32100,19,0.681617183,0.97409981,0.871762476,141
5d4d87dadf44ac741dabbb9491789644ceeb7388,1,Andrew Kornev,2008-01-10 01:10:43+00:00,['62d5b08a2593c0ca772714cef7e933786208281f'],6,80,86,32186,2,1,1,0.931818182,141
ab38be72cbec67f5d03980f20631256f7846e4ee,0,Andrew Kornev,2008-01-10 01:19:16+00:00,['5d4d87dadf44ac741dabbb9491789644ceeb7388'],498,498,996,33182,2,,,,141
d2c89d6e3047c3b01e30ace39f6dc13728f5b7cd,1,Andrew Kornev,2008-01-10 01:26:32+00:00,['ab38be72cbec67f5d03980f20631256f7846e4ee'],17,61,78,33260,2,,,,141
ffc4b0d4ca34749867321a56d40dd6e880f9759c,1,Andrew Kornev,2008-01-10 01:28:57+00:00,['d2c89d6e3047c3b01e30ace39f6dc13728f5b7cd'],691,798,1489,34749,6,0.032786885,0.901639344,0.737704918,141
71dc99891e5f05a0eee7e9bb20fceedb9465eae4,0,Andrew Kornev,2008-01-10 01:46:13+00:00,['ffc4b0d4ca34749867321a56d40dd6e880f9759c'],0,32,32,34781,2,,,,141
5a0a451b8069ef4e8bed9031f1f06ba1d0ed904d,0,Andrew Kornev,2008-01-10 20:04:53+00:00,['71dc99891e5f05a0eee7e9bb20fceedb9465eae4'],0,272,272,35053,17,,,,141
d008d1f441aabda569af91f6591c8d0318265241,1,Andrew Kornev,2008-01-16 18:31:41+00:00,['5a0a451b8069ef4e8bed9031f1f06ba1d0ed904d'],19,32,51,35104,4,1,1,1,141
d753e9098a6f19fb90241dc4180d9855a059a871,0,Andrew Kornev,2008-01-16 18:32:25+00:00,['d008d1f441aabda569af91f6591c8d0318265241'],1,5,6,35110,1,0,0,1,141
5e6f1f765c181ae0a3cce7b9524ab9095167d318,0,Andrew Kornev,2008-01-16 18:35:52+00:00,['d753e9098a6f19fb90241dc4180d9855a059a871'],29,22,51,35161,1,1,1,0,141
2474f37a0f2d5ceff68d6ca19d4d93fddb3995a1,0,Andrew Kornev,2008-01-16 18:37:44+00:00,['5e6f1f765c181ae0a3cce7b9524ab9095167d318'],23,131,154,35315,8,0,0.540540541,0.648648649,141
365c6e17edaaa1e3f097f60126e44c0d5d07d82f,0,Andrew Kornev,2008-01-16 18:41:03+00:00,['2474f37a0f2d5ceff68d6ca19d4d93fddb3995a1'],0,0,0,35315,0,,,,141
f1711641cd884ba751f4b5b6e90340d5ea814c71,0,Andrew Kornev,2008-01-24 00:32:17+00:00,['365c6e17edaaa1e3f097f60126e44c0d5d07d82f'],345,359,704,36019,1,0,0,0,141
d60e014b3f8145d60a771629cd7c2437e1333a4c,0,Andrew Kornev,2008-01-24 00:34:08+00:00,['f1711641cd884ba751f4b5b6e90340d5ea814c71'],90,90,180,36199,2,,,,141
a6d0a388682ae93fdee7e6c30143c60ad82ebcbb,1,Andrew Kornev,2008-01-24 00:37:29+00:00,['d60e014b3f8145d60a771629cd7c2437e1333a4c'],287,559,846,37045,16,0.572327044,0.943396226,0.949685535,143
9f10de49a9249ea2aa951a122f9226fa3ee4e918,0,Andrew Kornev,2008-01-24 00:38:11+00:00,['a6d0a388682ae93fdee7e6c30143c60ad82ebcbb'],1784,1784,3568,40613,10,,,,143
911e7a8c6e6d1db1cd35ab7e809d4750a6a8b760,1,Andrew Kornev,2008-01-24 21:25:25+00:00,['9f10de49a9249ea2aa951a122f9226fa3ee4e918'],25,96,121,40734,10,0,0,1,143
a32fd48ef2b72af6264d6fc2a77aa5fd8b5e43fe,0,Andrew Kornev,2008-01-24 23:11:11+00:00,['911e7a8c6e6d1db1cd35ab7e809d4750a6a8b760'],0,6,6,40740,1,,,,143
935dfab06e02a561a1abc320792cfe1cccf08975,0,Andrew Kornev,2008-01-25 23:58:25+00:00,['a32fd48ef2b72af6264d6fc2a77aa5fd8b5e43fe'],1,4,5,40745,3,,,,143
a3b0ab80e49741e3cf06ce17f2db2a290ff4b276,0,Andrew Kornev,2008-01-28 20:31:35+00:00,['935dfab06e02a561a1abc320792cfe1cccf08975'],0,6,6,40751,1,0,0,1,143
f82b49dd430817d508b06d6af41bded85fb79691,0,Andrew Kornev,2008-01-28 22:07:24+00:00,['a3b0ab80e49741e3cf06ce17f2db2a290ff4b276'],0,0,0,40751,0,,,,143
fc43b63e862fd4a04fbcfbfaca35933d19aab598,0,Andrew Kornev,2008-01-28 22:11:24+00:00,['f82b49dd430817d508b06d6af41bded85fb79691'],3,26,29,40780,1,,,,143
1153591dea3c1ca8c19e6f353dd10551c68c11c1,0,,2008-01-30 18:43:29+00:00,['fc43b63e862fd4a04fbcfbfaca35933d19aab598'],8,7,15,40795,4,0,0,1,143
fdb954fdef2fd4425c81ee118d5266cf8a59c83c,0,Andrew Kornev,2008-02-07 21:26:59+00:00,['1153591dea3c1ca8c19e6f353dd10551c68c11c1'],3,6,9,40804,1,0,0,1,143
6e8bcd146a3e9dcad32727c80dd8556549a34337,1,Andrew Kornev,2008-02-07 21:28:02+00:00,['fdb954fdef2fd4425c81ee118d5266cf8a59c83c'],10,63,73,40877,2,0,0,0.948717949,143
d72b54fb42742a89ce89c74c3fdf51d1de3f71cf,0,Andrew Kornev,2008-02-07 21:28:57+00:00,['6e8bcd146a3e9dcad32727c80dd8556549a34337'],4,6,10,40887,1,,,,143
480cf1a3a180ac9a6125b8f82e8f04dfbc094554,1,Andrew Kornev,2008-02-07 21:29:28+00:00,['d72b54fb42742a89ce89c74c3fdf51d1de3f71cf'],255,788,1043,41930,11,0.676567657,1,0.904290429,143
3b397095e6c74fd35a697f6c0da8801c36127e3e,0,Andrew Kornev,2008-02-07 21:36:14+00:00,['480cf1a3a180ac9a6125b8f82e8f04dfbc094554'],0,19,19,41949,1,,,,143
0c830830aa4cbeaf479cfb7618640ea6be57f5af,0,Andrew Kornev,2008-02-08 20:31:07+00:00,['3b397095e6c74fd35a697f6c0da8801c36127e3e'],12,446,458,42407,12,,,,154
41c6f3a9089940cd150efd98875067e57304bb88,0,Andrew Kornev,2008-02-08 22:25:48+00:00,['0c830830aa4cbeaf479cfb7618640ea6be57f5af'],9,9,18,42425,1,,,,154
a575976c553502ea73ce272f5d5060a271b6e06b,0,Andrew Kornev,2008-02-17 01:17:14+00:00,['41c6f3a9089940cd150efd98875067e57304bb88'],0,5,5,42430,1,,,,155
0b94bb84d83c77f58932ff35e3a355ef94a7e58f,0,Andrew Kornev,2008-02-17 01:32:31+00:00,['a575976c553502ea73ce272f5d5060a271b6e06b'],1,1,2,42432,1,,,,155
4b0cc456e9c1b5ffe4bf0c666545c74ffc9664d3,0,Andrew Kornev,2008-02-17 01:49:46+00:00,['0b94bb84d83c77f58932ff35e3a355ef94a7e58f'],1,2,3,42435,1,,,,155
f626ff622ef2f4ab91023a83a530eb00596e6e1d,0,Andrew Kornev,2008-02-17 01:54:37+00:00,['4b0cc456e9c1b5ffe4bf0c666545c74ffc9664d3'],1,1,2,42437,1,,,,155
ae74147efc8f3dffe6c68ec7ef30f222be63b396,1,Benjamin Reed,2008-02-21 15:46:48+00:00,['f626ff622ef2f4ab91023a83a530eb00596e6e1d'],2,12,14,42451,2,1,1,1,155
cef8ad10d66a54d9d5969cd8ea1682f58798c316,1,Andrew Kornev,2008-02-21 22:19:46+00:00,['ae74147efc8f3dffe6c68ec7ef30f222be63b396'],43,230,273,42724,3,0.272727273,0.838383838,0.646464646,156
2d5dd1da4d144cd1ab76edda05e4faa2d6f368e3,1,Andrew Kornev,2008-02-24 00:49:31+00:00,['cef8ad10d66a54d9d5969cd8ea1682f58798c316'],205,392,597,43321,14,1,1,0.946902655,158
d56cc9b9acb453945257a8e3b0cf8d88e5a36d35,1,Flavio Paiva Junqueira,2008-03-05 14:12:22+00:00,['2d5dd1da4d144cd1ab76edda05e4faa2d6f368e3'],558,2688,3246,46567,8,0.216168717,0.321616872,0.923550088,163
688f039444b44c925b3103cd0d05102a4b7ba690,1,Flavio Paiva Junqueira,2008-03-07 14:25:09+00:00,['d56cc9b9acb453945257a8e3b0cf8d88e5a36d35'],453,495,948,47515,2,0.121212121,0.151515152,0.96969697,163
cf6e81cb24dc8f0f7cd3f52bab48e2781f8c463d,1,Benjamin Reed,2008-03-10 21:40:59+00:00,['688f039444b44c925b3103cd0d05102a4b7ba690'],4,12,16,47531,2,1,1,1,163
ebcb21f448d92c19e025279f3c27bbdb2fc75af5,1,,2008-03-11 18:30:02+00:00,['cf6e81cb24dc8f0f7cd3f52bab48e2781f8c463d'],5,5,10,47541,1,,,,163
da2a904e6492c3e203f93190118922a730b2c6fc,0,Benjamin Reed,2008-03-14 21:37:29+00:00,['ebcb21f448d92c19e025279f3c27bbdb2fc75af5'],0,174,174,47715,1,0.607142857,0.776785714,0.723214286,164
4895120841fcfa8c7d45cadabb4d6468020ed41b,0,Andrew Kornev,2008-03-21 22:29:08+00:00,['da2a904e6492c3e203f93190118922a730b2c6fc'],0,213,213,47928,1,0.383561644,0.630136986,0.787671233,165
b01624e6f0caa19f610b110902cf7c8fb911ebfb,0,Benjamin Reed,2008-03-24 20:29:43+00:00,['4895120841fcfa8c7d45cadabb4d6468020ed41b'],1,1,2,47930,1,,,,165
ac533ef7e5aa056aabc8be5189175403aebc9a7a,0,Benjamin Reed,2008-03-26 22:02:25+00:00,['b01624e6f0caa19f610b110902cf7c8fb911ebfb'],174,0,174,48104,1,0.392857143,0.223214286,0.276785714,165
418a0392faf93494847798aea255d6503586a410,0,Andrew Kornev,2008-03-27 00:06:25+00:00,['ac533ef7e5aa056aabc8be5189175403aebc9a7a'],8,8,16,48120,1,,0,,165
bf1880ecb1385d570461213c352ff80b6ec9fb2f,1,Andrew Kornev,2008-03-27 00:06:27+00:00,['418a0392faf93494847798aea255d6503586a410'],0,59,59,48179,1,1,1,1,166
7f7a4a80beac658d2f1557b21499d596a2fe4929,0,Andrew Kornev,2008-03-27 00:10:32+00:00,['bf1880ecb1385d570461213c352ff80b6ec9fb2f'],191,207,398,48577,1,,,,166
a5cc7ba8b6739698f81f7d50bdac8f610f60d5b8,0,,2008-04-01 22:30:29+00:00,['7f7a4a80beac658d2f1557b21499d596a2fe4929'],4,3,7,48584,1,,,,166
ae6e4c603e4f9d3171bf40f110685b6c92c4c2c6,0,Andrew Kornev,2008-04-04 19:02:37+00:00,['a5cc7ba8b6739698f81f7d50bdac8f610f60d5b8'],12,15,27,48611,4,0,0.333333333,0,166
7f56417f9404afb0f8975b0fe616433ab75a5de8,1,Andrew Kornev,2008-04-04 22:53:25+00:00,['ae6e4c603e4f9d3171bf40f110685b6c92c4c2c6'],4567,5039,9606,58217,33,0.927710843,1,0.967871486,170
a40b75cd0894135def963ae24b8cbe37041a0592,1,Andrew Kornev,2008-04-04 22:54:46+00:00,['7f56417f9404afb0f8975b0fe616433ab75a5de8'],83,131,214,58431,5,0.975,1,1,170
5141003acd8ea3307bc36f9fc8c3990105a6f195,1,Andrew Kornev,2008-04-04 23:04:41+00:00,['a40b75cd0894135def963ae24b8cbe37041a0592'],9,281,290,58721,3,0.637681159,0.637681159,0.826086957,171
95828839ca0d575c04cb9df5eee9c82052c4c460,0,Andrew Kornev,2008-04-04 23:33:27+00:00,['5141003acd8ea3307bc36f9fc8c3990105a6f195'],3,0,3,58724,1,1,1,0,171
257ef2c937db7cc9e7d5fd5d036d87753bbc6d3c,1,Andrew Kornev,2008-04-05 00:50:53+00:00,['95828839ca0d575c04cb9df5eee9c82052c4c460'],123,170,293,59017,2,1,1,0,171
03954ba7db28b67fb8a7f4ca4ce1d12798207c09,0,Andrew Kornev,2008-04-05 00:51:34+00:00,['257ef2c937db7cc9e7d5fd5d036d87753bbc6d3c'],0,70,70,59087,1,0.652173913,1,1,172
3fc832e82ff3a5b3bd8ed7c5e86e90d8a5d90625,0,Andrew Kornev,2008-04-05 01:25:36+00:00,['03954ba7db28b67fb8a7f4ca4ce1d12798207c09'],1,1,2,59089,1,,,,172
b31e79ecb93acba7bf222813f8bf9c81cf1d6470,1,,2008-04-08 21:28:11+00:00,['3fc832e82ff3a5b3bd8ed7c5e86e90d8a5d90625'],0,17,17,59106,1,,,,173
90090902302f923a98b24185a56b392ca4144e54,1,Benjamin Reed,2008-04-09 04:45:57+00:00,['b31e79ecb93acba7bf222813f8bf9c81cf1d6470'],22,72,94,59200,2,0,1,1,173
2d1d4d3563233a4c7739069389ba2ff8a3a06c8c,1,,2008-04-09 17:57:31+00:00,['90090902302f923a98b24185a56b392ca4144e54'],11,9,20,59220,1,,,,173
256fe64d65db6fb0bcf4f0dc9120b6ab47f3bee3,0,Benjamin Reed,2008-04-15 15:04:06+00:00,['2d1d4d3563233a4c7739069389ba2ff8a3a06c8c'],0,1,1,59221,1,,,,173
edc4bf7ec225bba914037a89cf04c6601a8b9c33,1,Benjamin Reed,2008-04-17 22:37:55+00:00,['256fe64d65db6fb0bcf4f0dc9120b6ab47f3bee3'],33,430,463,59684,10,0.544117647,1,0.544117647,182
05b0999d09ed0dee3885ecf0746983b6ef5b4fc6,0,Benjamin Reed,2008-04-18 17:03:14+00:00,['edc4bf7ec225bba914037a89cf04c6601a8b9c33'],0,2,2,59686,1,,,,182
7369c5bdbac5426a16c5fa3b9ccea94dc7cc6120,0,Benjamin Reed,2008-04-21 16:42:58+00:00,['05b0999d09ed0dee3885ecf0746983b6ef5b4fc6'],1,3,4,59690,2,,,,182
cbf48b3780393f5f1c93ba3a2dfd94b9b7b2b047,1,Benjamin Reed,2008-04-28 16:24:51+00:00,['7369c5bdbac5426a16c5fa3b9ccea94dc7cc6120'],83,365,448,60138,6,0.432258065,0.967741935,0.980645161,182
3877da781d2c44d6cb98c325991caacfc94157d3,1,Andrew Kornev,2008-04-29 21:49:44+00:00,['cbf48b3780393f5f1c93ba3a2dfd94b9b7b2b047'],27,85,112,60250,3,0.675675676,0.675675676,0.675675676,182
888e0c5fc576415a7949a938bf1aad4be74984eb,1,Benjamin Reed,2008-04-29 22:27:32+00:00,['3877da781d2c44d6cb98c325991caacfc94157d3'],403,483,886,61136,40,0.121212121,0.121212121,0.363636364,183
8b68d78491052fc44bb5ef51ad866ce48d078725,0,Benjamin Reed,2008-04-29 22:36:42+00:00,['888e0c5fc576415a7949a938bf1aad4be74984eb'],9,10,19,61155,1,0.9,0.9,1,183
eb5e3fe817f7b14fa40de117b1bbcffb4abf7eb3,0,Benjamin Reed,2008-04-29 22:44:24+00:00,['8b68d78491052fc44bb5ef51ad866ce48d078725'],0,207,207,61362,3,,,,186
1a85483357106cf0993080a56ddd5c1e2644100c,1,Benjamin Reed,2008-04-29 23:11:26+00:00,['eb5e3fe817f7b14fa40de117b1bbcffb4abf7eb3'],53,102,155,61517,4,0,0.255319149,0.914893617,186
36ed46fc726fd3a1fdcf63559ff15231cd6398e0,0,Andrew Kornev,2008-04-30 01:13:36+00:00,['1a85483357106cf0993080a56ddd5c1e2644100c'],11,38,49,61566,1,0.46875,0.59375,0.46875,186
fd9a6525a702d7358bfc99b8d7724155006ca06d,0,,2008-04-30 05:25:39+00:00,['36ed46fc726fd3a1fdcf63559ff15231cd6398e0'],0,27,27,61593,1,,,,187
d2f590a28738bfa8a90a6ae3de7a013a19f7c161,0,Andrew Kornev,2008-04-30 19:35:20+00:00,['fd9a6525a702d7358bfc99b8d7724155006ca06d'],6,48,54,61647,3,,,,187
0fcfe3dc6a8380d2573858c9c321d94694045512,0,,2008-04-30 19:44:37+00:00,['d2f590a28738bfa8a90a6ae3de7a013a19f7c161'],1,5,6,61653,1,,,,187
7219da4dd344192ba5a36be46de4b572129fa6fe,0,Andrew Kornev,2008-04-30 23:42:05+00:00,['0fcfe3dc6a8380d2573858c9c321d94694045512'],3,3,6,61659,2,,,,187
bb10cb36bf9d8eb10f6418a6ebc9a84580f60d93,0,Andrew Kornev,2008-05-02 23:48:54+00:00,['7219da4dd344192ba5a36be46de4b572129fa6fe'],1,6,7,61666,2,,,,187
afd85358e0e3c32c93e33081d2904ad86f1f6ecb,1,Benjamin Reed,2008-05-06 23:15:47+00:00,['bb10cb36bf9d8eb10f6418a6ebc9a84580f60d93'],3,3,6,61672,1,,,,187
e3af06b67f3461a34951c0519a67dcbbb89af20b,0,Andrew Kornev,2008-05-07 00:05:11+00:00,['afd85358e0e3c32c93e33081d2904ad86f1f6ecb'],0,47,47,61719,1,,,,187
f976de7506640c8ba39b0de94c0d9c34fb9b7273,1,,2008-05-07 18:44:48+00:00,['e3af06b67f3461a34951c0519a67dcbbb89af20b'],3,141,144,61863,5,,,,191
3c67b6c6ddbee6d710714938f33697cf7912f00f,1,Andrew Kornev,2008-05-07 19:17:14+00:00,['f976de7506640c8ba39b0de94c0d9c34fb9b7273'],15,89,104,61967,1,,,,191
1f5dfb0bb6cd8c13d9308393825bea90ccf4e72c,0,,2008-05-08 18:49:06+00:00,['3c67b6c6ddbee6d710714938f33697cf7912f00f'],19,2,21,61988,1,0,0,0,191
f699c55336a7e3139afea6a7bbd77d837ded855a,0,,2008-05-08 20:52:57+00:00,['1f5dfb0bb6cd8c13d9308393825bea90ccf4e72c'],14,14,28,62016,1,0,1,1,191
a6bc7d54791e73b06083996ab57fdba9340ae1aa,1,Andrew Kornev,2008-05-08 21:50:32+00:00,['f699c55336a7e3139afea6a7bbd77d837ded855a'],805,542,1347,63363,24,0.693877551,0.683673469,0.316326531,192
03c7b1370bffacfdf9f9ce9369b68f9980485b78,0,Andrew Kornev,2008-05-08 21:55:51+00:00,['a6bc7d54791e73b06083996ab57fdba9340ae1aa'],8,25,33,63396,2,,,,192
2c0bb45cc843dac34496fc9adf496ee371d7bf03,0,Andrew Kornev,2008-05-08 22:01:15+00:00,['03c7b1370bffacfdf9f9ce9369b68f9980485b78'],1,7,8,63404,1,,,,192
da0d48460b006bbc0eb345e8267cb63c917469b2,1,Andrew Kornev,2008-05-09 19:46:20+00:00,['2c0bb45cc843dac34496fc9adf496ee371d7bf03'],10,21,31,63435,1,,,,192
e1e8bffbc2f3bcb28cd59b4a54568c26cf92cc8e,1,Flavio Paiva Junqueira,2008-05-10 01:14:11+00:00,['da0d48460b006bbc0eb345e8267cb63c917469b2'],7296,7302,14598,78033,15,0.666666667,0.666666667,1,192
5347de99d0d1fdd1d41ffb02e69931eda5fa2342,1,Andrew Kornev,2008-05-12 21:36:39+00:00,['e1e8bffbc2f3bcb28cd59b4a54568c26cf92cc8e'],40,11,51,78084,1,0.727272727,0.545454545,0,192
942b970c4c29af6285d97ff92b00c815ff422f15,0,Andrew Kornev,2008-05-12 22:24:16+00:00,['5347de99d0d1fdd1d41ffb02e69931eda5fa2342'],17,15,32,78116,1,,,,192
ffce83512370e970426f7f6b7cff8f519de59bd4,1,Benjamin Reed,2008-05-12 23:01:25+00:00,['942b970c4c29af6285d97ff92b00c815ff422f15'],3545,3678,7223,85339,23,1,1,1,192
8427cf0581571d46ff7c00318f8158431288b7bf,0,,2008-05-12 23:20:17+00:00,['ffce83512370e970426f7f6b7cff8f519de59bd4'],1,1,2,85341,1,,,,192
e62cbf76806ad2a25d9714590108221ae681d1a6,0,,2008-05-12 23:20:59+00:00,['8427cf0581571d46ff7c00318f8158431288b7bf'],1,1,2,85343,1,,,,192
e2f182cf0c095784e205b5bd63d72c73d1258297,1,,2008-05-19 19:29:01+00:00,['e62cbf76806ad2a25d9714590108221ae681d1a6'],62,68,130,85473,16,0,0,0,192
4255d3fcd559e28423356ee702487ad4f9d612fd,0,,2008-05-30 20:07:08+00:00,['e2f182cf0c095784e205b5bd63d72c73d1258297'],1,0,1,85474,1,,,,192
f1dd874ed7ddd42f006600319dd5e896ed8ac349,1,Benjamin Reed,2008-06-03 15:51:18+00:00,['4255d3fcd559e28423356ee702487ad4f9d612fd'],0,2645,2645,88119,42,0.905491699,0.96807152,0.910600255,234
40823446fb2530bf8c4866ae52ebbe4134a42b3b,1,Benjamin Reed,2008-06-03 18:52:01+00:00,['f1dd874ed7ddd42f006600319dd5e896ed8ac349'],5,22,27,88146,1,0,0.636363636,0.818181818,234
23e39b5a8797d2be1b1ed0420d67f26983887c84,1,Benjamin Reed,2008-06-06 19:01:57+00:00,['40823446fb2530bf8c4866ae52ebbe4134a42b3b'],142,422,564,88710,5,0.088050314,0.490566038,0.496855346,234
ed69411798bdf385610d0c6f5e2f303607b1e96e,0,Benjamin Reed,2008-06-06 19:05:25+00:00,['23e39b5a8797d2be1b1ed0420d67f26983887c84'],0,1,1,88711,1,,,,234
083aaac1bb6f2d56f1034ca6c53e7c5cb4115c5a,0,Patrick D. Hunt,2008-06-24 16:55:54+00:00,['ed69411798bdf385610d0c6f5e2f303607b1e96e'],0,0,0,88711,229,,,,234
8e1a54aab8958b30552c46febbc82fa3fa2083b2,0,Patrick D. Hunt,2008-06-24 16:57:33+00:00,['083aaac1bb6f2d56f1034ca6c53e7c5cb4115c5a'],0,0,0,88711,0,,,,234
03f3e5f76692d134f630be726557120ee8706212,0,Patrick D. Hunt,2008-06-24 17:00:42+00:00,['8e1a54aab8958b30552c46febbc82fa3fa2083b2'],0,0,0,88711,98,,,,234
9e8ffe581c1489ce7166508423be1ebea422ef07,0,Patrick D. Hunt,2008-06-24 17:02:41+00:00,['03f3e5f76692d134f630be726557120ee8706212'],0,0,0,88711,0,,,,234
be031cb42c842f5c5362b2333b6155f4985000fc,0,Patrick D. Hunt,2008-06-24 17:04:36+00:00,['9e8ffe581c1489ce7166508423be1ebea422ef07'],0,0,0,88711,219,,,,234
9fadd70f4bc235047d1dfda998f71df3264258c4,0,Patrick D. Hunt,2008-06-24 17:05:37+00:00,['be031cb42c842f5c5362b2333b6155f4985000fc'],0,0,0,88711,1,,,,234
47b8275402b3c9daa19f67aa42000ea7b0fbf0ce,0,Patrick D. Hunt,2008-06-24 17:08:42+00:00,['9fadd70f4bc235047d1dfda998f71df3264258c4'],0,2,2,88713,3,,,,235
daa66b7c180c4342ce7acc7b595106fa3a49a12d,0,Patrick D. Hunt,2008-06-24 17:13:40+00:00,['47b8275402b3c9daa19f67aa42000ea7b0fbf0ce'],0,0,0,88713,98,,,,235
67c653cf38015db23940c4229ea66509cbd2b2be,0,Patrick D. Hunt,2008-06-24 17:14:30+00:00,['daa66b7c180c4342ce7acc7b595106fa3a49a12d'],0,0,0,88713,98,,,,235
94ea75adeca9109d127735fd00138e530770552c,0,Patrick D. Hunt,2008-06-24 17:15:20+00:00,['67c653cf38015db23940c4229ea66509cbd2b2be'],0,0,0,88713,15,,,,235
f1e02be300aee5e0174419526c697b5bdf7da4eb,0,Patrick D. Hunt,2008-06-24 17:16:01+00:00,['94ea75adeca9109d127735fd00138e530770552c'],0,0,0,88713,15,,,,235
1da34580995bbce1cc56d2a7f822aa55e169670c,0,Patrick D. Hunt,2008-06-24 17:35:12+00:00,['f1e02be300aee5e0174419526c697b5bdf7da4eb'],0,0,0,88713,42,,,,235
98b153609b00157bb02ba75814f49a9bd46dc26d,0,Patrick D. Hunt,2008-06-24 17:35:31+00:00,['1da34580995bbce1cc56d2a7f822aa55e169670c'],0,0,0,88713,42,,,,235
cfd2ecb8d049c1b51b2c1e6d5fd02edd5d3c26e8,1,Patrick D. Hunt,2008-06-24 18:20:47+00:00,['98b153609b00157bb02ba75814f49a9bd46dc26d'],722,1253,1975,90688,160,0.26541555,1,1,237
b4b73a37d43413efdf50427f96aab2720af11baf,0,Patrick D. Hunt,2008-06-24 18:56:38+00:00,['cfd2ecb8d049c1b51b2c1e6d5fd02edd5d3c26e8'],755,1012,1767,92455,128,,,,237
0a81c16c4c921ef52179b943dd046fc72022ccc6,0,Patrick D. Hunt,2008-06-24 19:04:58+00:00,['b4b73a37d43413efdf50427f96aab2720af11baf'],4660,4660,9320,101775,20,,,,237
24cf7ed95245ed6f442281680d8415ad087f742b,0,Patrick D. Hunt,2008-06-24 19:19:02+00:00,['0a81c16c4c921ef52179b943dd046fc72022ccc6'],758,758,1516,103291,5,,,,237
b6f0e5d5e0baf59038ac4381229437607746069a,0,Patrick D. Hunt,2008-06-24 19:25:25+00:00,['24cf7ed95245ed6f442281680d8415ad087f742b'],0,0,0,103291,49,,,,237
7e05816a5e02f6c1c9f3d470e0a23e980c51bd86,0,Patrick D. Hunt,2008-06-24 19:34:22+00:00,['b6f0e5d5e0baf59038ac4381229437607746069a'],0,0,0,103291,5,,,,237
2fe9f3757664cef42a7ba17f932a94aad6f02e9a,0,Patrick D. Hunt,2008-06-25 21:30:04+00:00,['7e05816a5e02f6c1c9f3d470e0a23e980c51bd86'],0,5,5,103296,1,,,,237
920bd81fef8128e6f1bb5c59b8a7e36b1211fd87,0,Mahadev Konar,2008-06-25 23:06:01+00:00,['2fe9f3757664cef42a7ba17f932a94aad6f02e9a'],1,1,2,103298,1,1,1,1,237
bbda35fa6599b2b2931a052f38997d78c3e8deba,0,Patrick D. Hunt,2008-06-26 16:51:37+00:00,['920bd81fef8128e6f1bb5c59b8a7e36b1211fd87'],1,1,2,103300,1,,,,237
1d2a7863133cce103cb1784f704fac31169db29a,0,Andrew Kornev,2008-06-26 23:47:24+00:00,['bbda35fa6599b2b2931a052f38997d78c3e8deba'],11,11,22,103322,1,,,,237
7a56a8f5e57ff35f1076a5a45b10f358154227cb,0,Patrick D. Hunt,2008-06-28 00:13:26+00:00,['1d2a7863133cce103cb1784f704fac31169db29a'],4,4,8,103330,1,,1,,237
88b5498a96cdbefc3d1ec66d28e2d1e680b2cada,0,Patrick D. Hunt,2008-06-30 22:49:02+00:00,['7a56a8f5e57ff35f1076a5a45b10f358154227cb'],0,63,63,103393,4,,,,237
33e143dd200dd67984d6a83fb58e0eebca4c3c97,1,Mahadev Konar,2008-07-03 21:30:36+00:00,['88b5498a96cdbefc3d1ec66d28e2d1e680b2cada'],3,3,6,103399,1,,,,237
0da7e6a3a699284df263484496fa16ca0f67e32a,0,Mahadev Konar,2008-07-07 23:02:21+00:00,['33e143dd200dd67984d6a83fb58e0eebca4c3c97'],1,1,2,103401,1,,,,237
31d99a300ad9b0c66905333c7775321a58345ed6,0,Patrick D. Hunt,2008-07-15 23:49:31+00:00,['0da7e6a3a699284df263484496fa16ca0f67e32a'],329,625,954,104355,36,,,,240
f1f13a3719ffa1dfd3572b8db0b8a41a054599d0,0,Patrick D. Hunt,2008-07-16 18:38:39+00:00,['31d99a300ad9b0c66905333c7775321a58345ed6'],15,15,30,104385,1,,,,240
9ab335fc924a1267638f7311721dafb104604fd5,1,Patrick D. Hunt,2008-07-22 17:59:18+00:00,['f1f13a3719ffa1dfd3572b8db0b8a41a054599d0'],8,4454,4462,108847,79,0.800833333,0.824166667,0.919166667,318
05ae54b104502bbaac97d0bb1d09616646fed6c3,0,Andrew Kornev,2008-07-22 19:38:54+00:00,['9ab335fc924a1267638f7311721dafb104604fd5'],1,1,2,108849,1,,,,318
2bba284640acecb5794c4f0f9be8ae66e645c7eb,1,Andrew Kornev,2008-07-24 21:46:30+00:00,['05ae54b104502bbaac97d0bb1d09616646fed6c3'],137,3507,3644,112493,24,0.403706155,0.884844474,0.802779616,330
ab761fc1b371c7e3039784c918693025a0052b9b,1,Patrick D. Hunt,2008-07-25 21:19:47+00:00,['2bba284640acecb5794c4f0f9be8ae66e645c7eb'],63,88,151,112644,8,1,1,0.75,330
dcb4215e8a27f66f92a48c2d35e6e1ac454deccb,0,Flavio Paiva Junqueira,2008-07-26 12:14:38+00:00,['ab761fc1b371c7e3039784c918693025a0052b9b'],0,6,6,112650,1,0,0,1,330
774bda809bf4c17941eacddccf6298d57f1737a9,0,Mahadev Konar,2008-07-28 18:19:53+00:00,['dcb4215e8a27f66f92a48c2d35e6e1ac454deccb'],37,43,80,112730,2,0,0,1,330
3740b7c730e6e4ccccd78c35694689292bca4ddb,1,Patrick D. Hunt,2008-07-31 20:10:24+00:00,['774bda809bf4c17941eacddccf6298d57f1737a9'],5,69,74,112804,3,0.057692308,0.903846154,1,330
41eaa5741eb749f8a32a17c33c2828f422a551d3,0,Patrick D. Hunt,2008-07-31 21:22:33+00:00,['3740b7c730e6e4ccccd78c35694689292bca4ddb'],2,2,4,112808,1,,,,330
dbd65f592ba1398b9b8ac371917cb2b9e65eaff2,1,Mahadev Konar,2008-08-02 00:07:30+00:00,['41eaa5741eb749f8a32a17c33c2828f422a551d3'],4,50,54,112862,4,0,1,1,330
8a22ee2a08d3d00a2085459c5f1941648a12ec98,1,Mahadev Konar,2008-08-07 20:34:41+00:00,['dbd65f592ba1398b9b8ac371917cb2b9e65eaff2'],22,40,62,112924,6,0.428571429,0.142857143,0.857142857,330
0cb68e84c1f8c1ebb3a6a2711042cb610bcf4eff,0,Mahadev Konar,2008-08-07 20:35:37+00:00,['8a22ee2a08d3d00a2085459c5f1941648a12ec98'],0,6,6,112930,1,,,,331
509ded419f592b49d0886bdc30a27fe5b8560a3a,0,Flavio Paiva Junqueira,2008-08-08 17:57:58+00:00,['0cb68e84c1f8c1ebb3a6a2711042cb610bcf4eff'],34,93,127,113057,4,0,0.872727273,0.854545455,331
4f99cd940ce2fa57ee12daafbd7968e2c925a05b,1,Patrick D. Hunt,2008-08-09 05:02:12+00:00,['509ded419f592b49d0886bdc30a27fe5b8560a3a'],0,114,114,113171,1,0.52,0.52,0.74,332
6810b0a75be66b9f585d213735bb727760ad951d,1,Mahadev Konar,2008-08-13 17:58:59+00:00,['4f99cd940ce2fa57ee12daafbd7968e2c925a05b'],0,8730,8730,121901,17,0.328917051,0.636520737,0.739631336,349
b19a117b066ed405d0b8ee5c76e6f2ef3bebfe99,1,Mahadev Konar,2008-08-13 21:10:30+00:00,['6810b0a75be66b9f585d213735bb727760ad951d'],7,83,90,121991,1,,,,349
ed70d2edcb78a7e30ae60170ea986fb85e862b4b,1,Mahadev Konar,2008-08-15 17:15:10+00:00,['b19a117b066ed405d0b8ee5c76e6f2ef3bebfe99'],434,959,1393,123384,18,0.642424242,0.896969697,1,354
1ca4ea0540f3e313037d473b7cbdbcb45ea51f39,1,Andrew Kornev,2008-08-15 18:00:17+00:00,['ed70d2edcb78a7e30ae60170ea986fb85e862b4b'],427,57,484,123868,15,,,,356
435bc0ff5db851d341c373bc515f6a618691e6c4,1,Mahadev Konar,2008-08-15 22:02:28+00:00,['1ca4ea0540f3e313037d473b7cbdbcb45ea51f39'],477,997,1474,125342,33,0.349264706,0.360294118,0.941176471,356
a07a03d70b56ab26f4a790ef1e9941a06b478b84,0,Mahadev Konar,2008-08-19 17:58:30+00:00,['435bc0ff5db851d341c373bc515f6a618691e6c4'],2,7,9,125351,2,0,0,1,356
92c538d4d830d61fcaa4346c356e63d8f23bd2f3,0,Mahadev Konar,2008-08-25 18:16:45+00:00,['a07a03d70b56ab26f4a790ef1e9941a06b478b84'],2,5,7,125358,3,,,,356
3a6a4ba7fc538f066d7b691777320fb9b92a5f93,1,Mahadev Konar,2008-08-25 21:13:01+00:00,['92c538d4d830d61fcaa4346c356e63d8f23bd2f3'],48,172,220,125578,7,0.636363636,0.636363636,1,356
fb8c9be9aa0fde315cdd5a321f7da6c97fd7867c,0,Mahadev Konar,2008-08-27 05:12:19+00:00,['3a6a4ba7fc538f066d7b691777320fb9b92a5f93'],20,3,23,125601,3,,,,356
b7ebe2b67b6b29df0bbce88e3b49f831b2973c43,0,Mahadev Konar,2008-08-27 19:03:21+00:00,['fb8c9be9aa0fde315cdd5a321f7da6c97fd7867c'],2,25,27,125628,1,,,,356
e3e0db789177a2e77882545dbdd9eed9a23eb392,1,Benjamin Reed,2008-08-27 23:36:40+00:00,['b7ebe2b67b6b29df0bbce88e3b49f831b2973c43'],209,486,695,126323,10,0.484662577,0.932515337,0.650306748,356
4cdb4305ad4acd8189b4f771b30f05d4cf68703e,1,Benjamin Reed,2008-09-04 17:02:09+00:00,['e3e0db789177a2e77882545dbdd9eed9a23eb392'],97,137,234,126557,39,0.03030303,0,0.727272727,356
d80631f8e7bd447e684998fd59d19ef92b1f2b80,0,Benjamin Reed,2008-09-05 14:39:28+00:00,['4cdb4305ad4acd8189b4f771b30f05d4cf68703e'],22,150,172,126729,2,0.060240964,0.060240964,1,356
ada5b36e3683aadd061a9e3578c9b693f0b050ab,1,Benjamin Reed,2008-09-05 20:20:20+00:00,['d80631f8e7bd447e684998fd59d19ef92b1f2b80'],0,665,665,127394,2,1,1,0.896648045,358
a6078d424766ba7ca60821ae802f3acb9e2c7758,1,Benjamin Reed,2008-09-05 20:30:49+00:00,['ada5b36e3683aadd061a9e3578c9b693f0b050ab'],93,150,243,127637,4,0.785714286,1,0,359
931322a7c7287a715b4aa7046d4af4f42ddd5cd3,1,Patrick D. Hunt,2008-09-08 16:55:56+00:00,['a6078d424766ba7ca60821ae802f3acb9e2c7758'],95,269,364,128001,19,0.696969697,0.984848485,0.878787879,361
853eb9d897af76fcaf221270776614f171abb699,0,Patrick D. Hunt,2008-09-09 17:52:52+00:00,['931322a7c7287a715b4aa7046d4af4f42ddd5cd3'],0,7,7,128008,1,,,,361
1ff83d62d0464a0c21a711b2cadd549119c716ab,0,Patrick D. Hunt,2008-09-09 17:56:19+00:00,['853eb9d897af76fcaf221270776614f171abb699'],1,9,10,128018,2,,,,361
217107e26bef95aeb8f669013e03191406b9c7ee,1,Mahadev Konar,2008-09-10 17:49:26+00:00,['1ff83d62d0464a0c21a711b2cadd549119c716ab'],76,378,454,128472,12,,,,365
3553137b9a7e8d804fdb378be23196a74afaf731,1,Mahadev Konar,2008-09-19 01:24:25+00:00,['217107e26bef95aeb8f669013e03191406b9c7ee'],8,170,178,128650,5,0.152380952,0.152380952,0.952380952,366
d1fa7aa702b4c9474ecbed78da9f8ca0638b6d04,1,Benjamin Reed,2008-09-24 21:05:26+00:00,['3553137b9a7e8d804fdb378be23196a74afaf731'],75,114,189,128839,3,0.096774194,0.741935484,0,366
ad90e3700bd147bcec1691e51d40a09b43a82f8a,0,Benjamin Reed,2008-09-24 21:12:26+00:00,['d1fa7aa702b4c9474ecbed78da9f8ca0638b6d04'],0,160,160,128999,2,0.181818182,1,1,368
d284d6fdae9c826bea44414a4f8f7b811eb0657f,1,Benjamin Reed,2008-09-24 21:27:50+00:00,['ad90e3700bd147bcec1691e51d40a09b43a82f8a'],20,60,80,129079,2,0.3,1,1,368
f813b6394afc39bed4fca20568e7baf20c4dc7c0,1,Patrick D. Hunt,2008-09-25 01:05:14+00:00,['d284d6fdae9c826bea44414a4f8f7b811eb0657f'],77,11590,11667,140746,37,,,,397
9398146ee65f798983a9938fb515620fdeb7da1b,0,Patrick D. Hunt,2008-09-25 21:35:59+00:00,['f813b6394afc39bed4fca20568e7baf20c4dc7c0'],4,7,11,140757,1,,,,397
d349e7bd5ec70f62f75c6bd3c986fcd29e1b3a4c,1,Patrick D. Hunt,2008-09-25 22:25:28+00:00,['9398146ee65f798983a9938fb515620fdeb7da1b'],188,535,723,141480,26,0.992248062,0.821705426,0.953488372,401
4bf4f51660154b8a02cd703acbf392b137387428,0,Patrick D. Hunt,2008-09-25 22:57:25+00:00,['d349e7bd5ec70f62f75c6bd3c986fcd29e1b3a4c'],2,24,26,141506,1,,,,401
ad482ad24cc864686f268b71896606091d92a00f,1,Patrick D. Hunt,2008-09-26 18:09:25+00:00,['4bf4f51660154b8a02cd703acbf392b137387428'],151,168,319,141825,13,,,,401
c92694d86f381164dc73251af3060d48ef03ec16,1,Flavio Paiva Junqueira,2008-09-30 11:14:17+00:00,['ad482ad24cc864686f268b71896606091d92a00f'],290,228,518,142343,18,0,1,0,401
acfce8b8fc08928097572c261980e7ccb6d041a7,1,Patrick D. Hunt,2008-10-01 02:47:54+00:00,['c92694d86f381164dc73251af3060d48ef03ec16'],7,17,24,142367,4,0.833333333,0.833333333,1,401
0254f868ca34105308ac3524c73111d8d770091e,1,Benjamin Reed,2008-10-01 06:26:47+00:00,['acfce8b8fc08928097572c261980e7ccb6d041a7'],999,1887,2886,145253,35,1,1,0.18452381,409
0c6294e6cab2befc330b8a5c05ceeb156550c2fe,1,Benjamin Reed,2008-10-01 08:40:02+00:00,['0254f868ca34105308ac3524c73111d8d770091e'],414,515,929,146182,16,0.257575758,0.227272727,1,410
67c4e4533d0762ebb4cb77976df12304705fecb1,0,Patrick D. Hunt,2008-10-01 19:05:48+00:00,['0c6294e6cab2befc330b8a5c05ceeb156550c2fe'],37,9,46,146228,2,1,1,0,410
e148a40f5fc5bbd3fcb71d1e72db9a2f5c49d441,1,Patrick D. Hunt,2008-10-01 22:28:35+00:00,['67c4e4533d0762ebb4cb77976df12304705fecb1'],899,995,1894,148122,17,,,,411
ea54ef0825c6670cc6714e749d391f477420b118,1,Flavio Paiva Junqueira,2008-10-03 13:06:39+00:00,['e148a40f5fc5bbd3fcb71d1e72db9a2f5c49d441'],146,242,388,148510,20,0.819277108,0.108433735,1,412
4983f6dc5fd04081d5320f8a9db3b65498bf8c2a,1,Patrick D. Hunt,2008-10-03 23:22:21+00:00,['ea54ef0825c6670cc6714e749d391f477420b118'],22,42,64,148574,2,,,,412
d4abdba5438f5ffe00f415803a7261d58f0b7ae2,1,Patrick D. Hunt,2008-10-03 23:35:27+00:00,['4983f6dc5fd04081d5320f8a9db3b65498bf8c2a'],1365,1978,3343,151917,21,,,,412
3fd36ef74684e63eb69b10ac51e2970a1f0cdc02,0,Flavio Paiva Junqueira,2008-10-05 09:45:00+00:00,['d4abdba5438f5ffe00f415803a7261d58f0b7ae2'],2,0,2,151919,1,1,1,0,412
ff98502017f564c14008f5e55ba536bef7d60b78,1,Patrick D. Hunt,2008-10-07 18:51:49+00:00,['3fd36ef74684e63eb69b10ac51e2970a1f0cdc02'],438,727,1165,153084,10,0.31292517,1,1,413
109a15859be9184ab677c8db371084535e412212,1,Patrick D. Hunt,2008-10-08 18:00:33+00:00,['ff98502017f564c14008f5e55ba536bef7d60b78'],17,63,80,153164,3,0.869565217,0.869565217,0.739130435,413
8d30c6ed4e4e61f38b6eb6650f06a4d33038b1a9,1,Patrick D. Hunt,2008-10-08 18:17:52+00:00,['109a15859be9184ab677c8db371084535e412212'],609,731,1340,154504,4,,,,413
e04d55aa14c04ce90fdb0b7414c1fbfcbdaeb3a6,1,Patrick D. Hunt,2008-10-08 18:50:32+00:00,['8d30c6ed4e4e61f38b6eb6650f06a4d33038b1a9'],997,1446,2443,156947,4,,,,413
03f0f816dc7fdc5e767a8c8989b872b2b9ad36e1,1,Patrick D. Hunt,2008-10-10 13:58:03+00:00,['e04d55aa14c04ce90fdb0b7414c1fbfcbdaeb3a6'],435,6532,6967,163914,30,,,,424
d5a39f2c4ce1b162dd5c286217fda1cf40328365,0,Patrick D. Hunt,2008-10-10 22:56:37+00:00,['03f0f816dc7fdc5e767a8c8989b872b2b9ad36e1'],7,15,22,163936,2,,,,424
d768ace716fcf01e9f699355ec8e6876d0a2a9bf,1,Benjamin Reed,2008-10-10 23:15:55+00:00,['d5a39f2c4ce1b162dd5c286217fda1cf40328365'],0,15,15,163951,2,0,0,1,424
1d4a9521a4e6bce8f0346b000bf96856ccd5dfe7,1,Flavio Paiva Junqueira,2008-10-14 16:44:58+00:00,['d768ace716fcf01e9f699355ec8e6876d0a2a9bf'],40,168,208,164159,1,0.225806452,0.225806452,1,424
0bc7d41e3f15f02c81d63cc8fcf0f373ee867327,1,Mahadev Konar,2008-10-14 17:47:54+00:00,['1d4a9521a4e6bce8f0346b000bf96856ccd5dfe7'],36,319,355,164514,13,0.519736842,0.973684211,0.986842105,425
217fddb4b4a131fac932a65bcc45819e39fb35c4,0,Patrick D. Hunt,2008-10-14 20:09:57+00:00,['0bc7d41e3f15f02c81d63cc8fcf0f373ee867327'],0,35,35,164549,2,0.870967742,0.870967742,0.870967742,425
a673b0e0cd085b340d451169fe5bfced9a162955,0,Patrick D. Hunt,2008-10-14 20:17:30+00:00,['217fddb4b4a131fac932a65bcc45819e39fb35c4'],1,7,8,164557,2,,,,425
f15c156be0ac92b252882be6d9e15058882ecfd9,0,Patrick D. Hunt,2008-10-14 20:28:59+00:00,['a673b0e0cd085b340d451169fe5bfced9a162955'],0,21,21,164578,3,,,,425
e99350dc11fb37dc17c92ffb95113a3a607d84b6,1,Patrick D. Hunt,2008-10-14 21:09:46+00:00,['f15c156be0ac92b252882be6d9e15058882ecfd9'],2,102,104,164682,3,0.142857143,0.142857143,1,425
a23407ddefacba9cb899770c960a77133c6fa1a6,1,Patrick D. Hunt,2008-10-14 23:45:12+00:00,['e99350dc11fb37dc17c92ffb95113a3a607d84b6'],8,11,19,164701,2,,,,425
c6f2e6f797888f932f46e95780a3fe1def2e5d88,1,Patrick D. Hunt,2008-10-15 04:04:40+00:00,['a23407ddefacba9cb899770c960a77133c6fa1a6'],207,512,719,165420,15,,,,425
504b19774fab868fdd1d4fedad24b4664bd92aa7,0,Patrick D. Hunt,2008-10-15 04:05:04+00:00,['c6f2e6f797888f932f46e95780a3fe1def2e5d88'],0,3,3,165423,1,,,,425
0598b1e581dd526b225166ca3704597126c778c3,1,Patrick D. Hunt,2008-10-15 16:15:54+00:00,['504b19774fab868fdd1d4fedad24b4664bd92aa7'],67,1210,1277,166700,19,,,,428
337205755c5b7935fbec6a07687224528f20e687,0,Patrick D. Hunt,2008-10-15 16:17:36+00:00,['0598b1e581dd526b225166ca3704597126c778c3'],0,3,3,166703,2,,,,428
b8c2b821273184a67c9e063a8d393de663b5f032,1,Patrick D. Hunt,2008-10-16 20:09:15+00:00,['337205755c5b7935fbec6a07687224528f20e687'],877,833,1710,168413,7,,,,428
846ccb53d3816d009c38167b52d569814f45be8d,1,Patrick D. Hunt,2008-10-16 21:55:22+00:00,['b8c2b821273184a67c9e063a8d393de663b5f032'],429,461,890,169303,10,,,,428
505d23b4951a5444b8831e13bd66154ac7592c16,0,Patrick D. Hunt,2008-10-16 22:31:23+00:00,['846ccb53d3816d009c38167b52d569814f45be8d'],390,395,785,170088,10,,,,428
82627a641750383bc7380c568291839bbea5c26e,1,Patrick D. Hunt,2008-10-17 00:21:43+00:00,['505d23b4951a5444b8831e13bd66154ac7592c16'],12,1455,1467,171555,14,0.432679739,0.687581699,0.813071895,434
29b1362f15115ce31b420cc6cf6e0aa2f041443e,0,Patrick D. Hunt,2008-10-17 00:23:26+00:00,['82627a641750383bc7380c568291839bbea5c26e'],0,0,0,171555,4,,,,438
60808e0a7312525e2d3dfb82c5535582d1de391b,0,Patrick D. Hunt,2008-10-20 21:07:27+00:00,['29b1362f15115ce31b420cc6cf6e0aa2f041443e'],1,31,32,171587,3,,,,438
04ac2dc3e5527cd144c8fb0aa05e8747342d01d0,1,Patrick D. Hunt,2008-10-21 04:26:20+00:00,['60808e0a7312525e2d3dfb82c5535582d1de391b'],5,181,186,171773,4,0.175824176,0.406593407,0.945054945,439
c6acf2c2e3504b057195e434791dc5a60a80f5fe,1,Patrick D. Hunt,2008-10-21 04:36:28+00:00,['04ac2dc3e5527cd144c8fb0aa05e8747342d01d0'],5,7,12,171785,3,,,,439
4a1154ac082506a3269e47e51ff2f600b6d28d07,1,Patrick D. Hunt,2008-10-21 17:30:07+00:00,['c6acf2c2e3504b057195e434791dc5a60a80f5fe'],10,15,25,171810,3,,,,439
a79aaf38e4842f419269bdebf3bd1409bac81f7e,0,Patrick D. Hunt,2008-10-21 18:45:20+00:00,['4a1154ac082506a3269e47e51ff2f600b6d28d07'],2,14,16,171826,3,1,1,0.444444444,439
30c3c0eb55026bf73c6c6a87fe662ba458f67233,1,Mahadev Konar,2008-10-21 23:49:45+00:00,['a79aaf38e4842f419269bdebf3bd1409bac81f7e'],105,496,601,172427,18,0.389078498,0.372013652,0.494880546,439
80bfbf64a90e3461b6493756d63582e78514c682,1,Patrick D. Hunt,2008-10-22 00:13:54+00:00,['30c3c0eb55026bf73c6c6a87fe662ba458f67233'],91,280,371,172798,4,,,,439
5d56e6d2ead954483041a74112a69fb89a01199e,1,Patrick D. Hunt,2008-10-22 01:22:06+00:00,['80bfbf64a90e3461b6493756d63582e78514c682'],1022,1397,2419,175217,27,0.495192308,0.634615385,0.394230769,441
b4c58ed802c16bd4f12b5be330911050efc9c89a,1,Patrick D. Hunt,2008-10-22 01:26:36+00:00,['5d56e6d2ead954483041a74112a69fb89a01199e'],187,317,504,175721,4,,,,441
aa7d3d3a8a632e3da9a1180e2552da9e097cc80e,1,Patrick D. Hunt,2008-10-22 03:47:09+00:00,['b4c58ed802c16bd4f12b5be330911050efc9c89a'],39,41,80,175801,4,,,,441
e94f36ed85117ab05620479b406259ddb3dcd5b6,1,Patrick D. Hunt,2008-10-22 05:43:14+00:00,['aa7d3d3a8a632e3da9a1180e2552da9e097cc80e'],91,3969,4060,179861,4,,,,441
02af24921e1a1b95fc45cdb6ec54291fd3bc7a8d,0,Patrick D. Hunt,2008-10-22 05:48:26+00:00,['e94f36ed85117ab05620479b406259ddb3dcd5b6'],1,11,12,179873,2,,,,441
2f78a5741dcdf106377a927d7cf354685136a172,0,Mahadev Konar,2008-11-17 16:13:31+00:00,['02af24921e1a1b95fc45cdb6ec54291fd3bc7a8d'],4,5,9,179882,2,,,,441
f7673ae440408e4107c3a7874caf3e4df91b078c,1,Mahadev Konar,2008-11-17 23:18:47+00:00,['2f78a5741dcdf106377a927d7cf354685136a172'],6,85,91,179973,3,0.12244898,0.714285714,1,442
6866b0724ee627783831db770cc9e3ffe34efe77,1,Mahadev Konar,2008-11-17 23:48:37+00:00,['f7673ae440408e4107c3a7874caf3e4df91b078c'],562,780,1342,181315,4,,,,442
128807c962823b32bfd3f2872de1e3714b1e92f4,0,Mahadev Konar,2008-11-18 00:11:13+00:00,['6866b0724ee627783831db770cc9e3ffe34efe77'],33,36,69,181384,2,,,,442
53b690967c97dd30d463f69653c9dccdd7502c3d,1,Mahadev Konar,2008-11-18 17:22:05+00:00,['128807c962823b32bfd3f2872de1e3714b1e92f4'],138,153,291,181675,7,0,1,1,442
fa7764c88b063a672b48ec341b9e4a6d958cdce2,0,Mahadev Konar,2008-11-18 20:10:57+00:00,['53b690967c97dd30d463f69653c9dccdd7502c3d'],0,20,20,181695,2,,,,442
5bd5d2d7861c68e0f4bae5255ea49b89d936a88c,0,Mahadev Konar,2008-11-18 23:11:23+00:00,['fa7764c88b063a672b48ec341b9e4a6d958cdce2'],66,68,134,181829,4,,,,442
ebf6d1e106a94aeda223a70e5c8aaa6476526edb,0,Mahadev Konar,2008-11-18 23:30:58+00:00,['5bd5d2d7861c68e0f4bae5255ea49b89d936a88c'],97,61,158,181987,17,,,,442
1b7dbc1c523d4105899340b064f169e88a727081,0,Mahadev Konar,2008-11-18 23:42:22+00:00,['ebf6d1e106a94aeda223a70e5c8aaa6476526edb'],1,76,77,182064,3,0.428571429,1,0.892857143,443
4a9ba5da6e438dd2049325624c3f12f55a2de809,0,Patrick D. Hunt,2008-11-19 01:28:16+00:00,['1b7dbc1c523d4105899340b064f169e88a727081'],15,29,44,182108,5,0.375,0.375,1,443
3fcc62dae5f63a64f68b5d36f8d22e3ecf751a78,1,Mahadev Konar,2008-11-19 10:20:35+00:00,['4a9ba5da6e438dd2049325624c3f12f55a2de809'],88,225,313,182421,6,0.188888889,0.411111111,0.877777778,444
7070ea227a201d0b69c7da2a14cc54ed9bbd5428,1,Mahadev Konar,2008-11-19 20:47:22+00:00,['3fcc62dae5f63a64f68b5d36f8d22e3ecf751a78'],70,50,120,182541,3,1,0.161290323,0,444
b4051a04e10638546a04d51f280e47bed37c6964,0,Mahadev Konar,2008-11-19 20:52:11+00:00,['7070ea227a201d0b69c7da2a14cc54ed9bbd5428'],1,3,4,182545,2,,,,444
2ed749ffd1ae55ad8090890908fa2d3d1a64b20e,0,Mahadev Konar,2008-11-24 20:48:24+00:00,['b4051a04e10638546a04d51f280e47bed37c6964'],0,20,20,182565,2,,,,444
a399144537dfef4468a96971641bc372a3d8a76f,1,Mahadev Konar,2008-12-02 00:13:50+00:00,['2ed749ffd1ae55ad8090890908fa2d3d1a64b20e'],155,389,544,183109,11,0.181818182,0.555555556,0.95959596,445
4e482a0e8c2e79ea39ac98a422b604d5bd861250,0,Mahadev Konar,2008-12-09 05:09:48+00:00,['a399144537dfef4468a96971641bc372a3d8a76f'],2,9,11,183120,3,0,1,1,445
65fa4cc7188c14dcd5bc0cf3118c5997d1d28b5f,0,Mahadev Konar,2008-12-09 05:14:24+00:00,['4e482a0e8c2e79ea39ac98a422b604d5bd861250'],5,8,13,183133,2,,,,445
4ee7c1d3a904d164ff6f12c862043a03d98101bd,1,Mahadev Konar,2008-12-09 22:16:05+00:00,['65fa4cc7188c14dcd5bc0cf3118c5997d1d28b5f'],1,12,13,183146,2,0,0.625,0.625,445
c81e4c0214507b27fe9ae0ad0c78f0f5c7f79b76,1,Mahadev Konar,2008-12-09 22:28:49+00:00,['4ee7c1d3a904d164ff6f12c862043a03d98101bd'],465,500,965,184111,4,,,,445
679a561d009ff1220bebf172cadba4306efa7edd,1,Patrick D. Hunt,2008-12-10 00:11:48+00:00,['c81e4c0214507b27fe9ae0ad0c78f0f5c7f79b76'],384,613,997,185108,4,,,,445
b736d4372859b5778dfc329e3e60e5dc949768b1,1,Mahadev Konar,2008-12-10 00:22:17+00:00,['679a561d009ff1220bebf172cadba4306efa7edd'],792,1013,1805,186913,9,,,,445
9b1f7faa7902f0f3f5d8aa457b4c53ecb9155343,1,Mahadev Konar,2008-12-10 00:42:07+00:00,['b736d4372859b5778dfc329e3e60e5dc949768b1'],215,260,475,187388,4,,,,445
9f7759d73f44901226873cdf2da685877fa06f62,0,Patrick D. Hunt,2008-12-10 21:55:21+00:00,['9b1f7faa7902f0f3f5d8aa457b4c53ecb9155343'],3,101,104,187492,5,0.153846154,0.948717949,1,446
2e135ab9287f8babeeeddcfb7cd362f4d2b4278f,1,Patrick D. Hunt,2008-12-11 21:16:41+00:00,['9f7759d73f44901226873cdf2da685877fa06f62'],5,130,135,187627,5,0.301886792,0.547169811,1,447
e08ffda1b82a1f2e6232c6140fe38976c291e2fb,1,Mahadev Konar,2008-12-12 20:21:30+00:00,['2e135ab9287f8babeeeddcfb7cd362f4d2b4278f'],117,151,268,187895,3,1,1,1,447
b833f9d0431ed1629ce018e0c29c03cf3c94b618,1,Mahadev Konar,2008-12-13 00:27:22+00:00,['e08ffda1b82a1f2e6232c6140fe38976c291e2fb'],1,24,25,187920,3,0.470588235,0.470588235,0,447
790028113fe38b012682fddcc1fc467b8367fdee,0,Mahadev Konar,2008-12-15 22:36:25+00:00,['b833f9d0431ed1629ce018e0c29c03cf3c94b618'],2,23,25,187945,2,0,1,1,447
10d8d9cf50040f100b0d2eedaae9fc263b06133d,1,Mahadev Konar,2008-12-22 21:39:46+00:00,['790028113fe38b012682fddcc1fc467b8367fdee'],9,29,38,187983,6,0,0.866666667,0.066666667,447
88fab67e8bf006e10f23db1ae7059cb4c516a4a8,1,Mahadev Konar,2008-12-22 22:23:32+00:00,['10d8d9cf50040f100b0d2eedaae9fc263b06133d'],393,695,1088,189071,25,0.8,0.828571429,0.885714286,447
97af9cc16773e4cb932cff42b460db1b7b67e2d3,0,Mahadev Konar,2008-12-22 22:27:16+00:00,['88fab67e8bf006e10f23db1ae7059cb4c516a4a8'],508,548,1056,190127,2,,,,447
950586dc900653ecd2521291c76ba01084c7d2da,1,Mahadev Konar,2008-12-22 23:47:51+00:00,['97af9cc16773e4cb932cff42b460db1b7b67e2d3'],8,92,100,190227,4,0,1,1,448
2f3b513b446775563ace5f96803ca8cbf8e2d4f9,1,Mahadev Konar,2008-12-23 21:29:28+00:00,['950586dc900653ecd2521291c76ba01084c7d2da'],98,155,253,190480,7,0.142857143,0.142857143,1,448
5de5a6e6134892e4ab4b69818794f5c57dd79638,0,Mahadev Konar,2009-01-08 21:21:07+00:00,['2f3b513b446775563ace5f96803ca8cbf8e2d4f9'],1,22,23,190503,2,,,,448
dac9e075ec7325e401d88895a6d5fe12a61a738c,0,Mahadev Konar,2009-01-08 21:40:55+00:00,['5de5a6e6134892e4ab4b69818794f5c57dd79638'],179,190,369,190872,4,,,,448
1b86be3fcfea56f9b2c9dc2f384ad1d7953e6b92,1,Mahadev Konar,2009-01-08 22:32:00+00:00,['dac9e075ec7325e401d88895a6d5fe12a61a738c'],16,308,324,191196,8,0.295081967,0.295081967,0.918032787,452
da1e988798fd0336a893e16e94d699e6b156c941,1,Patrick D. Hunt,2009-01-15 22:57:14+00:00,['1b86be3fcfea56f9b2c9dc2f384ad1d7953e6b92'],2398,991,3389,194585,82,0.126760563,0,0.174647887,454
c6639c9842973a7954c8baa412d6825cb833d51f,1,Benjamin Reed,2009-01-15 23:48:24+00:00,['da1e988798fd0336a893e16e94d699e6b156c941'],212,231,443,195028,28,0,0,0.944444444,454
df8aabde05bed21954c3c48599292f9c92ec9f5a,1,Benjamin Reed,2009-01-22 15:29:11+00:00,['c6639c9842973a7954c8baa412d6825cb833d51f'],4,13,17,195045,4,,,,454
b17e881ff0e6fa9ce0ab5063c3a390fda782e752,0,Mahadev Konar,2009-01-26 17:56:22+00:00,['df8aabde05bed21954c3c48599292f9c92ec9f5a'],1,16,17,195062,3,,,,454
f340e569fe7c33985298397d31b89638a397bf19,0,Mahadev Konar,2009-01-26 19:21:38+00:00,['b17e881ff0e6fa9ce0ab5063c3a390fda782e752'],11,57,68,195130,3,0.916666667,0.916666667,1,455
e5b90d600c69107da88d1758c1e66eba7cc1abad,1,Benjamin Reed,2009-01-28 00:15:33+00:00,['f340e569fe7c33985298397d31b89638a397bf19'],709,789,1498,196628,12,0.857142857,0.857142857,0.828571429,455
8ad773d7da9f1802e2868207772b1ce1226d9a36,0,Benjamin Reed,2009-01-28 00:21:54+00:00,['e5b90d600c69107da88d1758c1e66eba7cc1abad'],457,500,957,197585,6,,,,455
8246ad6559d020e2eb8f6d5cc0d2914863d7c744,1,Mahadev Konar,2009-01-28 00:42:16+00:00,['8ad773d7da9f1802e2868207772b1ce1226d9a36'],580,1737,2317,199902,22,,,,458
578be33d4f175e650ea3794d45ba8ff85de8db89,1,Mahadev Konar,2009-01-28 00:46:59+00:00,['8246ad6559d020e2eb8f6d5cc0d2914863d7c744'],142,181,323,200225,4,,,,458
7d8d199a4662ab710c8f3a12745b86dbdb4c7520,1,Mahadev Konar,2009-01-29 23:11:02+00:00,['578be33d4f175e650ea3794d45ba8ff85de8db89'],19,230,249,200474,5,0.296610169,0.56779661,0.93220339,459
bd67906b1daa622e2c78032f453c0cc2e777b8cb,0,Mahadev Konar,2009-01-29 23:21:37+00:00,['7d8d199a4662ab710c8f3a12745b86dbdb4c7520'],1,6,7,200481,2,,,,459
18066791de571f1204b39b7a4fa06a849f2f0deb,0,Mahadev Konar,2009-01-29 23:29:42+00:00,['bd67906b1daa622e2c78032f453c0cc2e777b8cb'],458,493,951,201432,4,,,,459
a1ac465be361ff478f9b66147731e588fef64ff3,1,Mahadev Konar,2009-01-30 19:30:27+00:00,['18066791de571f1204b39b7a4fa06a849f2f0deb'],4,7087,7091,208523,40,0.415116622,0.651018601,0.832004724,495
4b62dbcd629c0b49ac33bbd062afd266b490f81f,1,Patrick D. Hunt,2009-01-30 20:47:27+00:00,['a1ac465be361ff478f9b66147731e588fef64ff3'],1,4,5,208528,2,,,,495
85fc47a95dc4cd72a5ea79bcb3ab87613fa8535b,1,Mahadev Konar,2009-01-30 23:01:33+00:00,['4b62dbcd629c0b49ac33bbd062afd266b490f81f'],29,306,335,208863,6,0,0.530232558,0.944186047,495
892b0941c13f3680a5e3cfc32d51694ac4861289,1,Patrick D. Hunt,2009-01-31 01:04:12+00:00,['85fc47a95dc4cd72a5ea79bcb3ab87613fa8535b'],7,1635,1642,210505,17,0.422105263,0.543157895,0.747368421,506
bdcdc82e97512d6094ea25775a8d77c1597e1223,1,Patrick D. Hunt,2009-01-31 01:18:30+00:00,['892b0941c13f3680a5e3cfc32d51694ac4861289'],15,179,194,210699,5,0.523809524,0.984126984,0.365079365,507
468528097496884cf91b13a76381c986ff77fef2,1,Patrick D. Hunt,2009-01-31 01:23:15+00:00,['bdcdc82e97512d6094ea25775a8d77c1597e1223'],692,1045,1737,212436,8,,,,507
22a056e496bbee629d9418ddc9cd036c7afee5da,1,Benjamin Reed,2009-02-02 21:36:03+00:00,['468528097496884cf91b13a76381c986ff77fef2'],13,15,28,212464,16,,,,507
8173d34f1bb7c59fa401c3db1c0e42264fc48924,1,Mahadev Konar,2009-02-02 22:26:03+00:00,['22a056e496bbee629d9418ddc9cd036c7afee5da'],562,800,1362,213826,20,0.262032086,0.647058824,0.962566845,508
0561dcbbaeb7e1fa6598d9e3e61ada3011a0c80d,0,Patrick D. Hunt,2009-02-02 23:00:04+00:00,['8173d34f1bb7c59fa401c3db1c0e42264fc48924'],246,261,507,214333,4,,,,508
a4c675afff3b26171efd78ced4916e2f5fb25eb4,1,Mahadev Konar,2009-02-03 05:23:47+00:00,['0561dcbbaeb7e1fa6598d9e3e61ada3011a0c80d'],190,1450,1640,215973,20,0.255033557,0.572147651,0.805369128,515
950db6d30a476f1579411ea69ce0a8e5cb418c1b,0,Mahadev Konar,2009-02-03 05:26:09+00:00,['a4c675afff3b26171efd78ced4916e2f5fb25eb4'],61,119,180,216153,14,,,,515
86b4b548edad7eb35178a05751f321f2a5412483,1,Mahadev Konar,2009-02-03 05:27:43+00:00,['950db6d30a476f1579411ea69ce0a8e5cb418c1b'],0,523,523,216676,2,,,,517
730a34e14aea24238cd7532c0cac23e5cc8984c6,0,Mahadev Konar,2009-02-03 22:19:40+00:00,['86b4b548edad7eb35178a05751f321f2a5412483'],3,13,16,216692,2,0,0,1,517
b80ed2845feeb0f4b968a8e511d733e56e2a359e,0,Patrick D. Hunt,2009-02-03 22:47:48+00:00,['730a34e14aea24238cd7532c0cac23e5cc8984c6'],3,4,7,216699,2,,,,517
f3f53d489903b193c2d68f5bbaf36c0d55811037,0,Patrick D. Hunt,2009-02-03 22:52:26+00:00,['b80ed2845feeb0f4b968a8e511d733e56e2a359e'],3,18,21,216720,4,,,,517
2890f77b0ea58176e14780d99c4dc3cc0dfa88fd,1,Mahadev Konar,2009-02-04 19:57:39+00:00,['f3f53d489903b193c2d68f5bbaf36c0d55811037'],128,182,310,217030,3,1,1,1,517
4447e6dfa786f918b7e89754b10c70509fccae46,0,Mahadev Konar,2009-02-05 21:16:02+00:00,['2890f77b0ea58176e14780d99c4dc3cc0dfa88fd'],11,88,99,217129,8,0.555555556,0.444444444,0.555555556,518
c5d28b03b72253f2ca6d9142a17487b253317ec6,1,Mahadev Konar,2009-02-06 21:19:03+00:00,['4447e6dfa786f918b7e89754b10c70509fccae46'],39,105,144,217273,9,0,0.796610169,1,518
29400c0f6a4c9ea4cf79dc2c5d1dbee2ffc8fd07,0,Mahadev Konar,2009-02-10 18:39:35+00:00,['c5d28b03b72253f2ca6d9142a17487b253317ec6'],4,23,27,217300,4,,,,518
83cf0a93c37759334fab885c2010fa0b7d953f52,1,Mahadev Konar,2009-02-20 00:23:40+00:00,['29400c0f6a4c9ea4cf79dc2c5d1dbee2ffc8fd07'],122,243,365,217665,19,0,0.276923077,0.815384615,518
f36e174ebe11ec7b3da2cfd5b4226d61e1d3f642,1,Mahadev Konar,2009-02-23 23:52:04+00:00,['83cf0a93c37759334fab885c2010fa0b7d953f52'],1,6,7,217672,2,0,1,1,518
63e2697d430ce1f7c5b60ddc3ce8f2c65ef861fb,0,Mahadev Konar,2009-02-27 19:00:08+00:00,['f36e174ebe11ec7b3da2cfd5b4226d61e1d3f642'],11,32,43,217715,5,0,1,0.923076923,518
620e1d67b03f002ac4e3770d24211504657e4e96,1,Mahadev Konar,2009-02-27 19:47:30+00:00,['63e2697d430ce1f7c5b60ddc3ce8f2c65ef861fb'],14,78,92,217807,5,0.368421053,0.078947368,0.842105263,518
c54056686830066b0823281a176532edab27a964,1,Mahadev Konar,2009-02-27 20:03:08+00:00,['620e1d67b03f002ac4e3770d24211504657e4e96'],0,17,17,217824,2,0,0,0,518
8b651cfb22985be3a755fb82e3619057e34f49ef,0,Mahadev Konar,2009-03-03 22:48:50+00:00,['c54056686830066b0823281a176532edab27a964'],48,34,82,217906,2,,,,518
8cfdbd4406abe8e04e4fd8e399a32125cc28e26c,0,Patrick D. Hunt,2009-03-05 21:33:10+00:00,['8b651cfb22985be3a755fb82e3619057e34f49ef'],17,25,42,217948,2,0.4,1,0.6,518
79f2b64027be55b61095f8ccc499319fb3a0e4a0,0,Patrick D. Hunt,2009-03-05 22:32:59+00:00,['8cfdbd4406abe8e04e4fd8e399a32125cc28e26c'],3,5,8,217956,2,,,,518
ce1ea3ae72defd38e072d93b74c61d6386ffdff5,1,Mahadev Konar,2009-03-06 00:44:48+00:00,['79f2b64027be55b61095f8ccc499319fb3a0e4a0'],93,26,119,218075,3,0.076923077,0.115384615,0.192307692,518
075d67b7116ed13e52d1c3c72d3516d54eb701b4,0,Patrick D. Hunt,2009-03-12 00:31:30+00:00,['ce1ea3ae72defd38e072d93b74c61d6386ffdff5'],3,6,9,218084,2,,,,518
9b76dc54e7327395d6842c7e0a141ece42778cab,1,Patrick D. Hunt,2009-03-12 00:48:47+00:00,['075d67b7116ed13e52d1c3c72d3516d54eb701b4'],3,53,56,218140,3,0,1,1,518
534631b066865b1968e2b89cc02adf14c3d2f0de,0,Mahadev Konar,2009-03-18 16:37:57+00:00,['9b76dc54e7327395d6842c7e0a141ece42778cab'],7,4,11,218151,2,0,0,0,518
04ede08efbd18ce49b2d48f99d2b67ce19d30857,1,Mahadev Konar,2009-03-27 00:30:12+00:00,['534631b066865b1968e2b89cc02adf14c3d2f0de'],0,377,377,218528,4,,,,520
412a01fdc0f69f3042522a17b8ca2579a2b3f6c6,1,Mahadev Konar,2009-03-27 00:38:21+00:00,['04ede08efbd18ce49b2d48f99d2b67ce19d30857'],0,22,22,218550,2,,,,520
109f0dd1bdf5c9e57a3af10235eefc5b1162dc12,1,Mahadev Konar,2009-03-27 00:44:41+00:00,['412a01fdc0f69f3042522a17b8ca2579a2b3f6c6'],2,77,79,218629,2,,,,520
0b3fc0e47e1513e282bc01c6cc4eb292b9ad2aab,1,Mahadev Konar,2009-03-27 01:00:45+00:00,['109f0dd1bdf5c9e57a3af10235eefc5b1162dc12'],4,11,15,218644,2,,,,520
dce60e840ba1dd7e555f4304468f549711a0d8b8,0,Mahadev Konar,2009-03-27 05:25:26+00:00,['0b3fc0e47e1513e282bc01c6cc4eb292b9ad2aab'],22,23,45,218689,4,,,,520
37a4b19d24d6772a180adc70221319911d0c9bfa,0,Mahadev Konar,2009-03-27 17:30:12+00:00,['dce60e840ba1dd7e555f4304468f549711a0d8b8'],0,2,2,218691,1,,,,520
05eab5e567f49d984e3c299be42d9a9760d98ec2,1,Mahadev Konar,2009-04-01 21:50:03+00:00,['37a4b19d24d6772a180adc70221319911d0c9bfa'],348,579,927,219618,17,0.869158879,0.644859813,0.887850467,521
8aeade991cb813d3fa28e5f76931707e90d03274,1,Mahadev Konar,2009-04-02 00:35:57+00:00,['05eab5e567f49d984e3c299be42d9a9760d98ec2'],4,16,20,219638,2,0,1,1,521
56a1186f817bf13f7672ad07e31684bcd0f536f6,1,Mahadev Konar,2009-04-02 21:28:27+00:00,['8aeade991cb813d3fa28e5f76931707e90d03274'],13,63,76,219714,7,,,,521
1b91bfd187f1a718fc4f596099ca08af15a17971,0,Mahadev Konar,2009-04-03 21:43:38+00:00,['56a1186f817bf13f7672ad07e31684bcd0f536f6'],5,16,21,219735,3,1,1,1,521
c9e8662617ac5d99cc08f858c21dc9c4ba175881,1,Mahadev Konar,2009-04-03 22:01:18+00:00,['1b91bfd187f1a718fc4f596099ca08af15a17971'],16,27,43,219778,4,0.5,0,1,521
b6320b80a4c08958d5b5028cf065cbcc57894a86,1,Mahadev Konar,2009-04-06 22:19:05+00:00,['c9e8662617ac5d99cc08f858c21dc9c4ba175881'],241,565,806,220584,8,0.1,0.772727273,0.845454545,523
06d451ad0c982c098458f7a40463b5034708bcfc,1,Mahadev Konar,2009-04-07 02:43:38+00:00,['b6320b80a4c08958d5b5028cf065cbcc57894a86'],2,89,91,220675,3,0,0,1,523
47b16b9612ece90d959f1966f387b91ee4d9b7ed,1,Mahadev Konar,2009-04-08 21:09:42+00:00,['06d451ad0c982c098458f7a40463b5034708bcfc'],67,38,105,220780,3,0.476190476,0.476190476,0,523
945c1815408365931c9dda506b9f9332376bed43,0,Mahadev Konar,2009-04-08 22:39:10+00:00,['47b16b9612ece90d959f1966f387b91ee4d9b7ed'],1,3,4,220784,2,,,,523
764e34ca913283f1059de2055b0aa313c0514c2a,1,Mahadev Konar,2009-04-09 21:02:49+00:00,['945c1815408365931c9dda506b9f9332376bed43'],108,114,222,221006,6,1,0,0,523
6b4e7aa40b250afc66fc5f26b75d8bc1e79569cb,1,Patrick D. Hunt,2009-04-10 16:21:56+00:00,['764e34ca913283f1059de2055b0aa313c0514c2a'],0,103,103,221109,1,0.06557377,0.06557377,1,524
4b9f4168f19568a3c7bc89c0f7053e441cde0153,1,Mahadev Konar,2009-04-14 04:55:06+00:00,['6b4e7aa40b250afc66fc5f26b75d8bc1e79569cb'],6,26,32,221141,4,,,,524
b82c45bd81386d5af77570393e5540c360e263ca,1,Mahadev Konar,2009-04-16 20:28:17+00:00,['4b9f4168f19568a3c7bc89c0f7053e441cde0153'],2,56,58,221199,3,0.088235294,0.911764706,0.911764706,524
f6521f7c29b1d330617aed3764ecc25ff73e2da1,1,Mahadev Konar,2009-04-16 22:59:49+00:00,['b82c45bd81386d5af77570393e5540c360e263ca'],330,541,871,222070,17,0,0.27388535,1,524
1e1ccdcfb19a60e50b9393feac7c0322048e20e1,1,Patrick D. Hunt,2009-04-17 18:11:43+00:00,['f6521f7c29b1d330617aed3764ecc25ff73e2da1'],67,217,284,222354,14,0.389830508,0.271186441,1,532
4a5a9673545474d3d69efc6803005140cdde089e,1,Mahadev Konar,2009-04-17 20:48:29+00:00,['1e1ccdcfb19a60e50b9393feac7c0322048e20e1'],19,21,40,222394,6,1,1,0,532
9bdd8cf6378245a36531d071f68cf58898e5cca6,1,Mahadev Konar,2009-04-17 21:28:30+00:00,['4a5a9673545474d3d69efc6803005140cdde089e'],94,186,280,222674,7,0.256410256,0.179487179,0.461538462,532
42224f6b7fee3d183a7cbd13079bfe8b2b17a3ef,0,Mahadev Konar,2009-04-20 22:15:38+00:00,['9bdd8cf6378245a36531d071f68cf58898e5cca6'],1,4,5,222679,2,,,,532
d879ea6c15ab6ee4a4b834e141db02bf0cd789a4,0,Patrick D. Hunt,2009-04-22 17:52:22+00:00,['42224f6b7fee3d183a7cbd13079bfe8b2b17a3ef'],5,2803,2808,225487,3,,,,533
579ad8454500a307b1ec07efc4eeed55d643f124,1,Patrick D. Hunt,2009-04-23 21:41:09+00:00,['d879ea6c15ab6ee4a4b834e141db02bf0cd789a4'],10,4701,4711,230198,36,0.499428571,0.625142857,0.827428571,560
cfdc76c1eeea467b44b0fa934bbccfcdc877be00,1,Mahadev Konar,2009-04-24 18:26:08+00:00,['579ad8454500a307b1ec07efc4eeed55d643f124'],636,1502,2138,232336,31,0.260416667,0.65625,0.666666667,564
ba1acd70605d284d6cc09cd0b3055a93ea3bc958,1,Mahadev Konar,2009-04-27 18:07:56+00:00,['cfdc76c1eeea467b44b0fa934bbccfcdc877be00'],0,8156,8156,240492,25,1,1,1,588
9b3953a4f713a4ddec398820ff222a537c033314,0,Patrick D. Hunt,2009-04-29 19:11:39+00:00,['ba1acd70605d284d6cc09cd0b3055a93ea3bc958'],2,7,9,240501,2,1,1,0.5,588
7955dea8215faeeedd347654e9b126cae30a1fa8,0,Patrick D. Hunt,2009-04-29 19:16:29+00:00,['9b3953a4f713a4ddec398820ff222a537c033314'],2,15,17,240518,3,,,,588
b4510d2b69db980525be0fcb6e11b692c690ac24,0,Mahadev Konar,2009-05-05 04:55:31+00:00,['7955dea8215faeeedd347654e9b126cae30a1fa8'],7,26,33,240551,3,0,1,0.882352941,588
c41bd3f83e6ad99f03261ba21295eed5151eadda,1,Flavio Paiva Junqueira,2009-05-06 08:49:48+00:00,['b4510d2b69db980525be0fcb6e11b692c690ac24'],448,1009,1457,242008,17,0.470989761,0.679180887,0.993174061,591
070689784849b2cc600794e73e2c8c56d6e13324,0,Mahadev Konar,2009-05-07 22:27:26+00:00,['c41bd3f83e6ad99f03261ba21295eed5151eadda'],2,4,6,242014,2,,,,591
b2969cc53c713855e19931b19292f7a698532d34,0,Mahadev Konar,2009-05-07 22:30:29+00:00,['070689784849b2cc600794e73e2c8c56d6e13324'],8,56,64,242078,2,0.348837209,0,0.953488372,591
b7091d6cda358a4fe5dac9c27d402e82dba1e424,1,Mahadev Konar,2009-05-07 22:34:36+00:00,['b2969cc53c713855e19931b19292f7a698532d34'],157,542,699,242777,9,0.40167364,0.317991632,0.807531381,595
3a816ff85664aafc39a474be9cfb31ef949c1d17,1,Mahadev Konar,2009-05-07 22:37:54+00:00,['b7091d6cda358a4fe5dac9c27d402e82dba1e424'],9,30,39,242816,2,,,,595
1cd080633bff3e8668f62149316d416698582b35,1,Mahadev Konar,2009-05-08 05:27:00+00:00,['3a816ff85664aafc39a474be9cfb31ef949c1d17'],0,4712,4712,247528,44,0.420886076,0.761603376,0.662447257,638
79de509219862735d0db1ff966aacb67430e0c89,1,Mahadev Konar,2009-05-12 20:59:33+00:00,['1cd080633bff3e8668f62149316d416698582b35'],18,17,35,247563,6,1,0.666666667,0,638
c92b14b8e234977b0ec7a3fb265ef61cc501ac24,1,Mahadev Konar,2009-05-14 06:37:59+00:00,['79de509219862735d0db1ff966aacb67430e0c89'],0,1632,1632,249195,13,0.454545455,0.875935829,0.864171123,650
0566dc00b3fe9af48ea856a587ceee56fcc24cd8,0,Flavio Paiva Junqueira,2009-05-14 08:21:16+00:00,['c92b14b8e234977b0ec7a3fb265ef61cc501ac24'],16,17,33,249228,6,0,0,1,650
acd8adc4a75bb2b0b5dfa3f75f31a723b9e763e7,0,Mahadev Konar,2009-05-14 17:22:19+00:00,['0566dc00b3fe9af48ea856a587ceee56fcc24cd8'],0,0,0,249228,2,,,,650
61922f2f212db1badc5eae560b25571c3d7ac8d3,1,Mahadev Konar,2009-05-14 19:16:43+00:00,['acd8adc4a75bb2b0b5dfa3f75f31a723b9e763e7'],1,4,5,249233,1,,,,650
382cce4d71475d3101cdd2caa57ccdae1064ee7c,1,Mahadev Konar,2009-05-14 20:15:06+00:00,['61922f2f212db1badc5eae560b25571c3d7ac8d3'],10,244,254,249487,6,0.389312977,0.526717557,1,651
8f48827911d180889a9db7ab467367829c2c38b6,1,Mahadev Konar,2009-05-19 21:27:07+00:00,['382cce4d71475d3101cdd2caa57ccdae1064ee7c'],7,34,41,249528,2,,,,651
c611de04703c9f6d27b3349b0d06a297dfc46fc1,1,Benjamin Reed,2009-05-20 17:58:56+00:00,['8f48827911d180889a9db7ab467367829c2c38b6'],0,3,3,249531,2,0,0,1,651
74141aaa4aad59c6839e4e46e8377628b0a6cfe3,1,Benjamin Reed,2009-05-20 18:08:28+00:00,['c611de04703c9f6d27b3349b0d06a297dfc46fc1'],4,22,26,249557,3,0,0.0625,1,651
7fc11691f45d8c4b384c564e9da10b3460109a00,1,Benjamin Reed,2009-05-20 18:12:24+00:00,['74141aaa4aad59c6839e4e46e8377628b0a6cfe3'],1,30,31,249588,1,,,,651
9da245089da466c3bedf569c81745f457d0fe5e8,1,Benjamin Reed,2009-05-20 18:13:32+00:00,['7fc11691f45d8c4b384c564e9da10b3460109a00'],0,3,3,249591,1,,,,651
cff0aedb1891cc1595cb19e28533f2b5c7a3e6a0,1,Benjamin Reed,2009-05-20 18:48:00+00:00,['9da245089da466c3bedf569c81745f457d0fe5e8'],46,127,173,249764,16,1,0.863636364,0.909090909,651
8bd356fe1d47a7300725f5562766355d5616fbb3,1,Benjamin Reed,2009-05-20 18:51:15+00:00,['cff0aedb1891cc1595cb19e28533f2b5c7a3e6a0'],5,11,16,249780,5,0,1,1,651
e936eceb9e75aee9f2cd245b9cc7709a2e7b4ded,1,Benjamin Reed,2009-05-20 20:16:33+00:00,['8bd356fe1d47a7300725f5562766355d5616fbb3'],66,128,194,249974,15,0.172413793,0,1,651
0fbbab80c67c7539eadc969c83503d494612bbec,1,Patrick D. Hunt,2009-05-20 22:41:10+00:00,['e936eceb9e75aee9f2cd245b9cc7709a2e7b4ded'],19,64,83,250057,5,,,,651
c0500af30f4a01114b030fb3e4afbc7bbaf210fa,1,Patrick D. Hunt,2009-05-21 21:22:10+00:00,['0fbbab80c67c7539eadc969c83503d494612bbec'],6,50,56,250113,5,0,0.129032258,0.774193548,651
2c6174d961eb3d4966ea27b39e36fbba1f29d07a,0,Patrick D. Hunt,2009-05-22 07:25:21+00:00,['c0500af30f4a01114b030fb3e4afbc7bbaf210fa'],1,7,8,250121,2,0.25,1,0.25,651
4b88ebcce8879df1c522a55dc8053f7b40bb63e9,0,Patrick D. Hunt,2009-05-22 07:43:14+00:00,['2c6174d961eb3d4966ea27b39e36fbba1f29d07a'],14,44,58,250179,2,0,1,1,651
32b1f3d03daec38f9c5b29fb003fffe75b02e51c,1,Benjamin Reed,2009-05-22 19:02:04+00:00,['4b88ebcce8879df1c522a55dc8053f7b40bb63e9'],2,4,6,250185,2,,,,651
08cc3e01fcd26ab9eced8eba0516e49c14cf27d3,1,Benjamin Reed,2009-05-22 19:06:02+00:00,['32b1f3d03daec38f9c5b29fb003fffe75b02e51c'],175,163,338,250523,34,0,0.65625,0.875,651
472de4a37f18e03b11d67aaac807b934208c9f0e,1,Mahadev Konar,2009-05-28 04:55:19+00:00,['08cc3e01fcd26ab9eced8eba0516e49c14cf27d3'],1,2,3,250526,2,,,,651
ba65c32347b12607cfa8160088b442e2f56a837e,1,Mahadev Konar,2009-05-28 05:00:40+00:00,['472de4a37f18e03b11d67aaac807b934208c9f0e'],168,1826,1994,252520,16,0.290167866,0.395683453,0.645083933,655
b21c2e528df0938471f7f1897964903fe1fc0a42,1,Patrick D. Hunt,2009-05-28 18:31:15+00:00,['ba65c32347b12607cfa8160088b442e2f56a837e'],7,13,20,252540,2,,,,655
359f5b0d38236611a93391e8cfae7bd0c0dc8d3d,0,Mahadev Konar,2009-05-29 22:04:28+00:00,['b21c2e528df0938471f7f1897964903fe1fc0a42'],0,0,0,252540,4,,,,655
f30c599844397dd75653ba2f924a2aca9760ee5c,1,Patrick D. Hunt,2009-06-01 21:00:09+00:00,['359f5b0d38236611a93391e8cfae7bd0c0dc8d3d'],2,21,23,252563,7,1,1,1,655
01aee31cd6dc5d49cc931299121cfc6687c2f9a5,0,Benjamin Reed,2009-06-02 21:15:23+00:00,['f30c599844397dd75653ba2f924a2aca9760ee5c'],1,26,27,252590,4,0.764705882,0.764705882,1,655
0959e89f8bfd67735be718542872582ec1ce792d,0,Benjamin Reed,2009-06-03 05:14:16+00:00,['01aee31cd6dc5d49cc931299121cfc6687c2f9a5'],341,463,804,253394,25,0,0.348484848,0.939393939,655
016f8c2ab755536ccc5daf953108978e9e0e9513,0,Benjamin Reed,2009-06-03 05:32:59+00:00,['0959e89f8bfd67735be718542872582ec1ce792d'],461,341,802,254196,24,1,0.651515152,0.060606061,655
a7521e409132bbdde4e4b8392b66ccc944aafa8b,0,Benjamin Reed,2009-06-05 04:44:23+00:00,['016f8c2ab755536ccc5daf953108978e9e0e9513'],36,67,103,254299,5,1,1,1,655
222d73fe2668f9a9277d8732842e1bd41706d4e7,1,Mahadev Konar,2009-06-08 20:38:46+00:00,['a7521e409132bbdde4e4b8392b66ccc944aafa8b'],317,321,638,254937,9,,,,655
389c0b17e7bad0f524c90b4764f23574646991ae,0,Mahadev Konar,2009-06-08 21:30:55+00:00,['222d73fe2668f9a9277d8732842e1bd41706d4e7'],5,6,11,254948,2,,,,655
320fd3b0c9eddec2e6336f557e675b28ed33fffe,1,Benjamin Reed,2009-06-09 05:04:36+00:00,['389c0b17e7bad0f524c90b4764f23574646991ae'],31,110,141,255089,11,0.615384615,0.615384615,1,655
3f31b97d141d0ebb78ba0ca43372c7d032f179fa,0,Benjamin Reed,2009-06-09 05:10:05+00:00,['320fd3b0c9eddec2e6336f557e675b28ed33fffe'],0,2,2,255091,1,,,,655
c20b3c471bb4aed9be49a8b56f5e997ba21ef7c1,1,Benjamin Reed,2009-06-09 05:12:16+00:00,['3f31b97d141d0ebb78ba0ca43372c7d032f179fa'],35,72,107,255198,2,0.321428571,0.392857143,1,655
601320c3379194eb90a3b57a5f27e703727aa690,1,Benjamin Reed,2009-06-09 05:21:27+00:00,['c20b3c471bb4aed9be49a8b56f5e997ba21ef7c1'],5,137,142,255340,4,0,1,1,656
082a3f9b0ec10b9587c1f05473d3c42905a2056c,1,Benjamin Reed,2009-06-09 05:23:26+00:00,['601320c3379194eb90a3b57a5f27e703727aa690'],0,659,659,255999,3,0.614555256,0.657681941,0.886792453,659
d1c6a8d9f0a69759aecc88e180f90de553ceaf6a,0,Benjamin Reed,2009-06-09 16:46:10+00:00,['082a3f9b0ec10b9587c1f05473d3c42905a2056c'],248,0,248,256247,1,0.290322581,0.290322581,0.135483871,659
7f9dd70384c16e81a08fb8055ffa194bf72bdd7d,1,Mahadev Konar,2009-06-09 19:01:11+00:00,['d1c6a8d9f0a69759aecc88e180f90de553ceaf6a'],91,268,359,256606,5,0.480519481,0.915584416,0.811688312,659
43ede9d7b80cd20ac916d50cc5e5faae0b925a41,1,Mahadev Konar,2009-06-09 23:03:38+00:00,['7f9dd70384c16e81a08fb8055ffa194bf72bdd7d'],549,911,1460,258066,11,,,,659
9ff16ed7c30a06b6a7fb58a5e040fc2fe18bca23,1,Mahadev Konar,2009-06-15 20:52:18+00:00,['43ede9d7b80cd20ac916d50cc5e5faae0b925a41'],78,131,209,258275,14,0,0,0.72,659
981052d54b87a7ec8989a46acf2d77d2064a9390,1,Mahadev Konar,2009-06-15 22:54:48+00:00,['9ff16ed7c30a06b6a7fb58a5e040fc2fe18bca23'],193,964,1157,259432,13,0.426229508,0.459016393,0.836065574,662
f81da9fecd15be58ba45ae54c59109c4153773ae,1,Mahadev Konar,2009-06-15 23:00:03+00:00,['981052d54b87a7ec8989a46acf2d77d2064a9390'],1,4,5,259437,2,,,,662
094dda343f05b354ac2cf4ede057afd363253a32,0,Mahadev Konar,2009-06-17 17:36:39+00:00,['f81da9fecd15be58ba45ae54c59109c4153773ae'],2,3,5,259442,2,,,,662
360fc24572f0ba75362253450fea50dd48d2ea13,1,Mahadev Konar,2009-06-18 01:08:52+00:00,['094dda343f05b354ac2cf4ede057afd363253a32'],4,153,157,259599,6,0.128205128,0.987179487,1,663
3402537c1f8d8301b6e16e6cebc8c1e655aa14bf,1,Mahadev Konar,2009-06-18 16:37:49+00:00,['360fc24572f0ba75362253450fea50dd48d2ea13'],387,534,921,260520,38,0,0.455696203,0.962025316,663
d41b671bd683600267b68df69beec38f681a189e,0,Benjamin Reed,2009-06-18 20:32:51+00:00,['3402537c1f8d8301b6e16e6cebc8c1e655aa14bf'],1,5,6,260526,2,0,0,1,663
76e038779ec1e22225d0ca69f5a1284ce3a46f32,1,Benjamin Reed,2009-06-18 22:22:44+00:00,['d41b671bd683600267b68df69beec38f681a189e'],7,21,28,260554,2,0,0,1,663
a021aff2ef6cfebea5ffb62b84ee075797764f93,0,Mahadev Konar,2009-06-22 20:48:18+00:00,['76e038779ec1e22225d0ca69f5a1284ce3a46f32'],0,0,0,260554,0,,,,663
cbd8be492393d9409ac0ee8c2dbb7c1bbad3cab3,0,Mahadev Konar,2009-06-22 20:53:05+00:00,['a021aff2ef6cfebea5ffb62b84ee075797764f93'],77,7,84,260638,5,0.052631579,0,0.026315789,663
9f27c0f760a1a614ceebc913d61b09bcd9ca87b9,1,Mahadev Konar,2009-06-23 18:38:33+00:00,['cbd8be492393d9409ac0ee8c2dbb7c1bbad3cab3'],198,5062,5260,265898,32,,,,675
c810a7731bd2087497d038d2daed1ca558b32963,1,Mahadev Konar,2009-06-23 19:03:45+00:00,['9f27c0f760a1a614ceebc913d61b09bcd9ca87b9'],569,815,1384,267282,4,,,,675
e0316743684e9ef208cfe68efc28929ecfad5e67,1,Benjamin Reed,2009-06-24 05:07:23+00:00,['c810a7731bd2087497d038d2daed1ca558b32963'],722,1787,2509,269791,21,0.327974277,0.644694534,0.871382637,676
e3650bf5dd0bc427fc8000821ae70e69c563863f,1,Mahadev Konar,2009-06-24 22:59:34+00:00,['e0316743684e9ef208cfe68efc28929ecfad5e67'],1008,1757,2765,272556,21,0.082742317,0.48463357,0.643026005,679
d563b681249eedd38ce3610e6328195ba3ee052a,1,Mahadev Konar,2009-06-25 01:48:18+00:00,['e3650bf5dd0bc427fc8000821ae70e69c563863f'],466,527,993,273549,4,,,,679
32b76dabd04b8ee71148dce562919f74b7addfeb,0,Mahadev Konar,2009-06-25 20:41:37+00:00,['d563b681249eedd38ce3610e6328195ba3ee052a'],6,36,42,273591,3,0.041666667,1,1,679
804e5d5b575e9873c9a5bc1fa4323c13bef2ad5c,0,Mahadev Konar,2009-06-25 22:42:42+00:00,['32b76dabd04b8ee71148dce562919f74b7addfeb'],519,845,1364,274955,7,,,,682
178925f672946d04524195caa2d191377e02f466,0,Mahadev Konar,2009-06-26 18:51:20+00:00,['804e5d5b575e9873c9a5bc1fa4323c13bef2ad5c'],211,295,506,275461,8,,,,684
0057dcb78313be28ae16b7e84c873191471dceee,1,Mahadev Konar,2009-06-26 20:29:54+00:00,['178925f672946d04524195caa2d191377e02f466'],20,210,230,275691,16,0.540540541,0.792792793,0.927927928,684
ed6a4639e787c8a68f8f4cbca740693927498ebb,0,Mahadev Konar,2009-06-26 21:15:58+00:00,['0057dcb78313be28ae16b7e84c873191471dceee'],3,9,12,275703,4,0,0,1,684
0732e418971bd8a50a9ac61f2e847716273f88bd,1,Patrick D. Hunt,2009-06-30 00:33:32+00:00,['ed6a4639e787c8a68f8f4cbca740693927498ebb'],27,71,98,275801,6,,,,686
0082d79ac81bfcb1c3d0c8139d74002020402940,1,Mahadev Konar,2009-06-30 01:28:24+00:00,['0732e418971bd8a50a9ac61f2e847716273f88bd'],0,3,3,275804,4,,,,686
b37b8d6713c630901e46f0191b205061c0273133,1,Mahadev Konar,2009-06-30 01:32:11+00:00,['0082d79ac81bfcb1c3d0c8139d74002020402940'],3,42,45,275849,4,0.08,1,1,686
8d2ae28491342663d9290114b8ecb182d6aa903e,1,Mahadev Konar,2009-06-30 20:47:09+00:00,['b37b8d6713c630901e46f0191b205061c0273133'],23,242,265,276114,5,0.211009174,0.596330275,1,687
ac0a3bea3c75c074eb5e96a1393845d74c1b1022,1,Patrick D. Hunt,2009-06-30 20:56:35+00:00,['8d2ae28491342663d9290114b8ecb182d6aa903e'],6,7,13,276127,2,,,,687
728979a47d09d5f6df670de042783f03d11be448,0,Patrick D. Hunt,2009-06-30 21:04:37+00:00,['ac0a3bea3c75c074eb5e96a1393845d74c1b1022'],4,4,8,276135,1,,,,687
b12211df5d86fe0fbd0683c62a02516f7970f29e,0,Patrick D. Hunt,2009-06-30 21:05:27+00:00,['728979a47d09d5f6df670de042783f03d11be448'],1,1,2,276137,1,,,,687
904ccddf85e5657a0f65cc4299a77a3f4e3b19f4,0,Patrick D. Hunt,2009-06-30 21:18:14+00:00,['b12211df5d86fe0fbd0683c62a02516f7970f29e'],4,19,23,276160,5,,,,687
3884a631b018d285ea00cc28bb07f16876f15116,0,Patrick D. Hunt,2009-07-01 16:38:06+00:00,['904ccddf85e5657a0f65cc4299a77a3f4e3b19f4'],2,6,8,276168,2,0,0,0,687
42c4239d64aaa86b9f2ef256f26a6e1510e216cb,0,Giridharan Kesavan,2009-07-02 16:13:24+00:00,['3884a631b018d285ea00cc28bb07f16876f15116'],0,0,0,276168,0,,,,687
b70182bab7d151fac116335a800267646db580bd,0,Flavio Paiva Junqueira,2009-07-16 14:58:55+00:00,['42c4239d64aaa86b9f2ef256f26a6e1510e216cb'],1,3,4,276172,2,,,,687
a44fae6243a6363d0e07f3ba1275f8ecd3f5deb5,1,Mahadev Konar,2009-07-16 22:09:40+00:00,['b70182bab7d151fac116335a800267646db580bd'],365,560,925,277097,43,0.244897959,0.846938776,1,688
02fe2f7cc867d81cf7e25db697d97693b315fa72,1,Mahadev Konar,2009-07-16 23:09:22+00:00,['a44fae6243a6363d0e07f3ba1275f8ecd3f5deb5'],2,4,6,277103,2,,,,688
a8675ad07878bfaf7a75fe39aa9e1b0bb70a1cb9,1,Mahadev Konar,2009-07-17 01:12:33+00:00,['02fe2f7cc867d81cf7e25db697d97693b315fa72'],17,35,52,277155,7,,,,688
27df3be388c6f67fe493c355f6695b4f19db32d2,0,Mahadev Konar,2009-07-20 22:30:40+00:00,['a8675ad07878bfaf7a75fe39aa9e1b0bb70a1cb9'],0,4,4,277159,3,,,,688
e84c8267713c44a067dd17a249bb262c533b1bb9,1,Mahadev Konar,2009-07-21 21:00:33+00:00,['27df3be388c6f67fe493c355f6695b4f19db32d2'],0,4,4,277163,2,,,,688
e6f0ba517168c4af11355bad793b4f481a66d4a0,0,Giridharan Kesavan,2009-07-27 06:42:56+00:00,['e84c8267713c44a067dd17a249bb262c533b1bb9'],3,6,9,277172,3,,,,688
4a59fd30d40d1cf2ef4b3c62e1d64047f246dba3,0,Mahadev Konar,2009-07-30 21:52:38+00:00,['e6f0ba517168c4af11355bad793b4f481a66d4a0'],1,3,4,277176,2,,,,688
e4801d85185d436a09bb257c0dd175a0f999b2c2,1,Mahadev Konar,2009-07-30 22:26:29+00:00,['4a59fd30d40d1cf2ef4b3c62e1d64047f246dba3'],13,18,31,277207,3,1,1,1,688
f884f500b035946775edb18baff564eaf5a69fad,0,Patrick D. Hunt,2009-07-31 19:07:59+00:00,['e4801d85185d436a09bb257c0dd175a0f999b2c2'],7,14,21,277228,4,0,0.4,1,688
0a1f589b1ce96c09eb71b5492ece6bc99bfeec13,1,Patrick D. Hunt,2009-07-31 20:32:02+00:00,['f884f500b035946775edb18baff564eaf5a69fad'],26,25,51,277279,2,1,0.423076923,0,688
1bc05ce6a3363206fbcf0a4bc6c9bbdee1d361f0,1,Mahadev Konar,2009-08-03 21:27:09+00:00,['0a1f589b1ce96c09eb71b5492ece6bc99bfeec13'],93,295,388,277667,3,0.734177215,1,0.873417722,689
a92959ed01dc7425cc4fad14950dc1604934f6e2,1,Mahadev Konar,2009-08-03 22:28:19+00:00,['1bc05ce6a3363206fbcf0a4bc6c9bbdee1d361f0'],16,59,75,277742,5,0.9375,1,1,689
e944652982bf75ae148020cd96338765391efc55,0,Patrick D. Hunt,2009-08-04 01:58:02+00:00,['a92959ed01dc7425cc4fad14950dc1604934f6e2'],7,23,30,277772,3,0,1,1,689
930380c9407184ba159181c0d8cd08d21ce90766,1,Mahadev Konar,2009-08-04 17:59:58+00:00,['e944652982bf75ae148020cd96338765391efc55'],8,224,232,278004,3,0.476744186,0.941860465,0.860465116,690
358f5122485b7ffa9dcc2e46e0751e88711f2ad9,1,Mahadev Konar,2009-08-04 18:11:16+00:00,['930380c9407184ba159181c0d8cd08d21ce90766'],3,190,193,278197,3,0.144444444,0.722222222,1,691
afaebe7331b1cc249ee8fce3372c9a4b47184f0e,1,Patrick D. Hunt,2009-08-04 21:21:02+00:00,['358f5122485b7ffa9dcc2e46e0751e88711f2ad9'],3,18,21,278218,3,,,,691
c11645f17c5266d7577ea58cb244a3d6eaaff0e0,0,Patrick D. Hunt,2009-08-04 21:38:38+00:00,['afaebe7331b1cc249ee8fce3372c9a4b47184f0e'],3,6,9,278227,2,0,0,1,691
d3bed4d6ff788cd800aca503d9d6a57e0cf75da9,1,Benjamin Reed,2009-08-06 18:03:25+00:00,['c11645f17c5266d7577ea58cb244a3d6eaaff0e0'],15,62,77,278304,4,0,1,1,691
9107bbaf5f94ea0c70bcaae458538c95aeb61454,1,Mahadev Konar,2009-08-06 23:23:32+00:00,['d3bed4d6ff788cd800aca503d9d6a57e0cf75da9'],23,81,104,278408,9,0,1,1,691
8d14195dd1c20e5ed8d648eee6ab5702a7a8e86a,0,Patrick D. Hunt,2009-08-07 18:00:48+00:00,['9107bbaf5f94ea0c70bcaae458538c95aeb61454'],13,58,71,278479,2,,,,691
30fe838bb0d0a728eb99f962094dcc115c9990d4,1,Mahadev Konar,2009-08-07 21:00:05+00:00,['8d14195dd1c20e5ed8d648eee6ab5702a7a8e86a'],8,43,51,278530,3,0.083333333,0,1,691
d26abefde17d4e168a32146238036e5515267655,1,Mahadev Konar,2009-08-10 22:24:06+00:00,['30fe838bb0d0a728eb99f962094dcc115c9990d4'],28,109,137,278667,4,0,1,1,691
94dabe199c1cfa6513d90b2f238bcb753846fd2a,1,Mahadev Konar,2009-08-11 00:28:06+00:00,['d26abefde17d4e168a32146238036e5515267655'],3,14,17,278684,2,,,,691
b12aad6381345396ad68be2c4c9df778883bd203,0,Patrick D. Hunt,2009-08-11 05:44:51+00:00,['94dabe199c1cfa6513d90b2f238bcb753846fd2a'],4,65,69,278753,3,0,0.352941176,1,691
a45c0e1b11ef8791778512ea23eebe21211f393d,1,Patrick D. Hunt,2009-08-11 06:16:41+00:00,['b12aad6381345396ad68be2c4c9df778883bd203'],65,4,69,278822,3,1,0.647058824,0,691
8b22eb1e4b8bfe4be08a766a98f636149e62fb28,1,Mahadev Konar,2009-08-11 21:09:32+00:00,['a45c0e1b11ef8791778512ea23eebe21211f393d'],592,1216,1808,280630,30,0.123809524,0.133333333,0.971428571,694
0a7c3b05744008862e1875dd6a651aa2a36d8cef,1,Mahadev Konar,2009-08-25 05:45:24+00:00,['8b22eb1e4b8bfe4be08a766a98f636149e62fb28'],35,317,352,280982,9,0.25,0.357142857,0.970238095,695
10a4ad03db6b65854d3b967ecbb27879577f9aaf,0,Patrick D. Hunt,2009-08-27 18:07:52+00:00,['0a7c3b05744008862e1875dd6a651aa2a36d8cef'],4,7,11,280993,2,,,,695
6e69b7cc29200ad553154bef32b43e448c610092,1,Patrick D. Hunt,2009-09-16 00:09:47+00:00,['10a4ad03db6b65854d3b967ecbb27879577f9aaf'],513,1016,1529,282522,31,0.520361991,1,0.814479638,698
e1af106bfbec9ba8be3d5ff42748ea409565a15e,1,Mahadev Konar,2009-09-22 22:59:34+00:00,['6e69b7cc29200ad553154bef32b43e448c610092'],233,303,536,283058,24,,,,698
fd03c45fdfce0c629cba2d8d70c7949e1c19f224,1,Mahadev Konar,2009-09-23 06:59:50+00:00,['e1af106bfbec9ba8be3d5ff42748ea409565a15e'],0,49,49,283107,1,,,,699
a3673f85484e61ec02bab6db995a3eef3433923e,1,Mahadev Konar,2009-09-23 20:00:23+00:00,['fd03c45fdfce0c629cba2d8d70c7949e1c19f224'],46,35,81,283188,8,,,,699
9eb990629b8bf09d91bfb439a2dfd0aaa8e9f14a,1,Mahadev Konar,2009-09-23 21:53:55+00:00,['a3673f85484e61ec02bab6db995a3eef3433923e'],7,17,24,283212,2,,,,699
535f0bc00aefe5a2c9aa3b0470a1804ac6730bcc,1,Mahadev Konar,2009-09-24 18:50:23+00:00,['9eb990629b8bf09d91bfb439a2dfd0aaa8e9f14a'],1,9,10,283222,2,,,,699
4afe93e5e1cf3a9493618cf9f16aae76ea19527c,1,Patrick D. Hunt,2009-10-01 21:37:36+00:00,['535f0bc00aefe5a2c9aa3b0470a1804ac6730bcc'],8,25,33,283255,5,,,,699
958f167a8e1f4aa1e6525bfdc16a4d8a54866008,0,Patrick D. Hunt,2009-10-02 00:26:14+00:00,['4afe93e5e1cf3a9493618cf9f16aae76ea19527c'],9,24,33,283288,2,1,1,0.166666667,699
a9c58d2ea3bd51dd806d8012b43fa765cebb6ce3,1,Mahadev Konar,2009-10-05 22:37:24+00:00,['958f167a8e1f4aa1e6525bfdc16a4d8a54866008'],1,68,69,283357,2,,,,699
9241d7e88f6c48fea7e95ae01fc92af3654d0ebb,1,Mahadev Konar,2009-10-07 18:10:50+00:00,['a9c58d2ea3bd51dd806d8012b43fa765cebb6ce3'],1,13,14,283371,2,0,0,0,699
b9f518c92e648acb4efc39a30313947961d617c3,1,Mahadev Konar,2009-10-09 00:42:18+00:00,['9241d7e88f6c48fea7e95ae01fc92af3654d0ebb'],65,321,386,283757,10,0.458823529,0.723529412,0.917647059,699
724d1a0984c4ed3589ce390bfc93c0bc1c0f52d1,1,Patrick D. Hunt,2009-10-13 23:14:05+00:00,['b9f518c92e648acb4efc39a30313947961d617c3'],15,149,164,283921,3,0.535714286,0.94047619,0.833333333,699
8c8d976e94956fec43924472d42a4d3472ef49c9,0,Patrick D. Hunt,2009-10-14 00:10:13+00:00,['724d1a0984c4ed3589ce390bfc93c0bc1c0f52d1'],2,3,5,283926,1,0,1,1,699
e8d31e674af714ee33bf4dcbabc6ad22387bc0b7,0,Patrick D. Hunt,2009-10-19 19:42:17+00:00,['8c8d976e94956fec43924472d42a4d3472ef49c9'],1,222,223,284149,6,0.7265625,1,0.890625,701
266b24b91dfaf65b94f74297d0ef46d6949fe20d,1,Mahadev Konar,2009-10-21 21:00:37+00:00,['e8d31e674af714ee33bf4dcbabc6ad22387bc0b7'],15,27,42,284191,3,0,0.125,0.125,701
c472d685e02ced4448054b3d8a83a1b669dee58e,1,Mahadev Konar,2009-10-27 21:14:00+00:00,['266b24b91dfaf65b94f74297d0ef46d6949fe20d'],29,52,81,284272,2,0,0,1,701
5c6b25380be5854f9b6ad3b58866c90df488bd8e,0,Patrick D. Hunt,2009-10-29 04:02:02+00:00,['c472d685e02ced4448054b3d8a83a1b669dee58e'],0,5,5,284277,2,,,,701
e9a7606bb0198f28ec9d9e5a3072d5f18b73b877,1,Mahadev Konar,2009-10-29 21:04:44+00:00,['5c6b25380be5854f9b6ad3b58866c90df488bd8e'],2,27,29,284306,3,0,1,1,701
0957b8404e1ecfc5703d7c2827752773b7dc23be,1,Mahadev Konar,2009-10-30 16:19:13+00:00,['e9a7606bb0198f28ec9d9e5a3072d5f18b73b877'],532,748,1280,285586,15,1,1,0.918032787,703
82a9d1d0a24147dcb533542559d61783058f1a1b,1,Mahadev Konar,2009-10-30 23:09:26+00:00,['0957b8404e1ecfc5703d7c2827752773b7dc23be'],79,929,1008,286594,26,0.264887064,0.611909651,0.616016427,704
8fb0deeb8f3cb740487a26cbd6196894a6c226e8,1,Patrick D. Hunt,2009-11-06 21:17:48+00:00,['82a9d1d0a24147dcb533542559d61783058f1a1b'],10,105,115,286709,3,,,,704
e3b97366f8064a6d65a3eb1c44e1191e5e73a5c3,1,Benjamin Reed,2009-11-07 00:48:04+00:00,['8fb0deeb8f3cb740487a26cbd6196894a6c226e8'],274,584,858,287567,15,0.339449541,0.431192661,0.95412844,704
2a23a2599b31dcbc971ddd68b05a13b9570247cc,1,Benjamin Reed,2009-11-07 07:16:30+00:00,['e3b97366f8064a6d65a3eb1c44e1191e5e73a5c3'],32,56,88,287655,4,0.090909091,0.090909091,1,704
b1b3bd11865ddd74b0977e977aedabdaf5603a1e,0,Flavio Paiva Junqueira,2009-11-08 21:41:13+00:00,['2a23a2599b31dcbc971ddd68b05a13b9570247cc'],1,15,16,287671,3,0,0,1,704
6dddf00c821abc9b4c9933b175e68407c279d290,0,Benjamin Reed,2009-11-08 22:46:04+00:00,['b1b3bd11865ddd74b0977e977aedabdaf5603a1e'],17,53,70,287741,1,0.060606061,0.787878788,0.363636364,704
47c4bdb0c3c40d756ec0ced91a39c771351e826a,1,Benjamin Reed,2009-11-12 19:53:07+00:00,['6dddf00c821abc9b4c9933b175e68407c279d290'],122,635,757,288498,10,0.324324324,0.895752896,0.876447876,706
41bd0e5f7f05694d7a22a72eceafad8907f57cfc,0,Benjamin Reed,2009-11-12 20:02:35+00:00,['47c4bdb0c3c40d756ec0ced91a39c771351e826a'],2,18,20,288518,2,,,,706
65b7111d7405320b4adf3ce5e50180e4ec3a6bbb,0,Benjamin Reed,2009-11-12 21:24:29+00:00,['41bd0e5f7f05694d7a22a72eceafad8907f57cfc'],357,403,760,289278,7,,,,706
b7121bb88bab363874309357f9c945c9ed8c75bc,1,Mahadev Konar,2009-11-12 21:27:47+00:00,['65b7111d7405320b4adf3ce5e50180e4ec3a6bbb'],1,4468,4469,293747,22,0.399260628,0.687615527,0.685767098,725
4a425c4e4911f1d4463f098a1c030b9920e391c0,1,Mahadev Konar,2009-11-12 22:48:00+00:00,['b7121bb88bab363874309357f9c945c9ed8c75bc'],315,404,719,294466,4,0,0,0.666666667,725
72f258cbdd2b5b59a35df8b45e6da6364cd8c915,1,Benjamin Reed,2009-11-17 23:38:49+00:00,['4a425c4e4911f1d4463f098a1c030b9920e391c0'],4,71,75,294541,3,0,0.9375,1,725
8db75b7fc3c911e3d039bb54715d0d1af28ec480,1,Benjamin Reed,2009-11-18 17:29:53+00:00,['72f258cbdd2b5b59a35df8b45e6da6364cd8c915'],9,10,19,294560,2,,,,725
989144a47532f26543291229e026efb11d4b5c48,1,Benjamin Reed,2009-11-18 17:44:56+00:00,['8db75b7fc3c911e3d039bb54715d0d1af28ec480'],0,10,10,294570,2,0,0,1,725
921710c6f184120e275d68351117fbcd4a209fb3,1,Benjamin Reed,2009-11-18 17:47:38+00:00,['989144a47532f26543291229e026efb11d4b5c48'],4,5,9,294579,2,,,,725
788c15be7363e475e8b050260623ec46c9ef8257,1,Mahadev Konar,2009-11-18 19:06:39+00:00,['921710c6f184120e275d68351117fbcd4a209fb3'],189,2523,2712,297291,51,0.33785822,0.719457014,0.978883861,738
12922f01c4df98acb915b5a3a02843b77672a20d,0,Patrick D. Hunt,2009-11-19 21:52:48+00:00,['788c15be7363e475e8b050260623ec46c9ef8257'],7,11,18,297309,1,,,,738
dd06b9e4595b18e8b877460e9721fb1ad1d55957,1,Patrick D. Hunt,2009-11-20 19:47:03+00:00,['12922f01c4df98acb915b5a3a02843b77672a20d'],493,516,1009,298318,4,,,,738
a62d0245c91f3ed70f0ee0833e3ec3799a24e377,1,Mahadev Konar,2009-11-20 22:28:38+00:00,['dd06b9e4595b18e8b877460e9721fb1ad1d55957'],9,261,270,298588,6,0.141176471,0.994117647,1,739
170dd6bb5952baef7b8299d819c82dc806e8e25a,1,Mahadev Konar,2009-11-25 19:06:08+00:00,['a62d0245c91f3ed70f0ee0833e3ec3799a24e377'],4,37,41,298629,2,0.590909091,0,1,739
adb0fa0abbcf9c578272a1f751531b38cd3ccc0a,1,Benjamin Reed,2009-11-26 13:36:46+00:00,['170dd6bb5952baef7b8299d819c82dc806e8e25a'],0,15,15,298644,2,,,,739
8de689292a6664dcfa1c0f0bff087b1d172537cc,0,Flavio Paiva Junqueira,2009-11-30 12:03:36+00:00,['adb0fa0abbcf9c578272a1f751531b38cd3ccc0a'],1,4,5,298649,2,,,,739
154647fa5d8cbb8e03dcace62707e1ce8f678fd6,1,Benjamin Reed,2009-12-02 18:36:24+00:00,['8de689292a6664dcfa1c0f0bff087b1d172537cc'],35,44,79,298728,2,0,0,0.333333333,739
1feeef99596f3db72ef731705deda47debf008bf,0,Mahadev Konar,2009-12-03 02:12:28+00:00,['154647fa5d8cbb8e03dcace62707e1ce8f678fd6'],0,5,5,298733,2,0,0,1,739
5ac3e719264a917674ded90490d5554c9a4da76c,1,Mahadev Konar,2009-12-03 22:30:44+00:00,['1feeef99596f3db72ef731705deda47debf008bf'],17,11,28,298761,2,1,1,0.571428571,739
6b9c7c225e6f6d4a763ea8cc4e1ccac7aa265915,1,Mahadev Konar,2009-12-04 23:47:30+00:00,['5ac3e719264a917674ded90490d5554c9a4da76c'],25,43,68,298829,2,0.428571429,0.428571429,1,739
9722b84b52b08e27a9f3170fc60f66e721128014,1,Mahadev Konar,2009-12-07 22:31:08+00:00,['6b9c7c225e6f6d4a763ea8cc4e1ccac7aa265915'],6,4,10,298839,2,0,0,0,739
9ecca8210ec1b065193984c1ff507ae5505ecbe1,0,Mahadev Konar,2009-12-08 01:20:42+00:00,['9722b84b52b08e27a9f3170fc60f66e721128014'],14,19,33,298872,2,1,1,1,739
6b85723d2db06b94af82b9e10d4c742838b2222e,1,Benjamin Reed,2009-12-11 19:38:47+00:00,['9ecca8210ec1b065193984c1ff507ae5505ecbe1'],2,6,8,298880,3,,,,739
c22c30d7c8c2ace2ad5f6675ccc6331310c0c144,1,Benjamin Reed,2009-12-11 20:24:23+00:00,['6b85723d2db06b94af82b9e10d4c742838b2222e'],43,79,122,299002,4,0.7,0.7,1,739
47356252a1371452afc3bf371f569cb815d71e29,1,Mahadev Konar,2009-12-11 21:46:06+00:00,['c22c30d7c8c2ace2ad5f6675ccc6331310c0c144'],6,17,23,299025,4,0,0.571428571,1,739
c387421cb46ea919b0759981ed9bd44123419c14,1,Henry Robinson,2009-12-11 22:42:19+00:00,['47356252a1371452afc3bf371f569cb815d71e29'],40,51,91,299116,10,1,1,1,739
2ed6485e9d503e68c8f9ab3d5655be88ab1e0851,1,Mahadev Konar,2009-12-11 23:03:33+00:00,['c387421cb46ea919b0759981ed9bd44123419c14'],57,87,144,299260,3,0.5,1,1,739
a8a73362bd9a3967c46011ded1ed831a586acd2e,1,Benjamin Reed,2009-12-15 22:23:55+00:00,['2ed6485e9d503e68c8f9ab3d5655be88ab1e0851'],211,338,549,299809,7,0.35,0.166666667,1,739
e8efba3f36b577e7dc41bb6ccfa30b370ae04a27,0,Patrick D. Hunt,2009-12-16 18:26:58+00:00,['a8a73362bd9a3967c46011ded1ed831a586acd2e'],11,20,31,299840,2,0.2,1,1,739
c1eb73fd1dd7635b4fcaf1b4ece84b57e7bbc5e6,0,Patrick D. Hunt,2009-12-16 18:28:51+00:00,['e8efba3f36b577e7dc41bb6ccfa30b370ae04a27'],236,3,239,300079,2,0.868217054,0,0,739
febdceb87f78038122574985f874af2ad56f1c72,1,Mahadev Konar,2009-12-16 23:27:38+00:00,['c1eb73fd1dd7635b4fcaf1b4ece84b57e7bbc5e6'],10,50,60,300139,4,0.733333333,1,1,739
ee258809459e60708ff30fcc2f09a7a856a81bc3,1,Mahadev Konar,2009-12-16 23:46:37+00:00,['febdceb87f78038122574985f874af2ad56f1c72'],8,147,155,300294,6,,,,741
75277a873629db46a61847c3b073d8ad0dbdce2a,0,Benjamin Reed,2009-12-17 17:36:19+00:00,['ee258809459e60708ff30fcc2f09a7a856a81bc3'],364,74,438,300732,8,0.343195266,0,0.088757396,741
983b66079abea732addd0d76a02d3a97b056a0e3,0,Benjamin Reed,2009-12-17 19:31:21+00:00,['75277a873629db46a61847c3b073d8ad0dbdce2a'],1,15,16,300748,2,,,,741
2ae786d5ccc463ea240efdf881585042ad8df42f,1,Benjamin Reed,2009-12-17 22:09:18+00:00,['983b66079abea732addd0d76a02d3a97b056a0e3'],50,73,123,300871,4,,,,741
ca72b976237a39f99672ca2ee9580fedd0ea28f2,0,Mahadev Konar,2009-12-17 23:38:33+00:00,['2ae786d5ccc463ea240efdf881585042ad8df42f'],19,35,54,300925,2,0,1,0.6,741
3ba0a5450cb5340a39154f872d920a580648de3c,1,Mahadev Konar,2009-12-18 02:19:50+00:00,['ca72b976237a39f99672ca2ee9580fedd0ea28f2'],205,761,966,301891,21,0.861702128,0.734042553,0.904255319,743
c083a36f5a290d2e04830236e465cd5fdf17c2e0,0,Flavio Paiva Junqueira,2010-01-05 14:04:28+00:00,['3ba0a5450cb5340a39154f872d920a580648de3c'],7,56,63,301954,5,,,,744
3ab8e2e2f87fc730a13181fa0e1e4ddb4ecadad3,0,Benjamin Reed,2010-01-05 17:32:35+00:00,['c083a36f5a290d2e04830236e465cd5fdf17c2e0'],16,142,158,302112,6,0.62962963,0.944444444,1,744
7a1109e0e4a72023cb4c98af878ec3768d69c815,1,Benjamin Reed,2010-01-05 17:38:44+00:00,['3ab8e2e2f87fc730a13181fa0e1e4ddb4ecadad3'],0,91,91,302203,5,,,,748
952e0f550807c5d331f9c6fbd1720846e5ff84d1,1,Benjamin Reed,2010-01-06 17:23:06+00:00,['7a1109e0e4a72023cb4c98af878ec3768d69c815'],1,4,5,302208,2,,,,748
bbfb463f82b01bc4b08305ea919a9d851b9486dd,0,Flavio Paiva Junqueira,2010-01-07 08:40:28+00:00,['952e0f550807c5d331f9c6fbd1720846e5ff84d1'],3,7,10,302218,2,,,,748
5b68d662bf3780edbe54576849af5ec620ce248a,1,Benjamin Reed,2010-01-12 22:02:27+00:00,['bbfb463f82b01bc4b08305ea919a9d851b9486dd'],0,2462,2462,304680,13,0.120378332,0.430782459,0.683576956,760
8d0272e4e6365832e892fcb7d9ed0e3b3169c906,0,Benjamin Reed,2010-01-12 22:04:33+00:00,['5b68d662bf3780edbe54576849af5ec620ce248a'],1,3,4,304684,2,,,,760
dafb6f5e2b48fdfcc6b077f95334eaedc2d1cf0c,0,Mahadev Konar,2010-01-14 20:04:07+00:00,['8d0272e4e6365832e892fcb7d9ed0e3b3169c906'],1,3,4,304688,2,,,,760
af79cf3ae01ea6a2b58533b34967acec6b99d74e,0,Henry Robinson,2010-01-19 20:06:37+00:00,['dafb6f5e2b48fdfcc6b077f95334eaedc2d1cf0c'],4,7,11,304699,2,,,,760
f2e91db611a0c936398f5b83cff47ee505aa1ea2,0,Mahadev Konar,2010-01-21 01:44:55+00:00,['af79cf3ae01ea6a2b58533b34967acec6b99d74e'],1,6,7,304706,2,0,0,1,760
773ed4078caf8d9b85330dc7d3aa91b330690e60,0,Mahadev Konar,2010-01-21 03:08:47+00:00,['f2e91db611a0c936398f5b83cff47ee505aa1ea2'],23,24,47,304753,2,1,1,0,760
f6264c94795a489309c23054451d1bf9078e7a68,1,Henry Robinson,2010-01-21 21:44:21+00:00,['773ed4078caf8d9b85330dc7d3aa91b330690e60'],193,487,680,305433,15,0,0.666666667,0.833333333,760
b4e31ff98c2c2bce326999361a27e89c4f79998c,0,Mahadev Konar,2010-01-22 00:49:22+00:00,['f6264c94795a489309c23054451d1bf9078e7a68'],4,7,11,305444,2,1,1,1,760
635896d619ac095022ddf005a0f37f28f0e089ef,1,Mahadev Konar,2010-01-23 00:31:09+00:00,['b4e31ff98c2c2bce326999361a27e89c4f79998c'],227,222,449,305893,4,,,,760
73f0ff946205e6054e72249fc0399c6e94b30a80,1,Henry Robinson,2010-01-25 03:28:40+00:00,['635896d619ac095022ddf005a0f37f28f0e089ef'],46,47,93,305986,28,,,,760
63f701585d4fedcd239c97a0d82bea58eca79f1d,0,Mahadev Konar,2010-01-25 03:35:14+00:00,['73f0ff946205e6054e72249fc0399c6e94b30a80'],1,3,4,305990,2,,,,760
5aea0fbbae6fab464b932339c00051f179eb0343,1,Mahadev Konar,2010-01-26 00:17:23+00:00,['63f701585d4fedcd239c97a0d82bea58eca79f1d'],453,860,1313,307303,17,0.30625,0.60625,0.975,760
f84a76cec527a895e7bed5e3a75be4e0e5c689a6,1,Mahadev Konar,2010-01-26 01:06:33+00:00,['5aea0fbbae6fab464b932339c00051f179eb0343'],35,97,132,307435,9,0,0.72972973,0.972972973,760
6492c7b6c42ec97461bd9a8048d2a18eccfe8dc3,0,Mahadev Konar,2010-01-26 02:03:56+00:00,['f84a76cec527a895e7bed5e3a75be4e0e5c689a6'],4,6,10,307445,2,,,,760
f0fad0f10e324b64bfafe0981732eecf38dbb3a3,0,Mahadev Konar,2010-01-26 02:22:40+00:00,['6492c7b6c42ec97461bd9a8048d2a18eccfe8dc3'],141,216,357,307802,8,0.392857143,1,1,760
ae541ace94f90ca00cd9086e617afb07791e3c76,0,Mahadev Konar,2010-01-26 02:56:43+00:00,['f0fad0f10e324b64bfafe0981732eecf38dbb3a3'],8,29,37,307839,3,0,1,1,760
acab74c55c38c45b8780de75402921c17c06bd03,0,Mahadev Konar,2010-01-26 03:11:19+00:00,['ae541ace94f90ca00cd9086e617afb07791e3c76'],4,9,13,307852,4,1,1,0,760
e1a1ee81f1aa930cae20fa3fc76485e45a95f066,1,Mahadev Konar,2010-01-26 23:16:45+00:00,['acab74c55c38c45b8780de75402921c17c06bd03'],6711,6345,13056,320908,62,1,1,0,787
d7b6d491746bafe769cf49818ef5984673240873,1,Mahadev Konar,2010-02-08 22:36:39+00:00,['e1a1ee81f1aa930cae20fa3fc76485e45a95f066'],6,7,13,320921,3,,,,787
a79444a33e154e3d5557842534e358464bc3cfd4,0,Mahadev Konar,2010-02-08 22:38:08+00:00,['d7b6d491746bafe769cf49818ef5984673240873'],1,1,2,320923,1,,,,787
d8c332f95dc9cac6ffc17fa98541de4b648a69b5,1,Mahadev Konar,2010-02-19 02:08:00+00:00,['a79444a33e154e3d5557842534e358464bc3cfd4'],157,60,217,321140,4,,,,787
fb29d381c86987905415e4f098854509e1d708de,0,Mahadev Konar,2010-02-19 02:33:37+00:00,['d8c332f95dc9cac6ffc17fa98541de4b648a69b5'],257,259,516,321656,10,,,,787
75abbb34e2d10b0c5fc955f76ffd17286922f14a,0,Mahadev Konar,2010-02-19 02:42:39+00:00,['fb29d381c86987905415e4f098854509e1d708de'],0,8,8,321664,2,,,,787
327b98b13d8d80a4eeda098ec7947e5e76071ceb,1,Mahadev Konar,2010-02-19 06:25:46+00:00,['75abbb34e2d10b0c5fc955f76ffd17286922f14a'],28,1238,1266,322930,7,,,,790
54bec37dabeaa6b65ab1d64b2e62ce412911a795,0,Mahadev Konar,2010-02-19 06:30:15+00:00,['327b98b13d8d80a4eeda098ec7947e5e76071ceb'],174,313,487,323417,4,,,,790
d20f44be6442a5d40ad54a6fd3f0c117c3e3eb13,1,Mahadev Konar,2010-02-19 07:02:06+00:00,['54bec37dabeaa6b65ab1d64b2e62ce412911a795'],129,1318,1447,324864,6,,,,792
a48ea12e5c455f3bb20ef42c3fe947561e82aa9c,0,Benjamin Reed,2010-02-20 00:50:08+00:00,['d20f44be6442a5d40ad54a6fd3f0c117c3e3eb13'],87,2,89,324953,2,0.775,0,0,792
b8ccc0c5708c11021a647dc4c1508499bc79cca2,1,Flavio Paiva Junqueira,2010-02-20 14:26:00+00:00,['a48ea12e5c455f3bb20ef42c3fe947561e82aa9c'],39,240,279,325232,5,0.163043478,0.532608696,1,793
6d3844bf7716e379e4974df39ca524fab886e149,0,Mahadev Konar,2010-02-23 18:22:34+00:00,['b8ccc0c5708c11021a647dc4c1508499bc79cca2'],4,5,9,325241,2,0,0,0,793
7c30839a67e99b7efc44bb39f2370814f1d76856,0,Mahadev Konar,2010-02-24 20:04:06+00:00,['6d3844bf7716e379e4974df39ca524fab886e149'],608,780,1388,326629,4,,,,793
6a915d89d23d0323ffbfb2932c52f6c796d17a6d,1,Mahadev Konar,2010-03-03 22:57:14+00:00,['7c30839a67e99b7efc44bb39f2370814f1d76856'],459,474,933,327562,4,,,,793
90dd37368463c49c1415564896d4141cdb674a6b,1,Mahadev Konar,2010-03-03 23:07:21+00:00,['6a915d89d23d0323ffbfb2932c52f6c796d17a6d'],10,99,109,327671,4,0.1875,0,1,793
691dfa44b48240a8917883f3065e3b25e633a58c,1,Mahadev Konar,2010-03-04 01:28:41+00:00,['90dd37368463c49c1415564896d4141cdb674a6b'],1,16,17,327688,3,0,0,1,793
cf0495acc9e53f96e1588f7812b02fe278621d32,1,Mahadev Konar,2010-03-04 20:10:19+00:00,['691dfa44b48240a8917883f3065e3b25e633a58c'],9,72,81,327769,5,,,,793
a2e02538cd652f8a58bdd738ccfd78b69a9165b7,1,Mahadev Konar,2010-03-04 22:55:36+00:00,['cf0495acc9e53f96e1588f7812b02fe278621d32'],43,45,88,327857,5,,,,793
23d4f2b1a237a3bcdcfe8f316c26a55c1d71ca6b,1,Mahadev Konar,2010-03-05 02:27:20+00:00,['a2e02538cd652f8a58bdd738ccfd78b69a9165b7'],108,110,218,328075,4,,,,793
9acd61b97abc7ee4153e4670dcf11a80c27b64ed,0,Mahadev Konar,2010-03-05 03:47:38+00:00,['23d4f2b1a237a3bcdcfe8f316c26a55c1d71ca6b'],14,123,137,328212,4,0.626865672,1,0.880597015,794
945d570e2e2d2a7aa77fd35d5b50114b0f66e0c7,1,Mahadev Konar,2010-03-05 22:03:04+00:00,['9acd61b97abc7ee4153e4670dcf11a80c27b64ed'],484,619,1103,329315,4,,,,794
a4e9208398d9c55d5412596dc7bbdb510a839169,1,Mahadev Konar,2010-03-06 05:33:29+00:00,['945d570e2e2d2a7aa77fd35d5b50114b0f66e0c7'],4,12,16,329331,2,0,0,1,794
32a5d09b3bc5088e32b065fd3c011628ca37dbed,1,Patrick D. Hunt,2010-03-09 01:06:15+00:00,['a4e9208398d9c55d5412596dc7bbdb510a839169'],6,5349,5355,334686,52,0.207723577,0.454471545,0.667886179,845
0051cd26087492fe393932d9fdac1f7bff8b7ac4,1,Henry Robinson,2010-03-09 01:18:55+00:00,['32a5d09b3bc5088e32b065fd3c011628ca37dbed'],430,487,917,335603,16,1,1,1,845
4b16ebc144b164434f4aca40f103c216e6a4ced3,0,Mahadev Konar,2010-03-09 01:50:39+00:00,['0051cd26087492fe393932d9fdac1f7bff8b7ac4'],1,5,6,335609,2,,,,845
ab5aa8c07299b04cccf3d2ca8b5c59db4f69af56,0,Mahadev Konar,2010-03-09 02:00:46+00:00,['4b16ebc144b164434f4aca40f103c216e6a4ced3'],17,24,41,335650,2,0,0,0,845
f582494d46c662658f81338471acf9c40f8d6996,0,Mahadev Konar,2010-03-09 02:09:15+00:00,['ab5aa8c07299b04cccf3d2ca8b5c59db4f69af56'],1,45,46,335696,2,0,1,1,845
dc9671d387830ccdea3faade5e7f388cb10518ae,1,Benjamin Reed,2010-03-09 04:44:26+00:00,['f582494d46c662658f81338471acf9c40f8d6996'],249,485,734,336430,36,0.39047619,0.857142857,0.695238095,846
618b01886c3fc18fdca9cbe36eacc3615d72563a,1,Mahadev Konar,2010-03-09 20:50:14+00:00,['dc9671d387830ccdea3faade5e7f388cb10518ae'],1,4,5,336435,2,,,,846
f0da09751b34ad6969656df34bea7201632ef0ba,1,Benjamin Reed,2010-03-10 01:27:14+00:00,['618b01886c3fc18fdca9cbe36eacc3615d72563a'],13,224,237,336672,6,0.166666667,0.202898551,0.927536232,846
0c9ba838da1c3f98a99bbbabb237d5c9cc5e29ba,1,Benjamin Reed,2010-03-10 16:32:22+00:00,['f0da09751b34ad6969656df34bea7201632ef0ba'],8,61,69,336741,5,0.741935484,0.741935484,1,846
402f64c14e3d51ba6426a7a570e4da1bfc43e005,0,Mahadev Konar,2010-03-10 18:14:54+00:00,['0c9ba838da1c3f98a99bbbabb237d5c9cc5e29ba'],1,3,4,336745,2,,,,846
892c491e49f8f2333308f10a6fb4367772625b07,1,Patrick D. Hunt,2010-03-10 18:52:11+00:00,['402f64c14e3d51ba6426a7a570e4da1bfc43e005'],2,33,35,336780,6,0,1,1,846
df20416c08fa0079d96f6327d10c6f102ebabd85,1,Mahadev Konar,2010-03-11 03:17:04+00:00,['892c491e49f8f2333308f10a6fb4367772625b07'],74,114,188,336968,5,0.578947368,0.578947368,1,846
42e23d3a7d70964d177e9c10cae736912aff5521,0,Flavio Paiva Junqueira,2010-03-11 14:05:15+00:00,['df20416c08fa0079d96f6327d10c6f102ebabd85'],1,12,13,336981,2,0,0,1,846
b99ef6bc93b7d27ee9359bcd1b4d56856445394d,1,Mahadev Konar,2010-03-12 18:26:45+00:00,['42e23d3a7d70964d177e9c10cae736912aff5521'],75,454,529,337510,21,0.554347826,0.907608696,0.891304348,847
08f78e034bd5d6fc0ba1b337bf39d5d6dd0db1fc,1,Mahadev Konar,2010-03-12 21:44:12+00:00,['b99ef6bc93b7d27ee9359bcd1b4d56856445394d'],2,7,9,337519,2,,,,847
f9413133fdc674bb7b9de43cdd652df416f4a9f0,1,Mahadev Konar,2010-03-12 22:36:12+00:00,['08f78e034bd5d6fc0ba1b337bf39d5d6dd0db1fc'],19,74,93,337612,9,0.36,1,0.92,847
e419600dff67353429353aef419d856e3935af8b,1,Patrick D. Hunt,2010-03-13 00:06:55+00:00,['f9413133fdc674bb7b9de43cdd652df416f4a9f0'],92,43,135,337747,18,0,0.181818182,0,847
037d07cb711b54558593b56d5d25ddfa24a6084d,1,Mahadev Konar,2010-03-14 04:01:05+00:00,['e419600dff67353429353aef419d856e3935af8b'],2,10,12,337759,2,1,1,1,847
f4138613a151f0383bf55ea0608708acbe070cc5,1,Patrick D. Hunt,2010-03-16 21:23:07+00:00,['037d07cb711b54558593b56d5d25ddfa24a6084d'],11,28,39,337798,6,0,0,1,847
5749256a08bb3d9cc584a285938bdf14a36dec66,0,Benjamin Reed,2010-03-16 22:25:58+00:00,['f4138613a151f0383bf55ea0608708acbe070cc5'],6,15,21,337819,6,1,1,1,847
fa66a48f63230553060e5024ad8670a315e82a65,1,Benjamin Reed,2010-03-16 23:20:59+00:00,['5749256a08bb3d9cc584a285938bdf14a36dec66'],238,362,600,338419,6,0.850134409,0.72983871,0.57594086,847
8c2d084e9b77bfa10a686c292af4e927de3828ad,0,Mahadev Konar,2010-03-17 00:05:24+00:00,['fa66a48f63230553060e5024ad8670a315e82a65'],1,29,30,338449,3,0.8125,1,0.8125,847
27c20471bcef452f4535aa27cce89c94c73dea74,1,Mahadev Konar,2010-03-17 04:14:52+00:00,['8c2d084e9b77bfa10a686c292af4e927de3828ad'],5,51,56,338505,3,1,1,0.75,847
14e09d6340d06042e5ba032f268aa068c3bcd09a,0,Patrick D. Hunt,2010-03-17 22:12:37+00:00,['27c20471bcef452f4535aa27cce89c94c73dea74'],1,4,5,338510,2,,,,847
b3a81ce65a1dca4da19f27817871af4738a6a4dc,1,Patrick D. Hunt,2010-03-18 06:23:21+00:00,['14e09d6340d06042e5ba032f268aa068c3bcd09a'],1,5,6,338516,2,,,,847
d688f88b1452b2156f45e3181a34ae340704df3c,1,Patrick D. Hunt,2010-03-18 06:48:15+00:00,['b3a81ce65a1dca4da19f27817871af4738a6a4dc'],1,4,5,338521,2,,,,847
65fc5e579a1e659a3977808dffe51e2a436afa86,0,Benjamin Reed,2010-03-18 18:39:50+00:00,['d688f88b1452b2156f45e3181a34ae340704df3c'],27,79,106,338627,8,0.888888889,0.944444444,0,847
b1c614b2ca982b2e029d11605717846af790870f,0,Benjamin Reed,2010-03-19 06:46:36+00:00,['65fc5e579a1e659a3977808dffe51e2a436afa86'],20,54,74,338701,4,0.294117647,0,1,847
11ff2ef50de57ef8f888586a2806c40c056112ea,1,Mahadev Konar,2010-03-19 17:23:09+00:00,['b1c614b2ca982b2e029d11605717846af790870f'],1078,1156,2234,340935,4,,,,847
cdc234855fdc476f9fa794120f58d635cc5485d8,0,Mahadev Konar,2010-03-19 17:27:11+00:00,['11ff2ef50de57ef8f888586a2806c40c056112ea'],0,3,3,340938,2,,,,847
f8f4ce353d4a3624b47e757737dd877cfad3e169,0,Mahadev Konar,2010-03-19 17:29:50+00:00,['cdc234855fdc476f9fa794120f58d635cc5485d8'],0,28,28,340966,2,0.235294118,0.235294118,0.235294118,847
abc87ce188827d41e7e596fd1c3a3df0ca9f56e5,0,Patrick D. Hunt,2010-03-19 18:04:40+00:00,['f8f4ce353d4a3624b47e757737dd877cfad3e169'],1,1,2,340968,1,,,,847
fffe0e0f1e2275899db903a925d68af53fd32dac,1,Patrick D. Hunt,2010-03-19 18:13:34+00:00,['abc87ce188827d41e7e596fd1c3a3df0ca9f56e5'],24,39,63,341031,25,,,,847
a1a877a468b9bf1adeace989cb0e55d74a1e5d5f,1,Mahadev Konar,2010-03-31 04:26:29+00:00,['fffe0e0f1e2275899db903a925d68af53fd32dac'],1249,1044,2293,343324,69,0.104761905,0,0,847
78269a99bc9eb74f99d267017033ea1d13531c5a,1,Mahadev Konar,2010-03-31 14:58:00+00:00,['a1a877a468b9bf1adeace989cb0e55d74a1e5d5f'],0,133,133,343457,2,0.547619048,1,1,849
af80eeedfc5347eb96de33a8f076f2169a7771e2,1,Mahadev Konar,2010-04-08 18:22:45+00:00,['78269a99bc9eb74f99d267017033ea1d13531c5a'],3,32,35,343492,4,,,,849
7ac6891efbf48f12a1b89df4127e56708cc8519b,1,Patrick D. Hunt,2010-04-12 06:19:13+00:00,['af80eeedfc5347eb96de33a8f076f2169a7771e2'],11,15,26,343518,3,,,,849
1c07468bf45581bc17b19ba16fae0cc785a3d356,1,Patrick D. Hunt,2010-04-12 06:31:47+00:00,['7ac6891efbf48f12a1b89df4127e56708cc8519b'],1,4,5,343523,2,,,,849
318820301c8a377af8eeb126828cfeb361ea0498,1,Henry Robinson,2010-04-15 07:23:44+00:00,['1c07468bf45581bc17b19ba16fae0cc785a3d356'],1,220,221,343744,4,0.209090909,0.972727273,0.890909091,850
6ad91e3ff0b8f6b956c4d5cac596562c46947c96,0,Patrick D. Hunt,2010-04-22 05:42:51+00:00,['318820301c8a377af8eeb126828cfeb361ea0498'],1933,236,2169,345913,29,0.428571429,1,0.795918367,851
4e820e33bf4d1fb4c3d1c0fab981f6ba0c363a03,1,Patrick D. Hunt,2010-04-22 06:06:18+00:00,['6ad91e3ff0b8f6b956c4d5cac596562c46947c96'],482,788,1270,347183,2,0,0,0.861111111,851
22e330464a7c33f96137b8482e44f8ec8f86b78c,0,Henry Robinson,2010-04-26 04:17:50+00:00,['4e820e33bf4d1fb4c3d1c0fab981f6ba0c363a03'],1,4,5,347188,2,,,,851
73719a1081b542fa7557513a0535fcb9c503ab64,1,Patrick D. Hunt,2010-04-26 18:54:06+00:00,['22e330464a7c33f96137b8482e44f8ec8f86b78c'],1,4,5,347193,2,,,,851
7ecd589c1511770b96bf034a5cd7d322bbe56bc5,1,Patrick D. Hunt,2010-04-26 19:58:59+00:00,['73719a1081b542fa7557513a0535fcb9c503ab64'],3,20,23,347216,3,0,1,0.5,851
2c161ea40a6dea6cc5b10de518371f0a15fdbc74,0,Patrick D. Hunt,2010-04-27 22:45:23+00:00,['7ecd589c1511770b96bf034a5cd7d322bbe56bc5'],44,47,91,347307,4,,,,851
2e4157ccb3e6c060ef5a54a15df359a87ab29277,1,Henry Robinson,2010-04-29 01:58:48+00:00,['2c161ea40a6dea6cc5b10de518371f0a15fdbc74'],15,48,63,347370,3,,,,851
dd8f018c05d06ae33f524f45a77bafdd4a64ba11,1,Henry Robinson,2010-04-30 22:50:13+00:00,['2e4157ccb3e6c060ef5a54a15df359a87ab29277'],2,42,44,347414,3,0.064516129,0.064516129,1,851
28ef0625fde431d911a47de90bc9eb655812c657,1,Patrick D. Hunt,2010-05-03 21:49:49+00:00,['dd8f018c05d06ae33f524f45a77bafdd4a64ba11'],19,523,542,347956,17,0.395,0.585,0.8425,852
2470b06a967ad18d8ba0b0c6dc52b5fd0965a385,1,Mahadev Konar,2010-05-04 21:45:13+00:00,['28ef0625fde431d911a47de90bc9eb655812c657'],220,373,593,348549,3,1,1,0.986111111,852
472c93adc6e4dfc7dbb7b5a95d211dce09cc154f,1,Mahadev Konar,2010-05-05 20:32:33+00:00,['2470b06a967ad18d8ba0b0c6dc52b5fd0965a385'],24,43,67,348616,10,0.461538462,0.615384615,1,852
f781b707210da366de11d3118ff0eb0f1e76f81c,0,Patrick D. Hunt,2010-05-05 21:53:04+00:00,['472c93adc6e4dfc7dbb7b5a95d211dce09cc154f'],3,59,62,348678,4,1,1,1,853
2f4e80d0172ada5cca58800b479889ee43f43ee4,1,Mahadev Konar,2010-05-05 22:41:14+00:00,['f781b707210da366de11d3118ff0eb0f1e76f81c'],71,110,181,348859,4,,,,853
38592a9e79e8c5f8ba8d6a709c7c28e7084030fc,1,Flavio Paiva Junqueira,2010-05-13 20:23:35+00:00,['2f4e80d0172ada5cca58800b479889ee43f43ee4'],271,912,1183,350042,18,0.168181818,0.277272727,0.986363636,853
001cdf3b5d180c58561940b6fa1b251928181f12,0,Flavio Paiva Junqueira,2010-05-14 07:04:41+00:00,['38592a9e79e8c5f8ba8d6a709c7c28e7084030fc'],0,243,243,350285,2,0.454545455,0.675324675,0.662337662,855
eef40c00214c2440e3a0e18d6ea1bc707164e32d,0,Patrick D. Hunt,2010-05-14 23:32:20+00:00,['001cdf3b5d180c58561940b6fa1b251928181f12'],22,47,69,350354,4,,,,855
805789eeb13d44d87ea680567fd96c7ddc5c94f0,0,Patrick D. Hunt,2010-05-19 06:37:49+00:00,['eef40c00214c2440e3a0e18d6ea1bc707164e32d'],1,33,34,350388,3,1,1,1,855
1987aaa78a5efbd0560a30b751d089e6fb4d5801,0,Patrick D. Hunt,2010-05-19 07:37:38+00:00,['805789eeb13d44d87ea680567fd96c7ddc5c94f0'],3,32,35,350423,3,,,,855
44e2475ed44024f45ed06b9095c832d7750cfff7,1,Henry Robinson,2010-05-21 16:22:52+00:00,['1987aaa78a5efbd0560a30b751d089e6fb4d5801'],0,103,103,350526,3,0,0,1,855
6bb8b641c65185eefd252e1fe38a933fe11bbceb,1,Patrick D. Hunt,2010-06-09 15:26:22+00:00,['44e2475ed44024f45ed06b9095c832d7750cfff7'],0,9734,9734,360260,59,0.388621444,0.49861415,0.712035011,913
f8583e170a56a2ce473d6a90dc77bbafb956ffee,0,Patrick D. Hunt,2010-06-25 20:08:12+00:00,['6bb8b641c65185eefd252e1fe38a933fe11bbceb'],8,14,22,360282,4,0,0,1,913
2a8a3063d64fb935ca4136ba10bb15efeb97d52e,1,Patrick D. Hunt,2010-07-05 18:20:22+00:00,['f8583e170a56a2ce473d6a90dc77bbafb956ffee'],13,180,193,360475,10,0.261904762,0.952380952,1,913
49a05a7bdbb183ee594a6b518d580b07fd35e59e,1,Patrick D. Hunt,2010-07-05 19:50:05+00:00,['2a8a3063d64fb935ca4136ba10bb15efeb97d52e'],279,286,565,361040,2,1,1,1,913
a59f144fbc1990ec5a6a1394ab893d55094acbfb,0,Patrick D. Hunt,2010-07-05 19:57:43+00:00,['49a05a7bdbb183ee594a6b518d580b07fd35e59e'],7,6,13,361053,2,,,,913
e22b26454ee215f40e907335484f909de5e377a7,0,Patrick D. Hunt,2010-07-05 20:32:03+00:00,['a59f144fbc1990ec5a6a1394ab893d55094acbfb'],0,5,5,361058,2,,,,913
089dfe6c64c8c3e31db49a52017018b65af0586b,1,Patrick D. Hunt,2010-07-06 21:50:25+00:00,['e22b26454ee215f40e907335484f909de5e377a7'],1,6,7,361065,2,,,,913
8953aabcb954bcd8f6827d450f70b77e2a6e81ca,1,Benjamin Reed,2010-07-09 20:53:36+00:00,['089dfe6c64c8c3e31db49a52017018b65af0586b'],15,162,177,361242,10,0,0,0.803738318,913
29ccd07f651c101d4f6b6de6c9d185da0ab5944d,1,Benjamin Reed,2010-07-09 21:17:57+00:00,['8953aabcb954bcd8f6827d450f70b77e2a6e81ca'],5,1233,1238,362480,9,0.300403226,0.747983871,0.467741935,915
2dc07d7eca5da3e3ab4f7e33789a545db01177fd,1,Patrick D. Hunt,2010-07-14 06:39:32+00:00,['29ccd07f651c101d4f6b6de6c9d185da0ab5944d'],2,1190,1192,363672,17,0.660493827,0.748971193,0.843621399,931
debd8a0368f8c81af33691c9d402990bb0976fd5,1,Benjamin Reed,2010-07-23 04:22:27+00:00,['2dc07d7eca5da3e3ab4f7e33789a545db01177fd'],28,169,197,363869,6,0.120481928,0,1,931
957b54a6a0f0b221ef463cf856d2f8d8e0095be2,1,Mahadev Konar,2010-07-26 21:48:47+00:00,['debd8a0368f8c81af33691c9d402990bb0976fd5'],1,13,14,363883,3,0.428571429,1,1,931
fc6b7c0357344a80a038b8e8c55fce95b1af0214,0,Mahadev Konar,2010-07-26 22:00:07+00:00,['957b54a6a0f0b221ef463cf856d2f8d8e0095be2'],0,174,174,364057,13,,,,931
2ae181498d46d0b5393157a63f3a9fcf71c667bd,1,Mahadev Konar,2010-07-26 22:44:12+00:00,['fc6b7c0357344a80a038b8e8c55fce95b1af0214'],2,9,11,364068,2,1,1,1,931
e096ab3ab7410ef23819fdfbce60b61a907566ad,0,Mahadev Konar,2010-07-27 15:11:04+00:00,['2ae181498d46d0b5393157a63f3a9fcf71c667bd'],0,212,212,364280,3,0.615384615,1,0.492307692,933
2678baf5c1e0789d3acead9e91ac7f64e70d7e48,1,Mahadev Konar,2010-07-29 21:10:36+00:00,['e096ab3ab7410ef23819fdfbce60b61a907566ad'],28,333,361,364641,7,0.291666667,0.744047619,0.970238095,934
b95f1ca96a76ec848519cd9d58b9ea35f8d75a25,0,Mahadev Konar,2010-08-05 07:09:02+00:00,['2678baf5c1e0789d3acead9e91ac7f64e70d7e48'],3,57,60,364701,3,0.435897436,1,1,934
b4337499e5c2864adcade4fbdab77cef93dad1b1,1,Patrick D. Hunt,2010-08-17 07:24:09+00:00,['b95f1ca96a76ec848519cd9d58b9ea35f8d75a25'],299,2075,2374,367075,35,0.663978495,0.860215054,0.751344086,952
09165ab0f7d7992bcf8cc43b734d91c728e42bad,1,Patrick D. Hunt,2010-08-18 05:47:51+00:00,['b4337499e5c2864adcade4fbdab77cef93dad1b1'],0,1467,1467,368542,28,0.642105263,0.810526316,0.584210526,979
30cff66e5efe6b99b7e7a2293061f0eea0def02f,1,Patrick D. Hunt,2010-08-18 06:24:08+00:00,['09165ab0f7d7992bcf8cc43b734d91c728e42bad'],1244,3137,4381,372923,63,0.430173293,0.747196738,0.890927625,989
c16f5b46bc8ab67fd66d789bddfe5eb092542ea6,1,Mahadev Konar,2010-08-19 21:25:13+00:00,['30cff66e5efe6b99b7e7a2293061f0eea0def02f'],0,28022,28022,400945,212,0.522683447,0.780574444,0.791434081,1200
08e61fd9e969d2f113a1b3959b199a5176b59b61,0,Henry Robinson,2010-08-23 02:53:53+00:00,['c16f5b46bc8ab67fd66d789bddfe5eb092542ea6'],3,9,12,400957,2,0,0.333333333,1,1200
a4f6dc7cbc951b9520347a773c09d60721b1cab0,0,Mahadev Konar,2010-08-28 16:10:27+00:00,['08e61fd9e969d2f113a1b3959b199a5176b59b61'],8,13,21,400978,3,0,1,1,1200
efa17f96f0d53e2dd8754ab44cd41f50b9df1076,1,Henry Robinson,2010-08-30 21:04:58+00:00,['a4f6dc7cbc951b9520347a773c09d60721b1cab0'],3,8,11,400989,3,1,1,1,1200
7eaf3d1422c40532986d8d767d59a8f56705c129,0,Mahadev Konar,2010-09-07 18:29:05+00:00,['efa17f96f0d53e2dd8754ab44cd41f50b9df1076'],0,4,4,400993,2,,,,1201
0850cf2fdf8ffd32b61e9b5a2b97955dcc6e8997,1,Patrick D. Hunt,2010-09-08 18:28:56+00:00,['7eaf3d1422c40532986d8d767d59a8f56705c129'],2,7,9,401002,2,0,1,1,1201
46c1493fac179d12acd5ac33aadae6549a0dd2fd,0,Benjamin Reed,2010-09-10 16:13:11+00:00,['0850cf2fdf8ffd32b61e9b5a2b97955dcc6e8997'],1,9,10,401012,2,0,0,1,1201
aeee6a849dd7404d76307d60fdb2b573e51aa523,1,Patrick D. Hunt,2010-09-14 21:05:43+00:00,['46c1493fac179d12acd5ac33aadae6549a0dd2fd'],25,123,148,401160,6,0.315789474,0.736842105,1,1202
575dcbb4ece807662af3b38fdffb6ad512025a63,0,Patrick D. Hunt,2010-09-15 05:51:44+00:00,['aeee6a849dd7404d76307d60fdb2b573e51aa523'],4,21,25,401185,3,0,0,1,1202
e1109ed7d6353fae077e81d2cdb010b570677ee3,0,Benjamin Reed,2010-09-17 16:58:07+00:00,['575dcbb4ece807662af3b38fdffb6ad512025a63'],55,133,188,401373,4,0.263157895,0.394736842,0.368421053,1202
f9f2f0f5242f007e866b65e9624ce0affe6960d7,1,Patrick D. Hunt,2010-09-22 06:36:39+00:00,['e1109ed7d6353fae077e81d2cdb010b570677ee3'],3,9,12,401385,2,0,0,0,1202
51cc82c2fe2848eebb8c1537efe775d24aa713aa,1,Mahadev Konar,2010-10-05 22:45:46+00:00,['f9f2f0f5242f007e866b65e9624ce0affe6960d7'],0,12,12,401397,2,,,,1202
b6c3c7a94bbe873afcf7e25f98344d5dcb25b2d0,1,Patrick D. Hunt,2010-10-06 16:14:43+00:00,['51cc82c2fe2848eebb8c1537efe775d24aa713aa'],3,62,65,401462,4,0.852941176,0.823529412,1,1202
472048297814559b81251dcca98ee662ea09f14d,1,Patrick D. Hunt,2010-10-06 17:01:53+00:00,['b6c3c7a94bbe873afcf7e25f98344d5dcb25b2d0'],19,110,129,401591,4,0,0,1,1202
b1d9f0a3ca379d5fbc5543bfd2c4bb875517357e,1,Benjamin Reed,2010-10-11 19:00:42+00:00,['472048297814559b81251dcca98ee662ea09f14d'],971,2218,3189,404780,40,0,0.7239819,0.457013575,1212
fe2f2ced4efd1ce615f1f5efc007d6463278ae7b,1,Benjamin Reed,2010-10-11 20:54:25+00:00,['b1d9f0a3ca379d5fbc5543bfd2c4bb875517357e'],5,12,17,404797,2,0,0,0,1212
06834b9a48c4753701917cb890829241939ad9c6,1,Benjamin Reed,2010-10-15 05:21:26+00:00,['fe2f2ced4efd1ce615f1f5efc007d6463278ae7b'],1,2,3,404800,2,1,0,0,1212
aa46cbd04b8bef569575a8fe9932c74dda10995e,1,Flavio Paiva Junqueira,2010-10-18 21:55:02+00:00,['06834b9a48c4753701917cb890829241939ad9c6'],416,579,995,405795,14,,,,1212
ac85ac93af08b5292654422459d5ea4fea0373d4,1,Henry Robinson,2010-10-19 18:57:02+00:00,['aa46cbd04b8bef569575a8fe9932c74dda10995e'],3,7,10,405805,3,,0,,1212
51dd9c039f70da96b4a5755f372ffcdc8009824b,1,Patrick D. Hunt,2010-10-19 22:32:09+00:00,['ac85ac93af08b5292654422459d5ea4fea0373d4'],19,90,109,405914,3,0,0.853658537,1,1212
6858c10334bce9d00c1445af35488f484a0d5140,0,Patrick D. Hunt,2010-10-20 16:25:04+00:00,['51dd9c039f70da96b4a5755f372ffcdc8009824b'],1,4,5,405919,2,,,,1212
478c37213eedcaa4e9a55990f0d99c633300a5b1,0,Patrick D. Hunt,2010-10-20 18:41:03+00:00,['6858c10334bce9d00c1445af35488f484a0d5140'],5,24,29,405948,2,,,,1212
d43038a0c8b8881fb4624ef20a7b30b8511e6b24,0,Patrick D. Hunt,2010-10-21 00:44:05+00:00,['478c37213eedcaa4e9a55990f0d99c633300a5b1'],114,159,273,406221,3,0.189189189,0.675675676,1,1212
519a45264453bf788a166d99e276869ced913daa,0,Mahadev Konar,2010-10-21 22:12:50+00:00,['d43038a0c8b8881fb4624ef20a7b30b8511e6b24'],0,18,18,406239,3,0,1,1,1212
8030fe25eaa4a8dc50c28f464c448575da4f9ad4,0,Mahadev Konar,2010-10-26 22:30:06+00:00,['519a45264453bf788a166d99e276869ced913daa'],4,33,37,406276,3,0,0.894736842,0.894736842,1212
fc0f266c93838cf6676306617b2f82283f9a6f15,0,Mahadev Konar,2010-10-28 16:19:52+00:00,['8030fe25eaa4a8dc50c28f464c448575da4f9ad4'],1,7,8,406284,2,,,,1212
5e530bd830f1ad39a3431dd8bd44a83632de2f1c,0,Mahadev Konar,2010-10-28 18:49:17+00:00,['fc0f266c93838cf6676306617b2f82283f9a6f15'],3,7,10,406294,2,,,,1212
dad9d5791ba9f8db74e9c94ae9a063a7919cf8ef,0,Benjamin Reed,2010-11-04 16:01:51+00:00,['5e530bd830f1ad39a3431dd8bd44a83632de2f1c'],11,60,71,406365,7,0,0.820512821,1,1212
9ef18fd3788eb37c90888e2cd12c84251e4db1aa,0,Benjamin Reed,2010-11-05 05:16:46+00:00,['dad9d5791ba9f8db74e9c94ae9a063a7919cf8ef'],74,76,150,406515,21,,,,1212
c7ab72d2dce6ab4cd8916e3e4105fadf9092a694,1,Benjamin Reed,2010-11-05 06:43:56+00:00,['9ef18fd3788eb37c90888e2cd12c84251e4db1aa'],1,48,49,406564,3,0.09375,1,1,1212
6f8b8d2383fedd6fd4d792a40f8fbe85d3a7651c,1,Nigel Daley,2010-11-09 07:49:00+00:00,['c7ab72d2dce6ab4cd8916e3e4105fadf9092a694'],0,714,714,407278,3,,,,1214
d577dbc4e7c97bb55c3f464bbe30874495b31c70,0,Nigel Daley,2010-11-09 07:54:30+00:00,['6f8b8d2383fedd6fd4d792a40f8fbe85d3a7651c'],3,0,3,407281,1,,,,1214
1b1d1bc68c9087e9f4ef687f5d5ce5d7c9be538b,0,Nigel Daley,2010-11-09 08:15:18+00:00,['d577dbc4e7c97bb55c3f464bbe30874495b31c70'],23,4,27,407308,1,,,,1214
cf75a4db7318ce00541da31d363ad93e04923a36,1,Nigel Daley,2010-11-09 18:15:26+00:00,['1b1d1bc68c9087e9f4ef687f5d5ce5d7c9be538b'],33,25,58,407366,2,,,,1214
d66faf25479ff3b0f0238fbc06458641126f5f69,1,Nigel Daley,2010-11-09 18:20:57+00:00,['cf75a4db7318ce00541da31d363ad93e04923a36'],17,15,32,407398,2,,,,1214
ae607423216819ddc13869e6abd21140cc2c51cd,1,Nigel Daley,2010-11-09 18:57:56+00:00,['d66faf25479ff3b0f0238fbc06458641126f5f69'],34,2,36,407434,2,,,,1214
b67088488ed98f2d21dc374a5a67be622cd8e046,1,Patrick D. Hunt,2010-11-10 22:36:34+00:00,['ae607423216819ddc13869e6abd21140cc2c51cd'],419,681,1100,408534,10,1,1,0.232876712,1216
524dbc6be1e064092a06c7928ce8feea092ab898,1,Patrick D. Hunt,2010-11-11 17:11:55+00:00,['b67088488ed98f2d21dc374a5a67be622cd8e046'],52,48,100,408634,4,1,0.833333333,0.25,1216
6470dc244bbb3e30162ea12e7fb7d92a6074fd9d,0,Benjamin Reed,2010-11-16 18:25:49+00:00,['524dbc6be1e064092a06c7928ce8feea092ab898'],243,177,420,409054,17,0.7,1,0.2,1216
09580032cb9cdcc694d0adae9f1cb897f9a5c215,1,Flavio Paiva Junqueira,2010-11-17 14:59:29+00:00,['6470dc244bbb3e30162ea12e7fb7d92a6074fd9d'],187,237,424,409478,4,1,1,1,1216
8b7ca576096ee541ad53e9a74a4c5483ab9922c7,0,Nigel Daley,2010-11-19 18:12:20+00:00,['09580032cb9cdcc694d0adae9f1cb897f9a5c215'],5,6,11,409489,1,,,,1216
fb9247c617f158f39612bf4dfc7343f101d98a1e,0,Patrick D. Hunt,2010-11-24 21:20:03+00:00,['8b7ca576096ee541ad53e9a74a4c5483ab9922c7'],0,0,0,409489,0,,,,1216
18c58fa390c47b74d2af7ffca7b87610568b37f5,1,Benjamin Reed,2010-11-30 20:16:35+00:00,['fb9247c617f158f39612bf4dfc7343f101d98a1e'],83,469,552,410041,8,0.912,1,1,1221
78edf6a7e86622225292b603049e2f15951df11d,0,Mahadev Konar,2010-12-07 19:01:58+00:00,['18c58fa390c47b74d2af7ffca7b87610568b37f5'],1,3,4,410045,2,,,,1221
1f56eacc9b3f56cdafaa0b4c16bb78ecd0ba68bc,1,Mahadev Konar,2010-12-07 19:15:33+00:00,['78edf6a7e86622225292b603049e2f15951df11d'],5,20,25,410070,2,,,,1221
0e604b1006d0edc079004639e63477a800f2f9f5,1,Benjamin Reed,2010-12-08 19:29:34+00:00,['1f56eacc9b3f56cdafaa0b4c16bb78ecd0ba68bc'],20,129,149,410219,4,0.590909091,0.909090909,0.909090909,1222
db0c2cccae39f93d7dd38a6d2c304a563aa73090,1,Mahadev Konar,2010-12-15 03:14:31+00:00,['0e604b1006d0edc079004639e63477a800f2f9f5'],2,4,6,410225,2,,,,1222
0f44ca750b5de683734b1eb22c31117512d5e6f0,0,Mahadev Konar,2010-12-21 19:32:58+00:00,['db0c2cccae39f93d7dd38a6d2c304a563aa73090'],2,10,12,410237,4,0.666666667,1,1,1222
2a6f177a50c84b7998fa831db1ee54a2f6e2349a,1,Flavio Paiva Junqueira,2010-12-23 12:42:42+00:00,['0f44ca750b5de683734b1eb22c31117512d5e6f0'],2,114,116,410353,4,0.048780488,0.951219512,1,1223
53e4a8c971b5bbc09c86836dee3183a92251652b,0,Henry Robinson,2010-12-29 00:30:01+00:00,['2a6f177a50c84b7998fa831db1ee54a2f6e2349a'],4,7,11,410364,3,,,,1223
6450175d43af5cad35f137ab9e2c69b4f022731a,0,Henry Robinson,2010-12-29 01:07:19+00:00,['53e4a8c971b5bbc09c86836dee3183a92251652b'],7,6,13,410377,3,,,,1223
c93433291d6f82dbcbdef0342eb9cc12bf7d376d,0,Benjamin Reed,2011-01-06 16:06:41+00:00,['6450175d43af5cad35f137ab9e2c69b4f022731a'],17,30,47,410424,4,0.333333333,0.333333333,0.333333333,1223
2bf093ec150923624dd7a042d8d9459d589b1ef3,1,Benjamin Reed,2011-01-22 19:38:57+00:00,['c93433291d6f82dbcbdef0342eb9cc12bf7d376d'],62,569,631,411055,9,0.091463415,0.103658537,0.893292683,1224
4bbdfaf41ee86b55eb19073d1ec848eda1377290,0,Patrick D. Hunt,2011-02-07 19:26:47+00:00,['2bf093ec150923624dd7a042d8d9459d589b1ef3'],119,136,255,411310,8,0,0,1,1224
feb7bece1af74972b425dbbc7b4b8438161f21e7,0,Mahadev Konar,2011-02-09 03:06:55+00:00,['4bbdfaf41ee86b55eb19073d1ec848eda1377290'],1,3,4,411314,2,,,,1224
02e2b883169869522716d591c3a3c9042f074272,0,Mahadev Konar,2011-02-09 19:15:26+00:00,['feb7bece1af74972b425dbbc7b4b8438161f21e7'],25,166,191,411505,11,0.227272727,0.378787879,0.818181818,1224
02d9be777e0e39dad366bc7a194427c3c2364600,1,Mahadev Konar,2011-02-09 23:41:17+00:00,['02e2b883169869522716d591c3a3c9042f074272'],5,16,21,411526,2,,,,1224
575c53253bf9f548f342c3371d05bc00d2c2363d,0,Benjamin Reed,2011-02-18 17:54:48+00:00,['02d9be777e0e39dad366bc7a194427c3c2364600'],5,25,30,411556,5,0.846153846,0.846153846,1,1224
5cd2fb1b82039a8b3b58b225ba917c8a9df18987,1,Patrick D. Hunt,2011-02-27 06:51:13+00:00,['575c53253bf9f548f342c3371d05bc00d2c2363d'],5,16,21,411577,2,,,,1224
bd959d7bd4b6a41ce1a386dbf9a98bf80e5af28d,1,Patrick D. Hunt,2011-02-27 07:02:00+00:00,['5cd2fb1b82039a8b3b58b225ba917c8a9df18987'],7,15,22,411599,5,,,,1224
cdd92bd1d0e6f3635349593e3d1590568263b002,1,Patrick D. Hunt,2011-02-27 07:11:04+00:00,['bd959d7bd4b6a41ce1a386dbf9a98bf80e5af28d'],0,4,4,411603,2,,,,1224
ea1baf0e285722ae8f7d65d7fed85104d7d1230a,0,Mahadev Konar,2011-03-15 18:37:41+00:00,['cdd92bd1d0e6f3635349593e3d1590568263b002'],1,4,5,411608,2,,,,1224
f28e66203772b3cbb5df1785b06eeda197b55d46,0,Mahadev Konar,2011-03-15 20:42:21+00:00,['ea1baf0e285722ae8f7d65d7fed85104d7d1230a'],0,3,3,411611,2,,,,1224
a035a32e21026bf1c6bc7d3d99215d694d5dfa92,1,Flavio Paiva Junqueira,2011-03-16 15:58:34+00:00,['f28e66203772b3cbb5df1785b06eeda197b55d46'],13,7,20,411631,2,0,0,0.5,1224
e97dd3f1fe1e76b6ab4e8508c95cc26e0555a4df,1,Benjamin Reed,2011-03-16 17:15:36+00:00,['a035a32e21026bf1c6bc7d3d99215d694d5dfa92'],1,8,9,411640,3,,,,1224
858e308a70a831bcd6e131bae7d72449ec8ee7f8,1,Benjamin Reed,2011-03-16 18:49:18+00:00,['e97dd3f1fe1e76b6ab4e8508c95cc26e0555a4df'],32,149,181,411821,4,0.278481013,0.506329114,0.835443038,1224
772297c640f2156c2e61a32f9ce0da1ae824c651,0,Benjamin Reed,2011-03-17 01:00:44+00:00,['858e308a70a831bcd6e131bae7d72449ec8ee7f8'],1,35,36,411857,4,0.523809524,1,0.476190476,1224
7faeaa12f4da8dd076e1b7ac2e2c9ce288936e58,0,Benjamin Reed,2011-03-30 23:28:20+00:00,['772297c640f2156c2e61a32f9ce0da1ae824c651'],41530,0,41530,453387,282,0.522013364,0.258914632,0.222319366,1224
e13db919e4d1361bc3eaa64de4dbdcd01145da0b,0,Benjamin Reed,2011-03-31 19:43:14+00:00,['7faeaa12f4da8dd076e1b7ac2e2c9ce288936e58'],184,2,186,453573,3,,,,1224
4862611c4fa50d76024c0412378526854a06aab4,1,Benjamin Reed,2011-04-01 17:21:44+00:00,['e13db919e4d1361bc3eaa64de4dbdcd01145da0b'],3,38,41,453614,3,,,,1224
b1dc6a62d4c2fd1144725ed0cb8d7412bbd5de87,1,Benjamin Reed,2011-04-04 21:06:27+00:00,['4862611c4fa50d76024c0412378526854a06aab4'],8,9,17,453631,3,1,1,0,1224
1e4ed1c912a45fc8c36a4f4008b228fa55a891b5,0,Patrick D. Hunt,2011-04-06 16:17:18+00:00,['b1dc6a62d4c2fd1144725ed0cb8d7412bbd5de87'],7,12,19,453650,5,,,,1224
d28681d253a333740a446b99dbc71907cb4d7864,1,Patrick D. Hunt,2011-04-06 16:23:48+00:00,['1e4ed1c912a45fc8c36a4f4008b228fa55a891b5'],259,259,518,454168,21,,,,1224
c1eab643af684a89b2ce957f60913c7710f7cf8e,0,Mahadev Konar,2011-04-06 20:20:32+00:00,['d28681d253a333740a446b99dbc71907cb4d7864'],5,17,22,454190,3,0,1,1,1224
53a3d5530bd337625374396199ab985e115025ed,1,Michi Mutsuzaki,2011-04-12 07:14:07+00:00,['c1eab643af684a89b2ce957f60913c7710f7cf8e'],535,687,1222,455412,176,1,1,0,1224
b5116d920d3a5bac42b1ba08aa5cef4a31801ebf,1,Flavio Paiva Junqueira,2011-04-13 16:10:02+00:00,['53a3d5530bd337625374396199ab985e115025ed'],0,92,92,455504,3,0.0625,0.96875,0.96875,1225
2be6b4dc25b55d86d15a68519a8b19630feaa4de,1,Flavio Paiva Junqueira,2011-04-29 16:12:44+00:00,['b5116d920d3a5bac42b1ba08aa5cef4a31801ebf'],119,362,481,455985,8,0.116788321,0.817518248,0.97080292,1225
db0f374ce739ab561c6ed7fbcaaf314aec0841ec,0,Michi Mutsuzaki,2011-05-03 17:57:44+00:00,['2be6b4dc25b55d86d15a68519a8b19630feaa4de'],2,6,8,455993,2,0,0,1,1225
9a01fadeb3f25ae6ae500c173f6923fecad9b5ae,0,Mahadev Konar,2011-05-03 21:29:55+00:00,['db0f374ce739ab561c6ed7fbcaaf314aec0841ec'],1,6,7,456000,2,,,,1225
1579a4d292cb1eb50b1138612b6725e4f82b78bc,1,Mahadev Konar,2011-05-04 06:02:49+00:00,['9a01fadeb3f25ae6ae500c173f6923fecad9b5ae'],1,4,5,456005,2,,,,1225
59ac9fa78963ca746d21a62a27fde497fd4c4d58,1,Mahadev Konar,2011-05-16 17:13:23+00:00,['1579a4d292cb1eb50b1138612b6725e4f82b78bc'],10,34,44,456049,3,,,,1225
7f64942ba8e5ce00948f6e7b23271de0556b668f,1,Mahadev Konar,2011-05-16 17:39:01+00:00,['59ac9fa78963ca746d21a62a27fde497fd4c4d58'],1,21,22,456071,3,0.8125,0.8125,1,1225
9be9a3a1d03d6f78b4e55423d15f46c5d3a82f74,1,Henry Robinson,2011-05-19 23:17:48+00:00,['7f64942ba8e5ce00948f6e7b23271de0556b668f'],55,483,538,456609,16,0.042553191,0.425531915,0.819148936,1225
a2763e3cf5cca5301aa8eac25dfb61c9501e4724,1,Henry Robinson,2011-05-19 23:24:52+00:00,['9be9a3a1d03d6f78b4e55423d15f46c5d3a82f74'],0,524,524,457133,4,0.387755102,0.844897959,0.979591837,1229
1fdcaaf4113114dbc27e1687f12efa14442a8d42,0,Camille Fournier,2011-05-20 20:19:55+00:00,['a2763e3cf5cca5301aa8eac25dfb61c9501e4724'],1,3,4,457137,2,,,,1229
a4414196b310dbe62ee9e6e7e0c2a91fcd85c465,1,Camille Fournier,2011-05-20 22:43:41+00:00,['1fdcaaf4113114dbc27e1687f12efa14442a8d42'],13,187,200,457337,5,0.252336449,0.140186916,0.392523364,1229
b916b3bbb643d6de07b962452685b8c5929f84b6,1,Camille Fournier,2011-06-05 20:54:36+00:00,['a4414196b310dbe62ee9e6e7e0c2a91fcd85c465'],0,29,29,457366,3,0,0.944444444,1,1229
55e298ece5d8c1cb4bf16ae86a47de3c7241ba22,0,Michi Mutsuzaki,2011-06-13 17:24:03+00:00,['b916b3bbb643d6de07b962452685b8c5929f84b6'],0,3,3,457369,2,,,,1229
e74a8149ebce642e6805afd3576536f27632bf6e,0,Michi Mutsuzaki,2011-06-13 20:09:09+00:00,['55e298ece5d8c1cb4bf16ae86a47de3c7241ba22'],214,5,219,457588,4,0,0,0,1229
7e10b209801bccc90f7f1e94f989fccfb4118523,0,Michi Mutsuzaki,2011-06-13 20:40:36+00:00,['e74a8149ebce642e6805afd3576536f27632bf6e'],0,24,24,457612,1,1,1,1,1230
776db7808e27624aa125f1314b7fbb2196837507,1,Benjamin Reed,2011-06-14 05:14:05+00:00,['7e10b209801bccc90f7f1e94f989fccfb4118523'],121,705,826,458438,16,0.330623306,0.357723577,0.951219512,1232
68a133174bfffa25940a0289d49bd272f7b4498d,1,Flavio Paiva Junqueira,2011-06-14 12:11:55+00:00,['776db7808e27624aa125f1314b7fbb2196837507'],1,28,29,458467,3,0,0.95,1,1232
1538d107efb36b9f39617d33e883260c1a7e2027,1,Benjamin Reed,2011-06-16 23:34:30+00:00,['68a133174bfffa25940a0289d49bd272f7b4498d'],91,135,226,458693,14,0.875,0.875,0.875,1232
d5036dad6041cc0d12d3e2d1d1c49a29c4f731e0,1,Benjamin Reed,2011-06-21 05:34:08+00:00,['1538d107efb36b9f39617d33e883260c1a7e2027'],4,33,37,458730,3,1,1,1,1232
137e7fcf0af230846cf84e51eda9faf052c11f61,1,Patrick D. Hunt,2011-06-21 17:16:23+00:00,['d5036dad6041cc0d12d3e2d1d1c49a29c4f731e0'],493,498,991,459721,12,,,,1232
556d062eb7351661acf2aac0f158278247fcc44d,1,Patrick D. Hunt,2011-06-21 22:19:04+00:00,['137e7fcf0af230846cf84e51eda9faf052c11f61'],4,18,22,459743,2,0,1,1,1232
f6cb87e368b414a99c1270d3683ccbed2c49d8ce,0,Patrick D. Hunt,2011-06-22 19:35:55+00:00,['556d062eb7351661acf2aac0f158278247fcc44d'],3,5,8,459751,1,0,0,1,1232
eb51de49f723542a17e722fa817d81605a04c74c,1,Camille Fournier,2011-06-23 16:01:47+00:00,['f6cb87e368b414a99c1270d3683ccbed2c49d8ce'],73,97,170,459921,20,1,1,0.857142857,1232
3249687c7c5b91e0d4c7cd8b38da6283b1bb65c4,0,Camille Fournier,2011-06-23 16:02:00+00:00,['eb51de49f723542a17e722fa817d81605a04c74c'],0,7,7,459928,1,,,,1232
80fac0914a891ae495ec79bd32f5606f12365403,1,Henry Robinson,2011-06-25 06:13:03+00:00,['3249687c7c5b91e0d4c7cd8b38da6283b1bb65c4'],44,74,118,460046,3,0.642857143,1,1,1232
7f5105dd07539d70b8b7a25717503c64101301a7,0,Mahadev Konar,2011-06-27 05:03:42+00:00,['80fac0914a891ae495ec79bd32f5606f12365403'],1,5,6,460052,2,,,,1232
0b3d1c6a7b46961e1fc501d66fb52173935306a1,1,Benjamin Reed,2011-06-30 22:53:28+00:00,['7f5105dd07539d70b8b7a25717503c64101301a7'],477,2986,3463,463515,30,0.46386192,0.538295577,0.783171521,1242
a58353b4fd25d376dd7e32d7440404b9159126a4,1,Benjamin Reed,2011-07-03 05:07:04+00:00,['0b3d1c6a7b46961e1fc501d66fb52173935306a1'],0,653,653,464168,1,0.275943396,0.893867925,0.919811321,1243
6d3eba82add410b42f430990391719c1ca93ff02,1,Mahadev Konar,2011-07-07 07:32:06+00:00,['a58353b4fd25d376dd7e32d7440404b9159126a4'],202,242,444,464612,44,,,,1243
6b46e50d8672f2d845911261d6326e4c6242686e,1,Patrick D. Hunt,2011-07-07 22:55:07+00:00,['6d3eba82add410b42f430990391719c1ca93ff02'],0,989,989,465601,7,0.441666667,0.952777778,0.927777778,1249
aee36f4d55c093f263547486b1579cba8668eb2a,1,Camille Fournier,2011-07-13 13:48:01+00:00,['6b46e50d8672f2d845911261d6326e4c6242686e'],35,47,82,465683,5,0,0.888888889,0,1249
85c8d8a79c65f1f67e4beba92d813efad619fad8,0,Benjamin Reed,2011-07-14 17:53:51+00:00,['aee36f4d55c093f263547486b1579cba8668eb2a'],5,5,10,465693,2,,,,1249
1dbffb9eca80268e7ebb611dac5afd058fd0f9a6,1,Benjamin Reed,2011-07-15 04:10:45+00:00,['85c8d8a79c65f1f67e4beba92d813efad619fad8'],45,51,96,465789,3,1,1,0.8,1249
839ecef3ba74e2119dbd177795214d3ae1045bb2,1,Benjamin Reed,2011-07-15 04:50:24+00:00,['1dbffb9eca80268e7ebb611dac5afd058fd0f9a6'],0,47,47,465836,4,0,0.916666667,1,1249
2b282f03fdebe2f4d7ccc5413aac04638bdc20a6,1,Michi Mutsuzaki,2011-07-19 00:59:10+00:00,['839ecef3ba74e2119dbd177795214d3ae1045bb2'],89,2311,2400,468236,21,0.934328358,0.579104478,0.208955224,1256
f4061e8f7ad6c67555d02199fc34d3effd737040,0,Patrick D. Hunt,2011-07-19 21:38:56+00:00,['2b282f03fdebe2f4d7ccc5413aac04638bdc20a6'],7,10,17,468253,2,,,,1256
82eeb94d131cda3018a5179b27d24ea906e0c57e,0,Mahadev Konar,2011-07-25 17:45:00+00:00,['f4061e8f7ad6c67555d02199fc34d3effd737040'],7,22,29,468282,3,0,1,1,1256
f08e26fc1dec101f5b3da37ed7fb756937941542,0,Mahadev Konar,2011-07-25 20:49:26+00:00,['82eeb94d131cda3018a5179b27d24ea906e0c57e'],1,9,10,468292,2,0.75,0.75,1,1256
a2cd570a3afce6be2822e30b7c99493e1a86577b,1,Mahadev Konar,2011-07-25 21:31:33+00:00,['f08e26fc1dec101f5b3da37ed7fb756937941542'],8,11,19,468311,6,,,,1256
34ca9854a208e999bbf2fa38d33514d5c8af51f7,1,Mahadev Konar,2011-07-25 22:19:08+00:00,['a2cd570a3afce6be2822e30b7c99493e1a86577b'],4,7,11,468322,3,,,,1256
6f07f77e16bb3dd48146b9df2b8a5ca429f075b3,1,Benjamin Reed,2011-07-28 05:49:59+00:00,['34ca9854a208e999bbf2fa38d33514d5c8af51f7'],6,145,151,468473,3,0,0.152380952,1,1256
a31d530327851acb231a6bf67e63ae4a8a61c3ad,1,Mahadev Konar,2011-07-28 22:02:18+00:00,['6f07f77e16bb3dd48146b9df2b8a5ca429f075b3'],6,105,111,468584,9,,,,1256
523451930ced2c0dde3cd145e3e16cace682a741,0,Mahadev Konar,2011-07-28 23:05:12+00:00,['a31d530327851acb231a6bf67e63ae4a8a61c3ad'],0,41,41,468625,1,,,,1257
977c21435abdf6bd04eb030d85edd532d9768b3b,0,Mahadev Konar,2011-07-28 23:23:26+00:00,['523451930ced2c0dde3cd145e3e16cace682a741'],3,5,8,468633,3,,,,1257
06e55faf96236117930667cfa9bfec26aeefcaaf,0,Mahadev Konar,2011-07-29 08:14:59+00:00,['977c21435abdf6bd04eb030d85edd532d9768b3b'],25,22,47,468680,6,,,,1257
8eeefcf274c2628633ba6d67f383996afcf5712c,1,Mahadev Konar,2011-08-11 06:00:21+00:00,['06e55faf96236117930667cfa9bfec26aeefcaaf'],4,81,85,468765,5,0.363636364,1,1,1257
41a2f0ac9df73a06386539350732ee7f14904f80,0,Camille Fournier,2011-08-11 15:19:15+00:00,['8eeefcf274c2628633ba6d67f383996afcf5712c'],1,3,4,468769,2,,,,1257
9667399905588c91876e83bff64067d4b31adb8f,0,Patrick D. Hunt,2011-08-11 19:18:45+00:00,['41a2f0ac9df73a06386539350732ee7f14904f80'],57,1368,1425,470194,30,,,,1272
1bf050164c65186b0e72fab134eb1fea83bbecf0,1,Patrick D. Hunt,2011-08-11 22:06:44+00:00,['9667399905588c91876e83bff64067d4b31adb8f'],1368,57,1425,471619,30,,,,1272
da88e47f755f745f353d81e54162e6ce151e7b37,1,Mahadev Konar,2011-08-14 16:40:03+00:00,['1bf050164c65186b0e72fab134eb1fea83bbecf0'],87,131,218,471837,5,0,1,1,1273
f73be2a0d286609698aa7dd2ffc73f274e4cb069,1,Mahadev Konar,2011-08-14 17:30:45+00:00,['da88e47f755f745f353d81e54162e6ce151e7b37'],2,13,15,471852,2,,,,1273
2a45a47b0104b75a6d62a5966014efa0ee112121,0,Mahadev Konar,2011-08-14 17:48:35+00:00,['f73be2a0d286609698aa7dd2ffc73f274e4cb069'],1,5,6,471858,2,,,,1273
1d1bac2a715aa13cda6d14d0544bae7f7e00f3e2,1,Mahadev Konar,2011-08-15 00:35:18+00:00,['2a45a47b0104b75a6d62a5966014efa0ee112121'],7,164,171,472029,4,0.373134328,0.970149254,0.970149254,1274
530c9d96956c4855c57ddf71c7b6aa76b188fc5e,0,Mahadev Konar,2011-08-15 00:39:11+00:00,['1d1bac2a715aa13cda6d14d0544bae7f7e00f3e2'],2,10,12,472041,3,1,1,1,1274
7c0952f55dda93efb093f79da285929a13727320,0,Mahadev Konar,2011-08-15 00:44:24+00:00,['530c9d96956c4855c57ddf71c7b6aa76b188fc5e'],0,5,5,472046,2,1,1,0.5,1274
4367c01fd1bf0c6b14a7093b52cc4b79844c06e3,0,Mahadev Konar,2011-08-15 00:54:09+00:00,['7c0952f55dda93efb093f79da285929a13727320'],4,4,8,472054,2,1,1,0,1274
1ebe43dabfb0d2e39fe423ff59f437cfc3e0d5a9,1,Mahadev Konar,2011-08-15 01:40:56+00:00,['4367c01fd1bf0c6b14a7093b52cc4b79844c06e3'],10,38,48,472102,7,1,1,1,1274
b9b1adb37f49477fe2c7c50cd672f3adb1f67c4d,1,Camille Fournier,2011-08-18 20:05:25+00:00,['1ebe43dabfb0d2e39fe423ff59f437cfc3e0d5a9'],1,21,22,472124,3,1,1,1,1274
f650291795d66491b326856bb7b987b0afd33d02,1,Mahadev Konar,2011-08-18 22:05:35+00:00,['b9b1adb37f49477fe2c7c50cd672f3adb1f67c4d'],300,2450,2750,474874,23,0.335324869,0.515309933,0.941747573,1284
c17d3501c94d43aaf430216f8a6ea714890eac78,1,Benjamin Reed,2011-08-21 00:53:46+00:00,['f650291795d66491b326856bb7b987b0afd33d02'],4,32,36,474910,3,0.681818182,0.681818182,1,1284
de63c672737047f3373acccd61591f4544c00425,0,Mahadev Konar,2011-08-26 07:42:35+00:00,['c17d3501c94d43aaf430216f8a6ea714890eac78'],6,11,17,474927,3,0,0,1,1284
a209e60eb5337f1855ed2a9d6a038ee2c5afb79c,1,Patrick D. Hunt,2011-08-29 21:26:44+00:00,['de63c672737047f3373acccd61591f4544c00425'],55,1366,1421,476348,29,,,,1299
f6b2211579a0bfd71033b5fa477e6b56d9ddb79a,0,Patrick D. Hunt,2011-08-29 21:29:22+00:00,['a209e60eb5337f1855ed2a9d6a038ee2c5afb79c'],0,2,2,476350,1,,,,1299
8024660dc7003e1162a8ae7ffe10438316d58c5d,1,Mahadev Konar,2011-08-30 06:29:07+00:00,['f6b2211579a0bfd71033b5fa477e6b56d9ddb79a'],15,24,39,476389,26,,,,1299
611e0364c198c39ab0445c35da04820bd8a0c3f2,1,Mahadev Konar,2011-08-30 06:37:07+00:00,['8024660dc7003e1162a8ae7ffe10438316d58c5d'],29,41,70,476459,4,0,1,1,1299
423ceb78e736a7a167eb1ba883188520676eaec6,1,Mahadev Konar,2011-08-30 07:01:48+00:00,['611e0364c198c39ab0445c35da04820bd8a0c3f2'],4,20,24,476483,2,1,1,0,1299
ff433f1652339b331f0388ac34648f22e57ebf89,1,Patrick D. Hunt,2011-09-01 17:15:08+00:00,['423ceb78e736a7a167eb1ba883188520676eaec6'],12,33,45,476528,4,1,1,1,1299
cf1683f7d9797c6d30758e44b00da06c39212f5c,0,Patrick D. Hunt,2011-09-01 20:42:33+00:00,['ff433f1652339b331f0388ac34648f22e57ebf89'],0,2,2,476530,1,,,,1299
0538ac83ae496cd4a4f29ee4dd957c8643b30e10,0,Patrick D. Hunt,2011-09-02 17:02:08+00:00,['cf1683f7d9797c6d30758e44b00da06c39212f5c'],0,4,4,476534,2,,,,1299
d1222313af892252ea0c056418f28f0e194e2b3f,1,Patrick D. Hunt,2011-09-02 20:50:38+00:00,['0538ac83ae496cd4a4f29ee4dd957c8643b30e10'],4,373,377,476911,7,0.770491803,0.926229508,0.885245902,1301
4e163743a5df20698fc4bfe1fdf76a45f2ec4ae3,0,Patrick D. Hunt,2011-09-02 20:53:58+00:00,['d1222313af892252ea0c056418f28f0e194e2b3f'],20,23,43,476954,4,1,1,0,1301
27d045af5c6b382fc5c787a5125f63ea730dc9bd,1,Camille Fournier,2011-09-02 23:07:00+00:00,['4e163743a5df20698fc4bfe1fdf76a45f2ec4ae3'],7,216,223,477177,4,0.168141593,0.362831858,0.982300885,1301
864d055ce287e14a046c50fc2246e29b74e7f89d,1,Patrick D. Hunt,2011-09-05 18:31:36+00:00,['27d045af5c6b382fc5c787a5125f63ea730dc9bd'],13,15,28,477205,8,,,,1301
634243cc4bb695e1679584dc80af8e33172309ad,1,Camille Fournier,2011-09-05 20:03:31+00:00,['864d055ce287e14a046c50fc2246e29b74e7f89d'],38,28,66,477271,2,,,,1301
1d6325605f1c6344c045839c043d239a6612d18a,0,Camille Fournier,2011-09-05 22:58:46+00:00,['634243cc4bb695e1679584dc80af8e33172309ad'],1,3,4,477275,1,,,,1301
a7bcf047f577949e96396588d23fde0107ff3b19,0,Mahadev Konar,2011-09-09 02:27:19+00:00,['1d6325605f1c6344c045839c043d239a6612d18a'],7,19,26,477301,7,0,1,1,1301
c62e07eff56995b60b03340d3d597cf51b8bec18,1,Mahadev Konar,2011-09-13 21:50:41+00:00,['a7bcf047f577949e96396588d23fde0107ff3b19'],11,15,26,477327,2,,,,1301
a7c483d16e18c9cc7b5c417ed3e81b8935853204,0,Mahadev Konar,2011-09-14 04:09:18+00:00,['c62e07eff56995b60b03340d3d597cf51b8bec18'],2,14,16,477343,2,,,,1301
e00dc11065f29e0d431f6a1d9e597d6ce8193c8a,0,Mahadev Konar,2011-09-14 04:32:12+00:00,['a7c483d16e18c9cc7b5c417ed3e81b8935853204'],1,3,4,477347,2,,,,1301
d84dc077d576b7cdfbfd003e3425fab85ca29a44,1,Mahadev Konar,2011-09-14 05:43:56+00:00,['e00dc11065f29e0d431f6a1d9e597d6ce8193c8a'],31,236,267,477614,3,0.208333333,1,1,1302
43776e4fa233eeda2bdbbb3ca4db5030d2a51a9d,1,Mahadev Konar,2011-09-14 06:56:13+00:00,['d84dc077d576b7cdfbfd003e3425fab85ca29a44'],75,431,506,478120,11,0.456621005,0.97716895,0.98630137,1304
5ae19450b586a3560cf39ca8eb0bad7542b859e6,0,Mahadev Konar,2011-09-14 07:20:56+00:00,['43776e4fa233eeda2bdbbb3ca4db5030d2a51a9d'],0,12,12,478132,1,,,,1304
d25e90b75d234865eeaf0a5d33bcc6976f8da245,0,Patrick D. Hunt,2011-09-14 22:22:47+00:00,['5ae19450b586a3560cf39ca8eb0bad7542b859e6'],181,35,216,478348,34,0.364864865,0.351351351,0.013513514,1304
3deab29864eb2fd42a624da2bd5ef372e267e145,1,Patrick D. Hunt,2011-09-14 22:37:06+00:00,['d25e90b75d234865eeaf0a5d33bcc6976f8da245'],2364,19,2383,480731,10,0.719153937,0.630434783,0.062867215,1304
de7289d3a1018fb18ca1818b4a2aee09ec2e0562,1,Patrick D. Hunt,2011-09-14 22:50:27+00:00,['3deab29864eb2fd42a624da2bd5ef372e267e145'],21,18,39,480770,2,0,0,0,1304
81728143a79b7135977e602da85bf43c5b8c8af3,0,Patrick D. Hunt,2011-09-14 22:55:24+00:00,['de7289d3a1018fb18ca1818b4a2aee09ec2e0562'],17,11,28,480798,4,0.5,0.5,1,1304
e865fa41513389539783fd94070058cef9395769,1,Patrick D. Hunt,2011-09-17 00:08:23+00:00,['81728143a79b7135977e602da85bf43c5b8c8af3'],13,15,28,480826,3,,,,1304
f31947ab7266202c5af695890fbbec5de787b3da,1,Patrick D. Hunt,2011-09-17 00:13:30+00:00,['e865fa41513389539783fd94070058cef9395769'],477,431,908,481734,24,0.333333333,0,0,1304
1dbe78692bb5d2fe4d050e2070ce948fdc1ea82b,1,Patrick D. Hunt,2011-09-17 00:24:55+00:00,['f31947ab7266202c5af695890fbbec5de787b3da'],5,15,20,481754,2,,,,1304
336888446c310494f1ae1e39b81dc5a60cb5576f,1,Patrick D. Hunt,2011-09-17 00:36:31+00:00,['1dbe78692bb5d2fe4d050e2070ce948fdc1ea82b'],297,259,556,482310,9,0.862068966,0.793103448,0.103448276,1304
0287aeebaec27fbe7f86365d424aac15dc2a2f17,0,Patrick D. Hunt,2011-09-17 00:42:10+00:00,['336888446c310494f1ae1e39b81dc5a60cb5576f'],46,199,245,482555,9,1,0.983333333,1,1306
4f7b7bfa1dfc39e498d65dd7ba8c4d33aaf66bbb,0,Camille Fournier,2011-09-19 01:10:53+00:00,['0287aeebaec27fbe7f86365d424aac15dc2a2f17'],8,8,16,482571,1,,0,,1306
b182dd4d765e36cacc6128c417ea392285815b84,1,Benjamin Reed,2011-09-22 05:42:19+00:00,['4f7b7bfa1dfc39e498d65dd7ba8c4d33aaf66bbb'],11,61,72,482643,3,0,0,1,1306
05287a9c14db8d145f61ea09ec2c61f4f0221cc6,0,Mahadev Konar,2011-09-27 01:05:13+00:00,['b182dd4d765e36cacc6128c417ea392285815b84'],6,29,35,482678,3,0,1,1,1306
7e64875f9d18cb043adbddc53c73e563886942ea,1,Mahadev Konar,2011-09-27 02:06:24+00:00,['05287a9c14db8d145f61ea09ec2c61f4f0221cc6'],11,26,37,482715,5,0.133333333,0.2,1,1306
6ac2b1c478346922ddd95aad0931ab5db833d5a7,0,Patrick D. Hunt,2011-09-27 19:51:27+00:00,['7e64875f9d18cb043adbddc53c73e563886942ea'],0,4,4,482719,2,,,,1306
9598a30a6620cc336f860cee56916022f7985890,1,Camille Fournier,2011-09-28 14:46:15+00:00,['6ac2b1c478346922ddd95aad0931ab5db833d5a7'],1,3,4,482723,1,1,1,1,1306
12f70403c6fdc4a94e6bfa0a66ddabe7f81c3afc,1,Camille Fournier,2011-09-28 20:17:16+00:00,['9598a30a6620cc336f860cee56916022f7985890'],9,19,28,482751,4,0,1,1,1306
c09f6b1a62dcd74345d8ba05b2a8ba564985d267,0,Mahadev Konar,2011-09-29 07:40:05+00:00,['12f70403c6fdc4a94e6bfa0a66ddabe7f81c3afc'],100,90,190,482941,2,1,1,0,1306
7307c9825187d3f3debf3b252ad5590965d9b56d,0,Patrick D. Hunt,2011-09-29 21:32:56+00:00,['c09f6b1a62dcd74345d8ba05b2a8ba564985d267'],1,5,6,482947,2,,,,1306
a83e0382c1c6b1de6f7d602bcfdbbf69c69cc015,0,Patrick D. Hunt,2011-10-05 17:25:58+00:00,['7307c9825187d3f3debf3b252ad5590965d9b56d'],3,5,8,482955,2,,,,1306
2bde61ba9287a97a4c38ab48a4a270789cebad15,1,Patrick D. Hunt,2011-10-05 18:34:32+00:00,['a83e0382c1c6b1de6f7d602bcfdbbf69c69cc015'],5,122,127,483082,3,,,,1306
50584b8dbc84841131e0796b4eef6580f710655f,0,Camille Fournier,2011-10-07 14:09:45+00:00,['2bde61ba9287a97a4c38ab48a4a270789cebad15'],534,3,537,483619,4,,,,1306
70650d066f0768a90fbf6a5877ae5461a2b1aa9f,0,Patrick D. Hunt,2011-10-07 20:41:14+00:00,['50584b8dbc84841131e0796b4eef6580f710655f'],14,16,30,483649,5,,,,1306
9ea4f145f21fb4920e45962db3e1b0c8c9ef7bec,1,Camille Fournier,2011-10-17 14:59:49+00:00,['70650d066f0768a90fbf6a5877ae5461a2b1aa9f'],71,49,120,483769,2,1,1,0.913043478,1306
7cc897605265469fbb51cae05218daaa2cca4f88,0,Mahadev Konar,2011-10-19 06:51:20+00:00,['9ea4f145f21fb4920e45962db3e1b0c8c9ef7bec'],0,0,0,483769,1,,,,1306
2dfda92bd1290fe7326191b66c5b7c1db9d7e073,0,Patrick D. Hunt,2011-10-20 16:48:17+00:00,['7cc897605265469fbb51cae05218daaa2cca4f88'],1418,16,1434,485203,13,0.604497354,0.321428571,0.191798942,1306
e04e40167ffe34472435f040f346af06e76ff760,1,Patrick D. Hunt,2011-10-20 18:02:18+00:00,['2dfda92bd1290fe7326191b66c5b7c1db9d7e073'],280,274,554,485757,14,1,1,0,1306
b33ab5999125a06c4a83bfe5950dacc7771a5890,0,Mahadev Konar,2011-10-24 06:35:11+00:00,['e04e40167ffe34472435f040f346af06e76ff760'],1,1,2,485759,1,,,,1306
a89d9b66ceba10bfb96787b59ef3e172bea0e1c6,1,Mahadev Konar,2011-10-24 06:44:40+00:00,['b33ab5999125a06c4a83bfe5950dacc7771a5890'],160,245,405,486164,2,0.255813953,0.744186047,1,1306
f5dcbad128356f8b5065311243f8c357d699bac7,1,Patrick D. Hunt,2011-10-24 08:02:09+00:00,['a89d9b66ceba10bfb96787b59ef3e172bea0e1c6'],6,43,49,486213,26,,,,1308
9ac5756b18d377774f49064e6e1de3f39d059b87,1,Patrick D. Hunt,2011-10-25 06:09:54+00:00,['f5dcbad128356f8b5065311243f8c357d699bac7'],270,202,472,486685,40,0.347826087,0.260869565,0.260869565,1308
f8d7bafc8797b5feb737064b22ab1401aa6e94e2,1,Patrick D. Hunt,2011-10-26 17:00:26+00:00,['9ac5756b18d377774f49064e6e1de3f39d059b87'],0,42,42,486727,2,1,1,1,1308
1c0984e31a18749a67b113e07d83e8386af90d29,0,Patrick D. Hunt,2011-10-26 17:09:51+00:00,['f8d7bafc8797b5feb737064b22ab1401aa6e94e2'],18,7,25,486752,2,1,1,0.384615385,1308
2504f4fb30c84af2b46f033f72e51c1eee86caee,1,Patrick D. Hunt,2011-10-27 16:11:15+00:00,['1c0984e31a18749a67b113e07d83e8386af90d29'],7,181,188,486940,3,0.443661972,0.908450704,1,1308
c81c577efe9046650821c77b3eeeb548899fa9b0,0,Patrick D. Hunt,2011-10-27 16:25:58+00:00,['2504f4fb30c84af2b46f033f72e51c1eee86caee'],5,3,8,486948,2,0,0,0,1308
16a0008be217ab68ef747b4e2cc76afdcd7b3cb3,0,Patrick D. Hunt,2011-10-27 18:23:28+00:00,['c81c577efe9046650821c77b3eeeb548899fa9b0'],2,2,4,486952,2,1,0,0,1308
d57806527fc3b543d3bf96240db11b15075136eb,1,Patrick D. Hunt,2011-10-27 21:25:49+00:00,['16a0008be217ab68ef747b4e2cc76afdcd7b3cb3'],73,30,103,487055,12,0.233333333,0.1,0.466666667,1308
4021bdec606b932f87f8591c04f3c2eed28d1906,0,Patrick D. Hunt,2011-10-27 22:58:03+00:00,['d57806527fc3b543d3bf96240db11b15075136eb'],10,15,25,487080,2,0,0,1,1308
3994a2aa08ef1f5b7de7da9ebcbe61554dac07e4,1,Camille Fournier,2011-10-28 14:33:29+00:00,['4021bdec606b932f87f8591c04f3c2eed28d1906'],65,89,154,487234,3,0.25,0.25,1,1308
4ae2225de1a170f00d0ea961baa36e783a9f3741,0,Patrick D. Hunt,2011-10-28 16:37:43+00:00,['3994a2aa08ef1f5b7de7da9ebcbe61554dac07e4'],12,19,31,487265,5,0,0,1,1308
7f317c5b01b261a67611b30b85130d3c14e7773b,0,Patrick D. Hunt,2011-10-28 16:59:31+00:00,['4ae2225de1a170f00d0ea961baa36e783a9f3741'],3,4,7,487272,2,1,1,0,1308
466b1f019e45d477798455f669c923559f0a24fc,0,Patrick D. Hunt,2011-10-31 20:05:36+00:00,['7f317c5b01b261a67611b30b85130d3c14e7773b'],60,3,63,487335,2,0,0,0,1308
aa786021bc3939ee79f8fde0a3fbcfbdeff69272,1,Mahadev Konar,2011-11-01 07:15:33+00:00,['466b1f019e45d477798455f669c923559f0a24fc'],31,80,111,487446,4,0.133333333,0.133333333,1,1308
50851134a2b4c79f1cd33f0064f2ab641569cdc5,1,Camille Fournier,2011-11-01 14:41:41+00:00,['aa786021bc3939ee79f8fde0a3fbcfbdeff69272'],19,157,176,487622,3,0.727272727,0.727272727,0.745454545,1309
736e27df12ffab4139aec95207c7fef1ca114509,0,Patrick D. Hunt,2011-11-02 21:53:46+00:00,['50851134a2b4c79f1cd33f0064f2ab641569cdc5'],10,115,125,487747,4,1,1,1,1310
73674f77cc30b9b0ed36f0032193362363c54bdd,1,Mahadev Konar,2011-11-05 06:29:01+00:00,['736e27df12ffab4139aec95207c7fef1ca114509'],6,119,125,487872,5,0.25,0.986842105,0.934210526,1310
f8f15de5fe447409a2987262b8e878be224dab25,1,Camille Fournier,2011-11-05 20:57:13+00:00,['73674f77cc30b9b0ed36f0032193362363c54bdd'],31,298,329,488201,5,0.090909091,0.939393939,1,1310
5b9c8d14c1ec18b3e405c30ec3e141df8b82e265,0,Patrick D. Hunt,2011-11-11 20:48:05+00:00,['f8f15de5fe447409a2987262b8e878be224dab25'],7,18,25,488226,2,0,0,0.615384615,1310
fa9e821e91d5c007593f830dcc4553a3f05b1038,0,Camille Fournier,2011-11-14 19:18:39+00:00,['5b9c8d14c1ec18b3e405c30ec3e141df8b82e265'],1,140,141,488367,7,0.266666667,0.983333333,0.966666667,1311
dad9038097c9ae699a32f812c6aa4410bf63b735,1,Camille Fournier,2011-11-15 18:30:28+00:00,['fa9e821e91d5c007593f830dcc4553a3f05b1038'],1,35,36,488403,3,0,0,1,1311
15ab2a328c0cebd5eca7266d6c31a368b60f696b,0,Mahadev Konar,2011-11-16 07:12:09+00:00,['dad9038097c9ae699a32f812c6aa4410bf63b735'],0,3,3,488406,2,,,,1311
73b1dee463d2a51faeb03ceaae9eaedd13c6b79c,0,Patrick D. Hunt,2011-12-01 07:13:51+00:00,['15ab2a328c0cebd5eca7266d6c31a368b60f696b'],13,5,18,488424,2,,,,1311
9553f94271ee3debdf431b33f669f4feade30126,0,Mahadev Konar,2011-12-08 21:58:28+00:00,['73b1dee463d2a51faeb03ceaae9eaedd13c6b79c'],2,9,11,488435,3,0,1,1,1311
c159afdac6fc0ebf22fcf1daf7af93c0bc8985f3,1,Mahadev Konar,2011-12-08 22:15:06+00:00,['9553f94271ee3debdf431b33f669f4feade30126'],37,196,233,488668,24,,,,1311
2dd718190f64f4bbbcb444cb96891e9f3654f410,0,Mahadev Konar,2011-12-08 22:26:33+00:00,['c159afdac6fc0ebf22fcf1daf7af93c0bc8985f3'],0,4,4,488672,2,0,0,0,1311
f5bd98679876cef7b2509650a44c78442a694071,0,Mahadev Konar,2011-12-09 00:20:07+00:00,['2dd718190f64f4bbbcb444cb96891e9f3654f410'],1,4,5,488677,2,,,,1311
2ba1042522f4dd686b2287acb55b1a53c289e5a1,0,Mahadev Konar,2011-12-09 18:36:27+00:00,['f5bd98679876cef7b2509650a44c78442a694071'],0,5,5,488682,2,0,0,0,1311
22e2d238cdae7ff77ae69bcad3876d2f0fd3dd84,1,Mahadev Konar,2011-12-09 19:03:26+00:00,['2ba1042522f4dd686b2287acb55b1a53c289e5a1'],6,116,122,488804,4,0.095890411,0.95890411,1,1311
e44601d1249ea70b5bfa514082c714640c6217dd,1,Mahadev Konar,2011-12-09 22:15:30+00:00,['22e2d238cdae7ff77ae69bcad3876d2f0fd3dd84'],31,77,108,488912,4,0,0.176470588,0.735294118,1311
5040b7eb0e5f2917789a2119da0e3cdbc30bd8c1,0,Patrick D. Hunt,2011-12-14 22:58:16+00:00,['e44601d1249ea70b5bfa514082c714640c6217dd'],2,2,4,488916,1,,,,1311
7a5a599016bc3e62dd56e1de9b35e0fc3c204dfb,0,Patrick D. Hunt,2011-12-14 23:11:53+00:00,['5040b7eb0e5f2917789a2119da0e3cdbc30bd8c1'],1,10,11,488927,2,0.740909091,0.659090909,0.320454545,1311
595c94c20d0787bbd0a1fcb7f094dd368687f67f,0,Patrick D. Hunt,2011-12-14 23:26:04+00:00,['7a5a599016bc3e62dd56e1de9b35e0fc3c204dfb'],41,2,43,488970,2,0,0,1,1311
73deba9c208dbb062da894f9b3cd83792fff7bc7,0,Patrick D. Hunt,2011-12-14 23:39:59+00:00,['595c94c20d0787bbd0a1fcb7f094dd368687f67f'],3,4,7,488977,2,1,1,1,1311
854c41926c9bb2c1281c3873008b9113ea021720,1,Patrick D. Hunt,2011-12-15 00:05:15+00:00,['73deba9c208dbb062da894f9b3cd83792fff7bc7'],594,869,1463,490440,88,0.709090909,0.959090909,0.736363636,1368
c85f61aee240e03fdebb31ce094f5b7c07619e34,1,Mahadev Konar,2011-12-21 20:39:33+00:00,['854c41926c9bb2c1281c3873008b9113ea021720'],40,112,152,490592,4,0,0,1,1368
aa52c5de1f5f72eb95d5cc3472a82cc4bd0b6354,1,Benjamin Reed,2011-12-23 19:46:53+00:00,['c85f61aee240e03fdebb31ce094f5b7c07619e34'],120,165,285,490877,2,1,1,0,1368
85da85be5383777dbd3fc76fa24a95cd6290d024,0,Patrick D. Hunt,2011-12-27 23:53:31+00:00,['aa52c5de1f5f72eb95d5cc3472a82cc4bd0b6354'],4,24,28,490905,4,0,0.538461538,1,1368
0dac263f40c3357014c3f6ff7a74606ea99cf579,0,Patrick D. Hunt,2011-12-27 23:55:47+00:00,['85da85be5383777dbd3fc76fa24a95cd6290d024'],0,1,1,490906,21,,,,1368
ff7b4f061566db14451b223800cecb047e8d3179,1,Patrick D. Hunt,2011-12-28 00:26:50+00:00,['0dac263f40c3357014c3f6ff7a74606ea99cf579'],2,7,9,490915,3,0.5,0.5,1,1368
aa4674cefe019a4cff7e874472b6aa12fa842888,0,Patrick D. Hunt,2011-12-28 00:39:23+00:00,['ff7b4f061566db14451b223800cecb047e8d3179'],2,4,6,490921,23,,,,1368
00a6861f922b55cbfeec3eb928be2b57ddf99780,1,Patrick D. Hunt,2011-12-28 06:07:19+00:00,['aa4674cefe019a4cff7e874472b6aa12fa842888'],40,90,130,491051,6,1,1,1,1369
6c4b747ea51561d251b3ae9e66276fc7d41bc81c,0,Camille Fournier,2011-12-28 14:55:37+00:00,['00a6861f922b55cbfeec3eb928be2b57ddf99780'],18,65,83,491134,12,0.730769231,1,1,1369
c95a66de524739896f96e6e69c3ae26577ef922d,0,Camille Fournier,2011-12-28 21:44:09+00:00,['6c4b747ea51561d251b3ae9e66276fc7d41bc81c'],65,18,83,491217,12,0.269230769,0,0,1369
03ce9fc9c487c49d065304f22ea9d65a868f1301,0,Patrick D. Hunt,2011-12-30 21:03:04+00:00,['c95a66de524739896f96e6e69c3ae26577ef922d'],1,5,6,491223,2,,,,1369
1a7165dca23d4e8b5545f7f0cb4163f6b9ba8f13,0,Patrick D. Hunt,2011-12-30 21:30:23+00:00,['03ce9fc9c487c49d065304f22ea9d65a868f1301'],0,13,13,491236,2,,,,1370
1a556bd13b9a1e250ec2279fb3ba92dc9ba2d69c,1,Benjamin Reed,2012-01-04 00:15:03+00:00,['1a7165dca23d4e8b5545f7f0cb4163f6b9ba8f13'],49,133,182,491418,3,0.369565217,1,1,1370
f7409be3355720638e6416bfebac128c97e2eaeb,1,Patrick D. Hunt,2012-01-06 01:23:41+00:00,['1a556bd13b9a1e250ec2279fb3ba92dc9ba2d69c'],3,5,8,491426,4,,,,1370
820f3e6dc2aaa6a15c307368e127c0a5dd8fc555,0,Patrick D. Hunt,2012-01-06 01:32:58+00:00,['f7409be3355720638e6416bfebac128c97e2eaeb'],5,4,9,491435,3,1,0.5,0,1370
06f28609b0c6b206d3b5dcb48895aad98607ddce,1,Henry Robinson,2012-01-13 23:28:41+00:00,['820f3e6dc2aaa6a15c307368e127c0a5dd8fc555'],6,103,109,491544,4,0.595238095,1,0.642857143,1371
d4b27432c8e474218c06ae62d7e1285b0cd4e9ad,0,Camille Fournier,2012-01-16 02:19:01+00:00,['06f28609b0c6b206d3b5dcb48895aad98607ddce'],1,4,5,491549,2,,,,1371
4ccd368e4fd6982c73b3c18c5eb27d63cc9608d0,0,Camille Fournier,2012-01-16 02:32:16+00:00,['d4b27432c8e474218c06ae62d7e1285b0cd4e9ad'],51,45,96,491645,2,0,0,0,1371
568940921eb9c79e7f99d096970521c96cdf5588,1,Patrick D. Hunt,2012-01-23 20:32:03+00:00,['4ccd368e4fd6982c73b3c18c5eb27d63cc9608d0'],1,7,8,491653,2,1,1,1,1371
73af50a8a91cee9d3d95a373df7ecb12825f5545,1,Mahadev Konar,2012-01-31 06:45:45+00:00,['568940921eb9c79e7f99d096970521c96cdf5588'],27,164,191,491844,8,0.069306931,1,1,1371
676fde7642711bc729e0dd00e644f9d6659db97e,0,Mahadev Konar,2012-02-06 07:38:21+00:00,['73af50a8a91cee9d3d95a373df7ecb12825f5545'],1,4,5,491849,2,,,,1371
f910c936e37505a31ed8c140daa5bbee448c444f,1,Mahadev Konar,2012-02-06 08:34:22+00:00,['676fde7642711bc729e0dd00e644f9d6659db97e'],37,414,451,492300,7,0.592,0.84,1,1374
5ddc24bf36fcc1e509302d0caef074f9c827e0b1,1,Mahadev Konar,2012-02-06 08:40:32+00:00,['f910c936e37505a31ed8c140daa5bbee448c444f'],87,106,193,492493,7,0.133333333,0.133333333,1,1374
97bdb8e94963857be25fd69eada9212c2d6f19d1,0,Mahadev Konar,2012-02-06 08:47:42+00:00,['5ddc24bf36fcc1e509302d0caef074f9c827e0b1'],76,53,129,492622,3,1,0,0,1374
60ff341b8b2080c6ffae5be887a3897ca201aafb,0,Mahadev Konar,2012-02-06 08:56:11+00:00,['97bdb8e94963857be25fd69eada9212c2d6f19d1'],15,42,57,492679,4,,,,1374
6465986efec9588492f55081778c6b7b09a114f4,1,Mahadev Konar,2012-02-06 09:06:27+00:00,['60ff341b8b2080c6ffae5be887a3897ca201aafb'],229,228,457,493136,67,,,,1374
477ebb005617d6bd9862aea59e84e85c5b4fbacf,0,Mahadev Konar,2012-02-06 09:39:15+00:00,['6465986efec9588492f55081778c6b7b09a114f4'],6,10,16,493152,3,1,1,0,1374
da05446a9fc849fba0c27f77478c8762e86bfb03,0,Mahadev Konar,2012-02-06 09:53:15+00:00,['477ebb005617d6bd9862aea59e84e85c5b4fbacf'],0,11,11,493163,2,1,1,1,1374
fad4d0ac5221715942304bae0d2ff63cd9bd7afe,0,Mahadev Konar,2012-02-06 09:58:27+00:00,['da05446a9fc849fba0c27f77478c8762e86bfb03'],5,88,93,493256,2,0,0,1,1374
e657907115bc2bb53c72e7c696ff949e1db21a02,0,Mahadev Konar,2012-02-06 10:13:40+00:00,['fad4d0ac5221715942304bae0d2ff63cd9bd7afe'],8,52,60,493316,3,0.285714286,1,0.714285714,1374
78a36341311f7846d3e78ef748e52fcf9b484114,1,Camille Fournier,2012-02-10 23:34:18+00:00,['e657907115bc2bb53c72e7c696ff949e1db21a02'],14,55,69,493385,12,0.72,1,1,1374
1c3ac516c2f355576d3787cb6763f86b46c9df78,1,Patrick D. Hunt,2012-02-15 22:53:18+00:00,['78a36341311f7846d3e78ef748e52fcf9b484114'],2,13,15,493400,2,,,,1374
6fbafc38df5cfe451670dce6d70da2fd43747ccb,0,Camille Fournier,2012-02-27 00:57:38+00:00,['1c3ac516c2f355576d3787cb6763f86b46c9df78'],1,5,6,493406,2,,,,1374
257a00aa97cd21c967ad620c3119a86295f1b794,1,Camille Fournier,2012-02-27 02:41:47+00:00,['6fbafc38df5cfe451670dce6d70da2fd43747ccb'],40,80,120,493526,7,1,1,1,1374
2ea71df8c6ccc80b3c72c49bc7a180c7485cf854,0,Camille Fournier,2012-03-02 02:44:20+00:00,['257a00aa97cd21c967ad620c3119a86295f1b794'],9,18,27,493553,2,0,1,1,1374
0ddcea51e8107dee09107d4c09fe049a9ecb5733,1,Henry Robinson,2012-03-06 08:20:49+00:00,['2ea71df8c6ccc80b3c72c49bc7a180c7485cf854'],28,200,228,493781,7,0.1,0.416666667,1,1374
ed6fe28fcf23df95009c61b5ed670fa4e6d1d65a,1,Henry Robinson,2012-03-06 21:48:37+00:00,['0ddcea51e8107dee09107d4c09fe049a9ecb5733'],0,369,369,494150,2,,,,1376
297517b5e1461400039aa7c4fdbbd246183a133f,1,Patrick D. Hunt,2012-03-15 16:47:29+00:00,['ed6fe28fcf23df95009c61b5ed670fa4e6d1d65a'],18,447,465,494615,10,0.447826087,0.908695652,0.904347826,1377
655b2e3f0a047d6b6db9e4cdb581a84a54f5366c,1,Patrick D. Hunt,2012-03-15 17:01:09+00:00,['297517b5e1461400039aa7c4fdbbd246183a133f'],2,132,134,494749,5,0.45,0.9875,1,1377
cbe58afeeccca6acd532968ddb32833ed65021b8,0,Patrick D. Hunt,2012-03-17 00:31:16+00:00,['655b2e3f0a047d6b6db9e4cdb581a84a54f5366c'],9,168,177,494926,5,0.435185185,1,1,1377
9ab32ca0dfe9ba49a26c08560d39d444fd775e4a,1,Patrick D. Hunt,2012-03-17 00:39:16+00:00,['cbe58afeeccca6acd532968ddb32833ed65021b8'],1,42,43,494969,4,0.733333333,0.733333333,1,1377
53cbcc6086b8170e7f7671c5ddbb474c41893c02,1,Camille Fournier,2012-03-17 15:17:11+00:00,['9ab32ca0dfe9ba49a26c08560d39d444fd775e4a'],16,9,25,494994,2,1,1,0,1377
03157aae3ed48b3e4462126efa453dcf29603e61,0,Camille Fournier,2012-03-17 22:14:32+00:00,['53cbcc6086b8170e7f7671c5ddbb474c41893c02'],1792,2,1794,496788,6,,,,1377
1962b839757f88d6bce4740dd7f82e5ca632ed5d,0,Camille Fournier,2012-03-17 22:42:07+00:00,['03157aae3ed48b3e4462126efa453dcf29603e61'],19,0,19,496807,2,,,,1377
ddd1481372d49988289f5032777885ae5910b157,1,Patrick D. Hunt,2012-03-18 06:03:05+00:00,['1962b839757f88d6bce4740dd7f82e5ca632ed5d'],279,1722,2001,498808,23,0.855691057,0.981707317,0.784552846,1396
9fcfbd4922528017786a72d6f8fe9a1093b72bf2,0,Patrick D. Hunt,2012-03-18 06:49:02+00:00,['ddd1481372d49988289f5032777885ae5910b157'],3,17,20,498828,2,,,,1396
647740f30ef9f72b92fd5f2864884f52732fcd2c,0,Patrick D. Hunt,2012-03-18 06:59:45+00:00,['9fcfbd4922528017786a72d6f8fe9a1093b72bf2'],2,5,7,498835,2,,,,1396
bc38ec61b24cca95757ce31bd37e76919a3d04c2,1,Camille Fournier,2012-03-18 20:06:46+00:00,['647740f30ef9f72b92fd5f2864884f52732fcd2c'],3,142,145,498980,4,0.777777778,1,1,1397
f0113e70c35418b6d7136a80d4ed3b715c043684,0,Patrick D. Hunt,2012-03-19 06:11:07+00:00,['bc38ec61b24cca95757ce31bd37e76919a3d04c2'],2,5,7,498987,2,,,,1397
e5a51ead53813843ad8b9448845fd2332757c757,0,Camille Fournier,2012-03-20 00:33:49+00:00,['f0113e70c35418b6d7136a80d4ed3b715c043684'],3,118,121,499108,3,0.214285714,1,0.892857143,1398
9eed31c5d9d8285a89b5cd10d2ae0a0627d010b5,0,Henry Robinson,2012-03-30 01:01:35+00:00,['e5a51ead53813843ad8b9448845fd2332757c757'],24,32,56,499164,2,,,,1398
def8600ac25832c72cbf54da2149b11191b5dcc6,0,Henry Robinson,2012-03-30 01:05:18+00:00,['9eed31c5d9d8285a89b5cd10d2ae0a0627d010b5'],11,105,116,499280,2,1,1,1,1398
58970ee5dd534a685cd0a73c9d3ffba8fc73bfe9,0,Henry Robinson,2012-03-30 22:29:08+00:00,['def8600ac25832c72cbf54da2149b11191b5dcc6'],1,3,4,499284,2,,,,1398
1e63b65bfe6e35ef80e11e682071be9e9fc84e5c,0,Michi Mutsuzaki,2012-04-14 00:32:19+00:00,['58970ee5dd534a685cd0a73c9d3ffba8fc73bfe9'],0,16,16,499300,2,0,0,0,1398
7bf199eb4df4537adca112c7962e200a87d2666d,1,Benjamin Reed,2012-04-22 23:20:13+00:00,['1e63b65bfe6e35ef80e11e682071be9e9fc84e5c'],396,1151,1547,500847,25,0.281853282,0.374517375,0.857142857,1399
02e1a6f8e14b7dfa0e5cf098c47e25ff0197cb18,0,Michi Mutsuzaki,2012-04-24 22:08:43+00:00,['7bf199eb4df4537adca112c7962e200a87d2666d'],0,4,4,500851,2,,,,1399
d6559837810960b131deb84cf09bca386334aab7,0,Michi Mutsuzaki,2012-04-26 10:57:05+00:00,['02e1a6f8e14b7dfa0e5cf098c47e25ff0197cb18'],1,4,5,500856,2,,,,1399
2d22c5be929759f15c600e8ed7721323a0d361b8,0,Michi Mutsuzaki,2012-04-27 06:48:17+00:00,['d6559837810960b131deb84cf09bca386334aab7'],2,5,7,500863,2,,,,1399
a7b48e56f5de8e623502b8e3333ef1e4070aac84,0,Michi Mutsuzaki,2012-05-06 03:45:26+00:00,['2d22c5be929759f15c600e8ed7721323a0d361b8'],1,4,5,500868,2,,,,1399
21c9ae268fb11a0c7380e520e1eebe115fba7387,1,Michi Mutsuzaki,2012-05-08 05:03:30+00:00,['a7b48e56f5de8e623502b8e3333ef1e4070aac84'],10,15,25,500893,2,0,0,1,1399
136215a230a52a2bda8879bc1edce14fb52b99a1,1,Michi Mutsuzaki,2012-05-10 01:52:18+00:00,['21c9ae268fb11a0c7380e520e1eebe115fba7387'],1,5,6,500899,2,0,0,1,1399
25cb38f42e0d25d47ab403628b1a7f889263a932,0,Michi Mutsuzaki,2012-05-11 05:54:31+00:00,['136215a230a52a2bda8879bc1edce14fb52b99a1'],1,5,6,500905,2,,,,1399
e969c29dcd9fcd0b470ef68b4b0b08387a471746,0,Henry Robinson,2012-06-19 00:20:51+00:00,['25cb38f42e0d25d47ab403628b1a7f889263a932'],1,9,10,500915,2,0,0.857142857,0.142857143,1399
e613fbd5671c65227d5401fb855cfb17c6c93037,0,Michi Mutsuzaki,2012-06-25 17:50:42+00:00,['e969c29dcd9fcd0b470ef68b4b0b08387a471746'],2,9,11,500926,2,,,,1399
51aba88122c95aa295beed3d23d57871c0567291,0,Mahadev Konar,2012-06-29 20:08:06+00:00,['e613fbd5671c65227d5401fb855cfb17c6c93037'],1,3,4,500930,2,,,,1399
7921c4d4c663c22d3f233f2762d3ddab13214860,0,Patrick D. Hunt,2012-06-30 06:04:48+00:00,['51aba88122c95aa295beed3d23d57871c0567291'],0,8,8,500938,2,,,,1399
3ddd007e1fb6f7b63e864f6d0d375c62d1b50015,0,Patrick D. Hunt,2012-06-30 06:18:49+00:00,['7921c4d4c663c22d3f233f2762d3ddab13214860'],4,5,9,500947,5,,,,1399
a17ca1544fabfa9fa93ba7d7da7efa7ce3b96efc,1,Patrick D. Hunt,2012-06-30 06:30:58+00:00,['3ddd007e1fb6f7b63e864f6d0d375c62d1b50015'],6,54,60,501007,3,0.095238095,1,1,1400
79bc813ef687b9e05d85fa597d9b59303c7f7ded,0,Patrick D. Hunt,2012-06-30 06:42:50+00:00,['a17ca1544fabfa9fa93ba7d7da7efa7ce3b96efc'],8,11,19,501026,2,,,,1400
7cd7a41704d36186db29a9e201255e94fe77bb18,0,Patrick D. Hunt,2012-06-30 06:51:26+00:00,['79bc813ef687b9e05d85fa597d9b59303c7f7ded'],1,9,10,501036,2,,,,1400
72d9f30dca729058f645dc027b16c767abc0f479,1,Camille Fournier,2012-07-05 16:01:26+00:00,['7cd7a41704d36186db29a9e201255e94fe77bb18'],22,190,212,501248,4,0,0.233870968,1,1400
e2ad1053563537bd815dad63482b61bd34d5143d,1,Patrick D. Hunt,2012-07-17 21:19:38+00:00,['72d9f30dca729058f645dc027b16c767abc0f479'],6,499,505,501753,7,0.682926829,0.863414634,0.853658537,1403
43eedab16b074f7b87da98ac0af60092bb0c52fd,1,Patrick D. Hunt,2012-07-17 21:25:11+00:00,['e2ad1053563537bd815dad63482b61bd34d5143d'],53,678,731,502484,7,0.281914894,0.688829787,0.978723404,1405
319190660ccc69544de1f36ade16be9c38b8d3e2,0,Patrick D. Hunt,2012-07-29 05:02:56+00:00,['43eedab16b074f7b87da98ac0af60092bb0c52fd'],3,9,12,502496,3,,,,1405
3c906d668041a13fc6ff4ccf5ab7b9a6c85eda0f,0,Patrick D. Hunt,2012-07-29 05:31:15+00:00,['319190660ccc69544de1f36ade16be9c38b8d3e2'],5,7,12,502508,2,,,,1405
0679a863ae20345c3b928743a9b42dfbf14a0738,0,Patrick D. Hunt,2012-08-01 15:53:36+00:00,['3c906d668041a13fc6ff4ccf5ab7b9a6c85eda0f'],13,29,42,502550,2,0.454545455,0,1,1405
13e537edc65866cb019db72c89414537d9d28258,0,Patrick D. Hunt,2012-08-01 19:21:11+00:00,['0679a863ae20345c3b928743a9b42dfbf14a0738'],32,3,35,502585,3,1,0,0,1405
62a4165a376c7aff4675e43d7624ed5accf3dcf9,1,Patrick D. Hunt,2012-08-01 21:38:05+00:00,['13e537edc65866cb019db72c89414537d9d28258'],9,23,32,502617,3,0.375,0,1,1405
60a702955b96c2373d2b87ad02bd952e2e7dcf5f,0,Patrick D. Hunt,2012-08-01 22:24:13+00:00,['62a4165a376c7aff4675e43d7624ed5accf3dcf9'],5,13,18,502635,2,1,1,1,1405
6b79710224533848b99c2a0297591d29c06583a0,1,Henry Robinson,2012-08-02 22:17:58+00:00,['60a702955b96c2373d2b87ad02bd952e2e7dcf5f'],67,266,333,502968,5,0.255319149,1,0.957446809,1407
5a612b32100070866717d02bed5706baba8b8f12,0,Michi Mutsuzaki,2012-08-14 23:06:57+00:00,['6b79710224533848b99c2a0297591d29c06583a0'],7,11,18,502986,2,,,,1407
fe34bbf0117245bc99f5dd2fbfba2fa694e14ad6,1,Patrick D. Hunt,2012-08-28 19:51:43+00:00,['5a612b32100070866717d02bed5706baba8b8f12'],39,268,307,503293,11,1,0.447761194,0.820895522,1409
b2fab8ac4a7b651885729b4e8dfb8999a4544bf1,0,Michi Mutsuzaki,2012-08-30 18:26:37+00:00,['fe34bbf0117245bc99f5dd2fbfba2fa694e14ad6'],0,3,3,503296,2,1,1,1,1409
72291ee63d3bb4e5bdaa562bf26f744fb42f0760,0,Michi Mutsuzaki,2012-08-30 20:32:54+00:00,['b2fab8ac4a7b651885729b4e8dfb8999a4544bf1'],1,38,39,503335,2,0.535714286,0,1,1409
b962fb16c797dce7db8a08ad0344eee999563a44,1,Mahadev Konar,2012-09-03 05:56:41+00:00,['72291ee63d3bb4e5bdaa562bf26f744fb42f0760'],4,14,18,503353,5,0,1,1,1409
5a1a34c731db3382d10feddaefb11185413cb0a0,0,Michi Mutsuzaki,2012-09-04 23:18:44+00:00,['b962fb16c797dce7db8a08ad0344eee999563a44'],0,19,19,503372,2,,,,1409
9d52877a46776ab4bd3df919dd303992fddda4c9,0,Mahadev Konar,2012-09-07 06:14:59+00:00,['5a1a34c731db3382d10feddaefb11185413cb0a0'],2,5,7,503379,2,,,,1409
eaade80f3608becf006a764fcfb3a0cf54795203,1,Mahadev Konar,2012-09-07 06:22:05+00:00,['9d52877a46776ab4bd3df919dd303992fddda4c9'],3,6,9,503388,3,,,,1409
6742b20263138e1ff824cd291301d6b26a3ae278,0,Mahadev Konar,2012-09-07 06:28:57+00:00,['eaade80f3608becf006a764fcfb3a0cf54795203'],0,8,8,503396,2,0,0,0,1409
987635edac8aa374a04ea130dfd81a03a635bf0d,1,Mahadev Konar,2012-09-09 18:24:07+00:00,['6742b20263138e1ff824cd291301d6b26a3ae278'],102,326,428,503824,10,0.227642276,0.455284553,0.528455285,1409
af4a92d88c39345f02edf77d5742da0407675b3a,0,Mahadev Konar,2012-09-10 07:00:50+00:00,['987635edac8aa374a04ea130dfd81a03a635bf0d'],2,7,9,503833,2,,,,1409
97b3c20cb8ab2f133572c9ec53c1ef2df57754c4,0,Mahadev Konar,2012-09-14 07:31:20+00:00,['af4a92d88c39345f02edf77d5742da0407675b3a'],3,6,9,503842,2,,,,1409
146441c55963f84b74033caad8439f22f1a3fa12,0,Michi Mutsuzaki,2012-09-16 21:31:30+00:00,['97b3c20cb8ab2f133572c9ec53c1ef2df57754c4'],19,0,19,503861,2,,,,1409
139d1d9c4b78424708b01f239211ed83e9279fc6,1,Mahadev Konar,2012-09-17 07:53:10+00:00,['146441c55963f84b74033caad8439f22f1a3fa12'],4,168,172,504033,3,0.38028169,1,1,1410
0aefdaa7b7d70dc3b1dbf69a0ce2a660d7f362e8,0,Henry Robinson,2012-09-24 23:57:20+00:00,['139d1d9c4b78424708b01f239211ed83e9279fc6'],1,4,5,504038,2,,,,1410
0b62693cc5f86fc64ecbecebc419f2dd5fc37fdb,1,Benjamin Reed,2012-09-25 05:13:27+00:00,['0aefdaa7b7d70dc3b1dbf69a0ce2a660d7f362e8'],1,4,5,504043,2,0,1,1,1410
8c6155afb6df604ff59fa4e4148a809c0740d3b6,1,Mahadev Konar,2012-09-28 16:32:19+00:00,['0b62693cc5f86fc64ecbecebc419f2dd5fc37fdb'],24,46,70,504113,5,0,0.863636364,1,1410
6e5a25670346ddf5e4bc3b1598f8ec5e52699c09,0,Patrick D. Hunt,2012-10-31 17:24:54+00:00,['8c6155afb6df604ff59fa4e4148a809c0740d3b6'],51,53,104,504217,1,0,0,0.5,1410
71adac9671684bf11a9d5b61f00fa03dde87edd5,0,Patrick D. Hunt,2012-10-31 18:38:57+00:00,['6e5a25670346ddf5e4bc3b1598f8ec5e52699c09'],0,16,16,504233,1,1,1,1,1410
ed622598737b8e8d374a4a883ccd9a966377dbff,1,Flavio Paiva Junqueira,2012-11-17 14:03:03+00:00,['71adac9671684bf11a9d5b61f00fa03dde87edd5'],216,2166,2382,506615,18,0.527855153,0.795264624,0.97632312,1413
a60acd59a2f4fd3ec90c7692f8bdc818ca8ef04c,0,Michi Mutsuzaki,2012-11-27 01:34:47+00:00,['ed622598737b8e8d374a4a883ccd9a966377dbff'],1,4,5,506620,2,,,,1413
ae76522addd7c8c62b0cb902f8f5383922429086,0,Patrick D. Hunt,2012-11-28 07:13:09+00:00,['a60acd59a2f4fd3ec90c7692f8bdc818ca8ef04c'],381,183,564,507184,32,,,,1413
395b5effc712bb8d960ab0f2c2ee6f6fdb47140c,1,Patrick D. Hunt,2012-11-28 07:43:26+00:00,['ae76522addd7c8c62b0cb902f8f5383922429086'],20,266,286,507470,5,0.315315315,0.459459459,1,1415
05acd0a720935baefc62d4f09c20edf5942b2100,0,Michi Mutsuzaki,2012-11-30 20:43:09+00:00,['395b5effc712bb8d960ab0f2c2ee6f6fdb47140c'],38,42,80,507550,5,,,,1415
e8d3e1d74eab7234d5a31e1201819b8686bf4499,1,Patrick D. Hunt,2012-12-07 23:38:00+00:00,['05acd0a720935baefc62d4f09c20edf5942b2100'],107,955,1062,508612,8,0.692493947,0.94188862,0.97094431,1417
6c81ec754e6ca43adee1c74db09c1131029759d0,1,Patrick D. Hunt,2012-12-11 07:42:37+00:00,['e8d3e1d74eab7234d5a31e1201819b8686bf4499'],52,26,78,508690,5,1,1,0,1417
8052a710bb3373adb5777e3f19037b0ee8c05608,1,Patrick D. Hunt,2012-12-11 08:18:08+00:00,['6c81ec754e6ca43adee1c74db09c1131029759d0'],2,10,12,508702,2,0,1,1,1417
df984c4c438971f1fea05d9d1cb00742c0eb64e7,1,Patrick D. Hunt,2012-12-12 06:46:25+00:00,['8052a710bb3373adb5777e3f19037b0ee8c05608'],11,147,158,508860,11,1,1,1,1425
46a3dd2e240e069217d1779a366f88a9cfcca46f,1,Patrick D. Hunt,2012-12-12 06:58:19+00:00,['df984c4c438971f1fea05d9d1cb00742c0eb64e7'],1,3,4,508864,2,,,,1425
4ed40f05a649783c855b63d09a1b485eff2b9555,0,Patrick D. Hunt,2012-12-12 07:19:53+00:00,['46a3dd2e240e069217d1779a366f88a9cfcca46f'],5,11,16,508880,3,1,1,1,1425
179fda77564cd67f9756bbb7902d5a2a3eb67767,1,Patrick D. Hunt,2012-12-12 07:30:50+00:00,['4ed40f05a649783c855b63d09a1b485eff2b9555'],1,3,4,508884,3,,,,1425
95468116d9366b3fffcd8ccf555951c5476b165f,0,Patrick D. Hunt,2012-12-12 07:59:14+00:00,['179fda77564cd67f9756bbb7902d5a2a3eb67767'],1,8,9,508893,2,,,,1425
4dc3c07561b6ef6e36b8189909ef6b2aaf8655fc,0,Patrick D. Hunt,2012-12-13 06:05:29+00:00,['95468116d9366b3fffcd8ccf555951c5476b165f'],0,6,6,508899,2,,,,1425
848898ee7bdb3f9a4e4f416f7fc64417083fc498,0,Patrick D. Hunt,2012-12-13 07:14:30+00:00,['4dc3c07561b6ef6e36b8189909ef6b2aaf8655fc'],13,10,23,508922,2,1,0,0,1425
c84f7ef14542dc1d3291e932932e6b6faf536944,1,Patrick D. Hunt,2012-12-13 07:25:35+00:00,['848898ee7bdb3f9a4e4f416f7fc64417083fc498'],1,44,45,508967,3,0.090909091,1,1,1425
75d592d0e4bdfcade93636d6f43563699741c788,1,Patrick D. Hunt,2012-12-15 00:42:43+00:00,['c84f7ef14542dc1d3291e932932e6b6faf536944'],2,50,52,509019,2,,,,1425
ebc9340426143caf9b9452be4b93aae227abe5fc,0,Patrick D. Hunt,2012-12-16 06:43:03+00:00,['75d592d0e4bdfcade93636d6f43563699741c788'],0,10,10,509029,2,1,1,1,1425
44f44b3bb87d3ad886689ab651a2f8453d7bce7d,1,Mahadev Konar,2012-12-17 06:10:35+00:00,['ebc9340426143caf9b9452be4b93aae227abe5fc'],2,19,21,509050,3,,,,1425
e4d07112a6f1f68a6866a27e6bfec9b4e415c743,1,Mahadev Konar,2012-12-17 07:12:29+00:00,['44f44b3bb87d3ad886689ab651a2f8453d7bce7d'],1,5,6,509056,2,,,,1425
a6b12286709f3f74ac0cc2c1a31be02732545ccd,1,Patrick D. Hunt,2012-12-19 08:02:50+00:00,['e4d07112a6f1f68a6866a27e6bfec9b4e415c743'],2,6,8,509064,2,,,,1425
6206b495e0c7a8ff3bb7a30cbddf2dd8f02f6dfc,1,Patrick D. Hunt,2012-12-19 18:07:14+00:00,['a6b12286709f3f74ac0cc2c1a31be02732545ccd'],525,1457,1982,511046,10,0.572706935,0.928411633,0.914988814,1428
97a8c5be83c4468cd67fa412b715cbb4f312885e,1,Patrick D. Hunt,2012-12-19 18:16:50+00:00,['6206b495e0c7a8ff3bb7a30cbddf2dd8f02f6dfc'],43,924,967,512013,25,0.416666667,0.575757576,0.676767677,1429
dbde0aea20707b945b8852e91a69fe3ff116859f,1,Patrick D. Hunt,2012-12-20 05:50:19+00:00,['97a8c5be83c4468cd67fa412b715cbb4f312885e'],42,60,102,512115,3,0.777777778,0.777777778,1,1429
4af0f828051ace307b2378c22f0c6294ae6fd29c,1,Patrick D. Hunt,2012-12-22 00:43:53+00:00,['dbde0aea20707b945b8852e91a69fe3ff116859f'],26,56,82,512197,6,0.75,1,1,1429
28c93eba0a198b34075d9aabd94aa73b0651aa76,0,Camille Fournier,2012-12-31 01:38:10+00:00,['4af0f828051ace307b2378c22f0c6294ae6fd29c'],5,1,6,512203,2,1,1,0,1429
21ef61aa9663284e1e8fa82974514c8e84265ae2,0,Flavio Paiva Junqueira,2013-01-15 21:13:28+00:00,['28c93eba0a198b34075d9aabd94aa73b0651aa76'],67,122,189,512392,4,0.677419355,0.290322581,0.032258065,1429
9531ec29f4806a1f127e3f02d2333a64090058e4,1,Flavio Paiva Junqueira,2013-01-18 00:08:53+00:00,['21ef61aa9663284e1e8fa82974514c8e84265ae2'],122,67,189,512581,4,0.322580645,0.709677419,0.967741935,1429
36b1c43ea1056084729489031bc100706ecec173,1,Michi Mutsuzaki,2013-01-23 02:55:58+00:00,['9531ec29f4806a1f127e3f02d2333a64090058e4'],1,18,19,512600,2,,,,1429
bb857582bab316abea48588375df98de51df9115,1,Patrick D. Hunt,2013-01-25 01:17:38+00:00,['36b1c43ea1056084729489031bc100706ecec173'],7,103,110,512710,5,0.485714286,0.971428571,0.885714286,1430
a5b39b7f075cf0ee1f08ed295f85a18ad0abca89,1,Patrick D. Hunt,2013-01-25 06:33:16+00:00,['bb857582bab316abea48588375df98de51df9115'],538,258,796,513506,5,,,,1432
620c7766fc99230460a248ba1aa1e17b772c418a,0,Patrick D. Hunt,2013-01-25 06:46:16+00:00,['a5b39b7f075cf0ee1f08ed295f85a18ad0abca89'],0,88,88,513594,3,0.258064516,0.967741935,1,1433
3d81f925c585ef252a55ab09b7f3ba838f98a797,0,Patrick D. Hunt,2013-01-25 06:54:19+00:00,['620c7766fc99230460a248ba1aa1e17b772c418a'],3,96,99,513693,4,1,1,1,1435
d9dae9ae9d46ef2a29c3457651a71e40969f7256,0,Patrick D. Hunt,2013-01-25 07:08:28+00:00,['3d81f925c585ef252a55ab09b7f3ba838f98a797'],10,141,151,513844,20,1,1,1,1436
f40d5baa66a303fae65707944c8a91f724b3f132,0,Patrick D. Hunt,2013-01-25 07:12:52+00:00,['d9dae9ae9d46ef2a29c3457651a71e40969f7256'],18,20,38,513882,18,,,,1436
00f754ec3e64778ba9319fdc69af15ebf17fc117,1,Patrick D. Hunt,2013-01-25 07:23:47+00:00,['f40d5baa66a303fae65707944c8a91f724b3f132'],16,19,35,513917,32,,,,1436
4d06d8dc96d964706064d80a0235d3d8a9ade52e,0,Patrick D. Hunt,2013-01-25 07:37:01+00:00,['00f754ec3e64778ba9319fdc69af15ebf17fc117'],0,132,132,514049,18,,,,1436
1ee879ee4c5b892c8b7fa94c4f726bea8af055f8,0,Patrick D. Hunt,2013-02-03 06:08:02+00:00,['4d06d8dc96d964706064d80a0235d3d8a9ade52e'],1,1,2,514051,1,,,,1436
56591bf514cd6e2193c8155c7b824aa2e551dc4d,0,Patrick D. Hunt,2013-02-03 06:39:57+00:00,['1ee879ee4c5b892c8b7fa94c4f726bea8af055f8'],0,7,7,514058,2,,,,1436
c35f9b0303b3b4fae62802f43707a06528013906,0,Camille Fournier,2013-02-03 14:52:11+00:00,['56591bf514cd6e2193c8155c7b824aa2e551dc4d'],58,218,276,514334,6,0.18852459,0.516393443,0.926229508,1436
ab536e667a52a93b81bd2e9ccb1387971e8b6ea3,1,Patrick D. Hunt,2013-02-16 00:49:23+00:00,['c35f9b0303b3b4fae62802f43707a06528013906'],1,4,5,514339,2,,,,1436
5676ddd01e4842ddd071eca657b73677a185b653,0,Patrick D. Hunt,2013-02-16 00:59:36+00:00,['ab536e667a52a93b81bd2e9ccb1387971e8b6ea3'],14,54,68,514407,2,0.307692308,0.384615385,1,1436
39783d6c8669c8917481153a06bcbfcb4db3f748,0,Patrick D. Hunt,2013-02-19 07:55:19+00:00,['5676ddd01e4842ddd071eca657b73677a185b653'],0,12,12,514419,2,1,1,1,1436
684549caaa2bf6c741eea713b59336dfd2e9747d,0,Patrick D. Hunt,2013-02-19 08:18:05+00:00,['39783d6c8669c8917481153a06bcbfcb4db3f748'],15,33,48,514467,2,0,0,1,1436
e111d7ee149761a1e87dac2bebd6c7ebfe6cdcc3,1,Patrick D. Hunt,2013-02-19 08:28:34+00:00,['684549caaa2bf6c741eea713b59336dfd2e9747d'],2,5,7,514474,2,,,,1436
59358ab8833c83551c7f08dd91181c26d7e3b38f,1,Patrick D. Hunt,2013-02-20 00:47:18+00:00,['e111d7ee149761a1e87dac2bebd6c7ebfe6cdcc3'],237,522,759,515233,5,,,,1438
97e598b6c1068624ab6b6a663d3d40047589199a,0,Michi Mutsuzaki,2013-02-20 05:24:31+00:00,['59358ab8833c83551c7f08dd91181c26d7e3b38f'],18,5,23,515256,2,,,,1438
5428cd4bc963c2e653a260c458a8a8edf3fa08ef,1,Benjamin Reed,2013-03-07 06:01:49+00:00,['97e598b6c1068624ab6b6a663d3d40047589199a'],705,4420,5125,520381,57,0.20232333,0.335914811,0.832042594,1447
541f601a2254a52ff601ae4f74a6a7a8ebdf64df,0,Camille Fournier,2013-03-12 01:48:52+00:00,['5428cd4bc963c2e653a260c458a8a8edf3fa08ef'],4,19,23,520404,2,0,0,1,1447
7ad91c4e6c4c59a1120082e37d8d2f425b53dbd0,0,Camille Fournier,2013-03-19 15:53:06+00:00,['541f601a2254a52ff601ae4f74a6a7a8ebdf64df'],1,2,3,520407,1,,,,1447
0312b95b80af898d20c1d77b254832fb32d109f0,0,Patrick D. Hunt,2013-03-20 06:17:41+00:00,['7ad91c4e6c4c59a1120082e37d8d2f425b53dbd0'],1,4,5,520412,2,,,,1447
17560fed49670afda291d8c5d1b3048fdc15f041,0,Camille Fournier,2013-03-28 15:07:41+00:00,['0312b95b80af898d20c1d77b254832fb32d109f0'],0,15,15,520427,1,0.769230769,0.923076923,1,1447
52cf2242c993bb27c3305899ab86c2807ac269fc,0,Michi Mutsuzaki,2013-04-01 23:01:06+00:00,['17560fed49670afda291d8c5d1b3048fdc15f041'],1,1,2,520429,1,,,,1447
925599c72bc35edb5ffa25c6cc839932573b01aa,0,Flavio Paiva Junqueira,2013-05-11 12:51:25+00:00,['52cf2242c993bb27c3305899ab86c2807ac269fc'],6,10,16,520445,2,0,0,1,1447
e1574fad8afabd0df5ff9433c5d968679c3d6f1d,0,Flavio Paiva Junqueira,2013-05-11 13:35:13+00:00,['925599c72bc35edb5ffa25c6cc839932573b01aa'],9,19,28,520473,3,0,0,1,1447
0cd81fad33028481426a0e5a4d2c0f3b04355d16,0,Flavio Paiva Junqueira,2013-05-13 07:32:47+00:00,['e1574fad8afabd0df5ff9433c5d968679c3d6f1d'],1,3,4,520477,2,,,,1447
8b4520f77760b2a7d35708f556dd23a05c95c6f7,1,Flavio Paiva Junqueira,2013-05-14 12:27:11+00:00,['0cd81fad33028481426a0e5a4d2c0f3b04355d16'],124,199,323,520800,4,1,0.6875,0.375,1447
d9ad361538f52ca8122b9aad8a8378892572a87e,0,Camille Fournier,2013-05-16 16:49:11+00:00,['8b4520f77760b2a7d35708f556dd23a05c95c6f7'],1,27,28,520828,2,0,1,1,1447
4db12a94adfbdfa7f0b9c1e418a81bbac4d8dfae,1,Camille Fournier,2013-05-19 21:58:21+00:00,['d9ad361538f52ca8122b9aad8a8378892572a87e'],33,36,69,520897,6,,,,1447
37973fab29cdf4515e8e7c6898c68b9a6490b80b,1,Michi Mutsuzaki,2013-05-19 22:08:08+00:00,['4db12a94adfbdfa7f0b9c1e418a81bbac4d8dfae'],252,467,719,521616,12,0.661290323,0.370967742,0.661290323,1447
3565ab74baaf2de5d802f31ef3a71c196bfe3b06,0,Camille Fournier,2013-05-20 17:08:25+00:00,['37973fab29cdf4515e8e7c6898c68b9a6490b80b'],1,1,2,521618,1,,,,1447
1b66c34ea897ccd18ffe94d66778e2f208686ec9,1,Camille Fournier,2013-06-06 16:53:06+00:00,['3565ab74baaf2de5d802f31ef3a71c196bfe3b06'],5,57,62,521680,3,0,1,1,1447
0b2c75f0b1c256c75758bbda9d58f3e8bbc6068a,0,Camille Fournier,2013-06-21 17:56:06+00:00,['1b66c34ea897ccd18ffe94d66778e2f208686ec9'],4,23,27,521707,3,,,,1447
aec7dd83aaadc8c99a072936062467471458ddfd,0,Camille Fournier,2013-06-28 16:26:09+00:00,['0b2c75f0b1c256c75758bbda9d58f3e8bbc6068a'],3,7,10,521717,4,,,,1447
9f102d311e0d68a2e0a212b1c870a6f999a128a5,1,Thawan Kooburat,2013-06-28 21:22:35+00:00,['aec7dd83aaadc8c99a072936062467471458ddfd'],170,1588,1758,523475,12,0.282517483,0.823776224,0.728671329,1450
b40bb0b4622bb4e1eca6331b2b3b4fc271742dc9,0,Patrick D. Hunt,2013-07-01 22:54:25+00:00,['9f102d311e0d68a2e0a212b1c870a6f999a128a5'],0,15,15,523490,2,0,0,0,1450
baa95e16a9d52fe95f347e242458d0debd14dd13,0,Camille Fournier,2013-07-14 20:09:45+00:00,['b40bb0b4622bb4e1eca6331b2b3b4fc271742dc9'],327,62,389,523879,4,0.673913043,0,0,1450
c0051fd8368dffdcb82b5a43ff6751f136a05016,0,Camille Fournier,2013-07-15 01:28:42+00:00,['baa95e16a9d52fe95f347e242458d0debd14dd13'],9,11,20,523899,1,0,0,1,1450
363f5f50f27f28855ed77f362ea7c9736f295325,0,Flavio Paiva Junqueira,2013-08-21 09:40:42+00:00,['c0051fd8368dffdcb82b5a43ff6751f136a05016'],25,30,55,523954,3,0,0,0,1450
c2673e4d0a3ea359298e25609e466222a35b224f,0,Flavio Paiva Junqueira,2013-08-21 09:53:37+00:00,['363f5f50f27f28855ed77f362ea7c9736f295325'],7,15,22,523976,4,0,0,1,1450
4eb31cf5359d59b7af2bc83467a311f7341bca4f,0,Flavio Paiva Junqueira,2013-09-02 20:22:45+00:00,['c2673e4d0a3ea359298e25609e466222a35b224f'],1,3,4,523980,2,,,,1450
15c32d197968fe41d194ef11f665508ff39ed5d7,1,Flavio Paiva Junqueira,2013-09-02 21:04:12+00:00,['4eb31cf5359d59b7af2bc83467a311f7341bca4f'],6,32,38,524018,3,0,1,1,1450
7a996de098b8abf095f6479c3d9ba77329cefe21,1,Flavio Paiva Junqueira,2013-09-03 11:40:38+00:00,['15c32d197968fe41d194ef11f665508ff39ed5d7'],0,10,10,524028,2,,,,1450
62dcea67c7a3d12bdb5fa014936f465fadb1e3df,1,Flavio Paiva Junqueira,2013-09-05 21:50:08+00:00,['7a996de098b8abf095f6479c3d9ba77329cefe21'],0,51,51,524079,4,0.2,0.96,1,1450
12878387483a4084c5a3beafbfae0172a44e5dcf,1,Michi Mutsuzaki,2013-09-09 22:37:13+00:00,['62dcea67c7a3d12bdb5fa014936f465fadb1e3df'],9,74,83,524162,3,0,1,1,1451
46cbf07c4e6da3d9897ecc2373f9a0996ed730d2,0,Camille Fournier,2013-09-11 20:44:15+00:00,['12878387483a4084c5a3beafbfae0172a44e5dcf'],22,96,118,524280,3,0,0,1,1451
e3c1c87739b9fede7a0fcad0aaad0ca65b5101a9,0,Michi Mutsuzaki,2013-09-11 22:26:52+00:00,['46cbf07c4e6da3d9897ecc2373f9a0996ed730d2'],3,11,14,524294,1,0,1,1,1451
67dd6fc9df3d33e40570095b52cd6858621c3ae0,0,Flavio Paiva Junqueira,2013-09-17 23:14:04+00:00,['e3c1c87739b9fede7a0fcad0aaad0ca65b5101a9'],5,50,55,524349,3,0,0.967741935,1,1451
a00d174d986386b19b0bf285918b06f2fcf55a2f,0,Mahadev Konar,2013-09-18 02:08:33+00:00,['67dd6fc9df3d33e40570095b52cd6858621c3ae0'],4,11,15,524364,2,0,0,1,1451
885bac190a4e2cb34949fc9f3182200e95fa8d62,1,Flavio Paiva Junqueira,2013-09-18 10:58:32+00:00,['a00d174d986386b19b0bf285918b06f2fcf55a2f'],16,102,118,524482,4,0.928571429,0,1,1452
000b7dfa2fd3339af95870b95c1e12acc8313cf6,1,Flavio Paiva Junqueira,2013-09-18 13:14:07+00:00,['885bac190a4e2cb34949fc9f3182200e95fa8d62'],4,22,26,524508,2,0,0,1,1452
0b3ea918139583bebec3240194ddbd41b987d486,1,Camille Fournier,2013-09-25 16:18:03+00:00,['000b7dfa2fd3339af95870b95c1e12acc8313cf6'],3,69,72,524580,3,0.1875,0.6875,1,1452
72eb405829a9173966d6b29e229c56c95ace0524,1,Flavio Paiva Junqueira,2013-09-25 22:13:19+00:00,['0b3ea918139583bebec3240194ddbd41b987d486'],10,66,76,524656,8,0,0.724137931,0.931034483,1452
8e29703235388d3e46de1c0c0517c94e929b7c6c,0,Mahadev Konar,2013-09-26 00:00:43+00:00,['72eb405829a9173966d6b29e229c56c95ace0524'],11,20,31,524687,2,0,0,1,1452
eb1cb72922b1e974eadb8936df965d630261bd47,1,Flavio Paiva Junqueira,2013-09-26 12:05:47+00:00,['8e29703235388d3e46de1c0c0517c94e929b7c6c'],10,152,162,524849,5,0.257425743,0.95049505,1,1452
625b53c1ca89daf2aeb914eb66ed009bd2b994af,1,Mahadev Konar,2013-09-27 23:21:17+00:00,['eb1cb72922b1e974eadb8936df965d630261bd47'],20,11,31,524880,2,1,1,0,1452
85a22cac6e5059896d2ad7d273198621fed33174,0,Mahadev Konar,2013-09-27 23:24:37+00:00,['625b53c1ca89daf2aeb914eb66ed009bd2b994af'],9,22,31,524911,2,0,0,1,1452
6177dd957378c5420f19f7eb86dabfcf10be3ff8,0,Camille Fournier,2013-09-29 20:24:03+00:00,['85a22cac6e5059896d2ad7d273198621fed33174'],8,13,21,524932,2,0,1,1,1452
5891c35930d85dbcabd1dc85194dbbbe877a14c8,1,Thawan Kooburat,2013-09-30 20:20:30+00:00,['6177dd957378c5420f19f7eb86dabfcf10be3ff8'],12,96,108,525040,6,0.25,0.285714286,0.964285714,1452
0e97f2359dbc38e01b7e1410415f7bf03423d6f0,0,Thawan Kooburat,2013-09-30 20:52:58+00:00,['5891c35930d85dbcabd1dc85194dbbbe877a14c8'],0,18,18,525058,2,,,,1452
4e82aebecc6338b5668742c87ebd0d913c08410c,0,Patrick D. Hunt,2013-10-01 05:56:21+00:00,['0e97f2359dbc38e01b7e1410415f7bf03423d6f0'],4,12,16,525074,4,0,1,1,1452
9c953d1ae260f062f696dad48ed40e68b78af2ba,1,Patrick D. Hunt,2013-10-01 21:18:07+00:00,['4e82aebecc6338b5668742c87ebd0d913c08410c'],9,13,22,525096,5,,,,1452
f6db73a0374f756043ad3b99b994c61cdbd30152,0,Patrick D. Hunt,2013-10-01 21:42:24+00:00,['9c953d1ae260f062f696dad48ed40e68b78af2ba'],2,6,8,525104,2,,,,1452
7033e577a54e1df2a766e1cd59836c7c837e6e74,0,Patrick D. Hunt,2013-10-01 23:45:22+00:00,['f6db73a0374f756043ad3b99b994c61cdbd30152'],1,19,20,525124,4,0.6,1,1,1453
88b11f243b4a51eba3a6b0522bc58dd4bd34f921,0,Patrick D. Hunt,2013-10-02 18:19:30+00:00,['7033e577a54e1df2a766e1cd59836c7c837e6e74'],7,17,24,525148,2,0.25,0.25,1,1453
3d68334a22dbbab796df96c399a33553cd4a08a7,1,Patrick D. Hunt,2013-10-03 16:45:52+00:00,['88b11f243b4a51eba3a6b0522bc58dd4bd34f921'],0,36,36,525184,3,0,0,1,1453
f17ef583f7e650eda9d32be603784747f47b794d,1,Patrick D. Hunt,2013-10-03 16:57:07+00:00,['3d68334a22dbbab796df96c399a33553cd4a08a7'],9,40,49,525233,21,,,,1453
0e3441598e4ca9103f86e6f5b72a59e24848c008,0,Flavio Paiva Junqueira,2013-10-03 21:48:28+00:00,['f17ef583f7e650eda9d32be603784747f47b794d'],7,23,30,525263,2,0,0,1,1453
c3bd2f5a3b62d048459e3935997b638cbdbec648,0,Michi Mutsuzaki,2013-10-04 22:17:00+00:00,['0e3441598e4ca9103f86e6f5b72a59e24848c008'],2,5,7,525270,3,,,,1453
eda0f162f7b0e7d93e835c2645e1b40a09e65b63,1,Michi Mutsuzaki,2013-10-04 22:57:41+00:00,['c3bd2f5a3b62d048459e3935997b638cbdbec648'],10,12,22,525292,10,,,,1453
adedc7a421c723f1427cd0034953e1826587d9bb,1,Thawan Kooburat,2013-10-07 19:08:55+00:00,['eda0f162f7b0e7d93e835c2645e1b40a09e65b63'],41,322,363,525655,5,0.159624413,0.845070423,1,1453
28246a44ef4653515708937fc2a9c5d51baa0937,1,Patrick D. Hunt,2013-10-07 23:35:20+00:00,['adedc7a421c723f1427cd0034953e1826587d9bb'],5,144,149,525804,4,0.571428571,1,1,1454
391c1654747d2c856ae63001b1bfdf7c149c2e19,1,Patrick D. Hunt,2013-10-07 23:36:54+00:00,['28246a44ef4653515708937fc2a9c5d51baa0937'],7,4,11,525815,16,,,,1454
b74c78067fc6754f3a56cff0b2b6136f0a973b11,0,Patrick D. Hunt,2013-10-08 05:27:30+00:00,['391c1654747d2c856ae63001b1bfdf7c149c2e19'],1,4,5,525820,2,,,,1454
b848a573d4e60cd3222adf130fb6b8942b280467,1,Patrick D. Hunt,2013-10-08 05:34:46+00:00,['b74c78067fc6754f3a56cff0b2b6136f0a973b11'],1,30,31,525851,3,,0,,1454
19b0b8f0308d5a5bf80d91b02e7c51ea8cc4bf81,1,Patrick D. Hunt,2013-10-08 06:44:54+00:00,['b848a573d4e60cd3222adf130fb6b8942b280467'],21,79,100,525951,6,0.918918919,0,0,1454
01d4e780adb67f7feb98f1e4b1c1c3cff92d497f,1,Patrick D. Hunt,2013-10-09 16:50:05+00:00,['19b0b8f0308d5a5bf80d91b02e7c51ea8cc4bf81'],16,18,34,525985,18,,,,1454
b71191f514a2eec512f795e43a25c64d48f0e4c7,1,Thawan Kooburat,2013-10-09 20:21:55+00:00,['01d4e780adb67f7feb98f1e4b1c1c3cff92d497f'],222,2373,2595,528580,41,0.45487042,0.629133155,0.941912422,1464
e8287a053f0e7177b329474025105c64d17b8401,1,Patrick D. Hunt,2013-10-09 22:11:56+00:00,['b71191f514a2eec512f795e43a25c64d48f0e4c7'],2,7,9,528589,2,,,,1464
51cd9ed37bea20aeb10c8c80ad3279bbca6f5582,1,Camille Fournier,2013-10-10 18:06:17+00:00,['e8287a053f0e7177b329474025105c64d17b8401'],0,206,206,528795,4,0.11,0.77,1,1465
2cfb6cc4a2f78c35d6cd9d840c7b28d31f4ff80a,1,Patrick D. Hunt,2013-10-11 19:18:14+00:00,['51cd9ed37bea20aeb10c8c80ad3279bbca6f5582'],5,8,13,528808,3,,,,1465
01e35751f88c5d7509d47c24b264d36223bf4d72,0,Patrick D. Hunt,2013-10-11 22:04:17+00:00,['2cfb6cc4a2f78c35d6cd9d840c7b28d31f4ff80a'],4,15,19,528827,3,1,1,1,1465
418eab7b6b84ea4ea0a139bf882a50ddc88f148e,0,Patrick D. Hunt,2013-10-14 23:56:53+00:00,['01e35751f88c5d7509d47c24b264d36223bf4d72'],0,5,5,528832,3,,,,1465
80c6bd4a6da25700bb18bbae309cb01824ac466c,0,Patrick D. Hunt,2013-10-17 17:07:44+00:00,['418eab7b6b84ea4ea0a139bf882a50ddc88f148e'],0,13,13,528845,2,1,1,0,1465
c6ee0139d58250ac07ddfa3692c9adec488339bf,1,Flavio Paiva Junqueira,2013-10-21 21:36:55+00:00,['80c6bd4a6da25700bb18bbae309cb01824ac466c'],6,126,132,528977,6,0,0.169230769,1,1465
ec36884c2d49e4256f1d439efce3347c0a92800c,1,Flavio Paiva Junqueira,2013-10-22 10:54:44+00:00,['c6ee0139d58250ac07ddfa3692c9adec488339bf'],39,266,305,529282,4,0.315315315,1,1,1466
10987f3f578d8ca24140dc30c002120e992a542e,0,Patrick D. Hunt,2013-10-22 23:15:22+00:00,['ec36884c2d49e4256f1d439efce3347c0a92800c'],1,13,14,529296,2,0,1,1,1466
3ec0ca950f58667c568e1d5bb9f5ea65e1a8165b,0,Patrick D. Hunt,2013-10-22 23:23:54+00:00,['10987f3f578d8ca24140dc30c002120e992a542e'],0,0,0,529296,0,,,,1466
10abb60db7ca7eed540dc637ecfd638dce4edc40,0,Patrick D. Hunt,2013-10-24 01:09:54+00:00,['3ec0ca950f58667c568e1d5bb9f5ea65e1a8165b'],37,101,138,529434,3,1,1,1,1467
bac5a6bfbb4134c7c41bb6521d1199b7ca8127a1,1,Patrick D. Hunt,2013-10-24 05:11:40+00:00,['10abb60db7ca7eed540dc637ecfd638dce4edc40'],3,11,14,529448,2,,,,1467
4fe97763c2e765c5140071906f7f70d0727abb5d,1,Patrick D. Hunt,2013-10-24 05:21:13+00:00,['bac5a6bfbb4134c7c41bb6521d1199b7ca8127a1'],3,19,22,529470,3,1,1,1,1467
293386c3be43fcd98754ac476385e399b426c02b,0,Thawan Kooburat,2013-10-24 18:41:12+00:00,['4fe97763c2e765c5140071906f7f70d0727abb5d'],0,14,14,529484,3,0,0,1,1467
08014e67410fa8a5235e91f57ad302efeedb43a1,1,Camille Fournier,2013-11-05 02:02:37+00:00,['293386c3be43fcd98754ac476385e399b426c02b'],2,44,46,529530,3,0.321428571,0.321428571,1,1467
c56db03e686ab805821896486717123ed84e38a1,1,Benjamin Reed,2013-11-07 05:41:50+00:00,['08014e67410fa8a5235e91f57ad302efeedb43a1'],47,95,142,529672,8,0.04,0.08,1,1467
6ce15c7bcf685a111fcd049953382409898ec0c9,0,Patrick D. Hunt,2013-11-12 06:33:32+00:00,['c56db03e686ab805821896486717123ed84e38a1'],2,7,9,529681,2,0,0,1,1467
dd31b9d9c5fdc608e269dd2f9b38d12afbecbef0,0,Thawan Kooburat,2013-11-14 04:34:42+00:00,['6ce15c7bcf685a111fcd049953382409898ec0c9'],0,8,8,529689,1,1,1,1,1467
d5d0164a60150d2ad2885f938ef7b215f12b8cbc,0,Flavio Paiva Junqueira,2013-11-15 18:06:26+00:00,['dd31b9d9c5fdc608e269dd2f9b38d12afbecbef0'],2,4,6,529695,2,,,,1467
23852655a6d41f675b8a9cca66387fca9bfe4e12,1,Michi Mutsuzaki,2013-11-19 01:03:43+00:00,['d5d0164a60150d2ad2885f938ef7b215f12b8cbc'],45,78,123,529818,12,0,0.655172414,1,1467
595bf52d2f66e3b09149cfc0cad6a240a5bfd30b,0,Flavio Paiva Junqueira,2013-11-27 23:22:03+00:00,['23852655a6d41f675b8a9cca66387fca9bfe4e12'],0,7,7,529825,2,0,1,1,1467
133f1c48b0c5fa8a10f0832d2857ecab8f66cb2c,0,Michi Mutsuzaki,2013-12-04 04:14:52+00:00,['595bf52d2f66e3b09149cfc0cad6a240a5bfd30b'],3,18,21,529846,3,0.818181818,1,0.181818182,1467
65348e6224b802376d88202ed760f6cd472bfca4,1,Flavio Paiva Junqueira,2013-12-07 10:16:34+00:00,['133f1c48b0c5fa8a10f0832d2857ecab8f66cb2c'],3,31,34,529880,3,0.619047619,1,1,1467
de87a016c6de64b825d2edbeebd621c7baced9b4,0,Michi Mutsuzaki,2013-12-10 20:38:32+00:00,['65348e6224b802376d88202ed760f6cd472bfca4'],2,8,10,529890,3,,,,1467
95d4897e7794be975210789c437f06ee28489608,0,Michi Mutsuzaki,2013-12-11 00:10:29+00:00,['de87a016c6de64b825d2edbeebd621c7baced9b4'],0,5,5,529895,2,0,0,1,1467
cdee4002b4b7d14413a5ed447dbbd146c5a99eee,0,Camille Fournier,2013-12-11 18:22:04+00:00,['95d4897e7794be975210789c437f06ee28489608'],2,493,495,530390,7,0.60199005,1,0.925373134,1471
32d900b1d439f1ef52c69185e5bc6f73d272ed0b,0,Michi Mutsuzaki,2013-12-16 04:18:47+00:00,['cdee4002b4b7d14413a5ed447dbbd146c5a99eee'],24,29,53,530443,3,0,1,1,1471
f271dac9f994770ef3ae389484f2d1519cc9f259,1,Patrick D. Hunt,2013-12-16 06:29:50+00:00,['32d900b1d439f1ef52c69185e5bc6f73d272ed0b'],1,4,5,530448,2,,,,1471
5cb7ec496c5aeaaa0b93331e264b6bd415cd33f6,0,Michi Mutsuzaki,2013-12-16 21:47:20+00:00,['f271dac9f994770ef3ae389484f2d1519cc9f259'],7,12,19,530467,2,,,,1471
59ecde5ed38f0c6701d818841446793214cf702e,0,Patrick D. Hunt,2013-12-17 16:55:29+00:00,['5cb7ec496c5aeaaa0b93331e264b6bd415cd33f6'],3,205,208,530675,5,0.206451613,0.722580645,0.683870968,1471
1fb8b4c89b05463e3afcd05dfd4b402d70c81427,1,Patrick D. Hunt,2013-12-20 01:28:50+00:00,['59ecde5ed38f0c6701d818841446793214cf702e'],30,87,117,530792,3,,,,1471
efdb06a6b401831ee18b31b35b78072b87f43a15,1,Flavio Paiva Junqueira,2013-12-21 21:05:40+00:00,['1fb8b4c89b05463e3afcd05dfd4b402d70c81427'],6,43,49,530841,15,0,0,1,1471
310f890ff8c4e4977204fb0dd8443bbe6ba3c7a1,1,Flavio Paiva Junqueira,2013-12-27 14:57:20+00:00,['efdb06a6b401831ee18b31b35b78072b87f43a15'],1,107,108,530949,3,0.113636364,1,1,1472
1ae076d14c012d8b87b5e6c68732af542aa5b235,0,Flavio Paiva Junqueira,2013-12-27 16:46:37+00:00,['310f890ff8c4e4977204fb0dd8443bbe6ba3c7a1'],3,4,7,530956,1,,,,1472
772304a191c1ea1dc41185d6ccfca51d41c4d240,1,Flavio Paiva Junqueira,2014-01-03 00:24:52+00:00,['1ae076d14c012d8b87b5e6c68732af542aa5b235'],18,34,52,531008,3,0.466666667,0.733333333,0.666666667,1472
e20321dbdfde955a08717f4424c4ecf1336c5838,0,Flavio Paiva Junqueira,2014-01-03 00:40:13+00:00,['772304a191c1ea1dc41185d6ccfca51d41c4d240'],0,17,17,531025,1,,,,1472
50f99d983fb877151bcf896549187ae0d02f66ae,0,Michi Mutsuzaki,2014-01-09 19:21:10+00:00,['e20321dbdfde955a08717f4424c4ecf1336c5838'],3,6,9,531034,2,0,1,1,1472
90e482b0612a02c53802bdee79a251b2192f91ce,0,Michi Mutsuzaki,2014-01-09 21:01:29+00:00,['50f99d983fb877151bcf896549187ae0d02f66ae'],0,15,15,531049,2,1,1,1,1472
abf9f386c9a2cf4983c00103e3e7d24814296cc4,1,Michi Mutsuzaki,2014-01-09 22:56:41+00:00,['90e482b0612a02c53802bdee79a251b2192f91ce'],0,12,12,531061,3,0,1,1,1472
f7c7765b6c4e2b9f69af9d80b63bee5daf2df90f,1,Patrick D. Hunt,2014-01-13 22:34:05+00:00,['abf9f386c9a2cf4983c00103e3e7d24814296cc4'],2,8,10,531071,2,1,1,0,1472
68d5ca8c5a33a9382ef2b95f54969a4ae8499f1b,0,Flavio Paiva Junqueira,2014-01-16 22:59:23+00:00,['f7c7765b6c4e2b9f69af9d80b63bee5daf2df90f'],33,67,100,531171,4,0,0,1,1472
fef1ae2e7b2bf712b315b6907ebef0bf2a988927,1,Michi Mutsuzaki,2014-01-21 03:50:01+00:00,['68d5ca8c5a33a9382ef2b95f54969a4ae8499f1b'],49,91,140,531311,11,0.5,0.590909091,0.909090909,1472
da950d6d6dc517bf9d1e7f2ccb61d794740309f2,1,Michi Mutsuzaki,2014-01-21 20:29:52+00:00,['fef1ae2e7b2bf712b315b6907ebef0bf2a988927'],0,243,243,531554,1,0.728813559,1,0.889830508,1473
98789ea4876fea771ca761d1c66d44e18d104b8e,1,Patrick D. Hunt,2014-01-24 06:18:32+00:00,['da950d6d6dc517bf9d1e7f2ccb61d794740309f2'],16,1356,1372,532926,15,0.166301969,0.824945295,0.704595186,1475
8c5689ad175d4cdcb3c350e6964a61bdc50288b5,0,Flavio Paiva Junqueira,2014-01-25 00:17:07+00:00,['98789ea4876fea771ca761d1c66d44e18d104b8e'],5,116,121,533047,5,0.184615385,0.184615385,1,1475
4b1e9ecd134cff894d2c1efc6f1c783bd3d8aa0e,0,Flavio Paiva Junqueira,2014-01-27 13:37:00+00:00,['8c5689ad175d4cdcb3c350e6964a61bdc50288b5'],6,12,18,533065,2,0,0,1,1475
523a776780c0af1d15e60667ac3e2532c3779380,1,Patrick D. Hunt,2014-02-10 20:50:54+00:00,['4b1e9ecd134cff894d2c1efc6f1c783bd3d8aa0e'],56,77,133,533198,3,0,1,1,1475
2c7fbbecd7122815aa6072096be7c5737d04a670,1,Patrick D. Hunt,2014-02-10 21:25:49+00:00,['523a776780c0af1d15e60667ac3e2532c3779380'],1,11,12,533210,2,0,0,1,1475
f6752dd0648c8c00cc8cd5dc3333da7760cfb4bb,0,Michi Mutsuzaki,2014-02-12 01:30:48+00:00,['2c7fbbecd7122815aa6072096be7c5737d04a670'],8,21,29,533239,2,1,1,1,1475
87dbab3b7c2d30c4b65659eb001ea859d96ad7ae,1,Michi Mutsuzaki,2014-02-12 01:39:48+00:00,['f6752dd0648c8c00cc8cd5dc3333da7760cfb4bb'],3,6,9,533248,2,,,,1475
5d00c83b2a94bf40477651d9b0176e2d7d07012a,0,Flavio Paiva Junqueira,2014-02-12 16:00:09+00:00,['87dbab3b7c2d30c4b65659eb001ea859d96ad7ae'],34,120,154,533402,8,0.090909091,0.712121212,0.848484848,1475
d88a04ffdfa37cb80f4a8adf2d205d9a36b27840,1,Camille Fournier,2014-02-14 00:34:30+00:00,['5d00c83b2a94bf40477651d9b0176e2d7d07012a'],18,11,29,533431,2,1,0.222222222,0,1475
6aaa3b23f708fbbd1c04f58646ba27cb70831e27,0,Camille Fournier,2014-02-19 01:31:53+00:00,['d88a04ffdfa37cb80f4a8adf2d205d9a36b27840'],8,69,77,533508,3,0,1,0.717391304,1475
0a7acbeceb177ccdb3e8504039c8b4fa2a3d25c0,0,Michi Mutsuzaki,2014-03-05 21:53:40+00:00,['6aaa3b23f708fbbd1c04f58646ba27cb70831e27'],1,5,6,533514,2,,,,1475
e4fd07ec20d22bdbd697bf8f2ace6144ad645cd0,1,Michi Mutsuzaki,2014-03-10 23:28:19+00:00,['0a7acbeceb177ccdb3e8504039c8b4fa2a3d25c0'],3,18,21,533535,4,,,,1475
d289eddfbc700308aa646b3fae3bbbde19a0bbd0,0,Michi Mutsuzaki,2014-03-11 01:44:30+00:00,['e4fd07ec20d22bdbd697bf8f2ace6144ad645cd0'],7,22,29,533564,2,0,0,1,1475
7799dea8f39a0696fd2871f56764f21f0d43b8cb,1,Michi Mutsuzaki,2014-03-12 21:44:20+00:00,['d289eddfbc700308aa646b3fae3bbbde19a0bbd0'],7,14,21,533585,2,0,0,1,1475
ad745010ff099460410ff17abf4150256180c446,0,Michi Mutsuzaki,2014-03-12 22:25:14+00:00,['7799dea8f39a0696fd2871f56764f21f0d43b8cb'],2,5,7,533592,2,,,,1475
3dc91bd289fe1b07384eaea23c96bb81bb336912,0,Michi Mutsuzaki,2014-03-12 22:57:11+00:00,['ad745010ff099460410ff17abf4150256180c446'],2,3,5,533597,2,1,1,0,1475
5dec5415968f75ed7938ea47ecdfc8dcbcdd487c,1,Michi Mutsuzaki,2014-03-13 01:39:14+00:00,['3dc91bd289fe1b07384eaea23c96bb81bb336912'],5,2,7,533604,2,,,,1475
ef80ec4cd22280436abd1492e3944b2d7972b310,0,Michi Mutsuzaki,2014-03-13 20:58:01+00:00,['5dec5415968f75ed7938ea47ecdfc8dcbcdd487c'],5,5,10,533614,2,1,0,0,1475
f91ae0ca6c047ebb729b91323ecb9447c4955dfc,1,Michi Mutsuzaki,2014-03-14 22:51:29+00:00,['ef80ec4cd22280436abd1492e3944b2d7972b310'],11,72,83,533697,3,0.315789474,1,1,1475
f636c489c15a257c52659af7c9913883767fc7c1,0,Michi Mutsuzaki,2014-03-14 23:10:35+00:00,['f91ae0ca6c047ebb729b91323ecb9447c4955dfc'],5,21,26,533723,2,1,1,1,1475
66646796c2173423655c7faf2b458b658143e6b5,0,Michi Mutsuzaki,2014-03-21 05:36:11+00:00,['f636c489c15a257c52659af7c9913883767fc7c1'],28,28,56,533779,4,,,,1475
a6e8a13a2da6df08f4426cc4f623ec5c76078ba9,1,Michi Mutsuzaki,2014-03-23 03:12:56+00:00,['66646796c2173423655c7faf2b458b658143e6b5'],43,257,300,534079,21,0.912280702,1,1,1478
71989813100ed91620ec18989cd2d0b1b7c8a9df,0,Michi Mutsuzaki,2014-03-23 21:03:31+00:00,['a6e8a13a2da6df08f4426cc4f623ec5c76078ba9'],0,6,6,534085,2,1,1,0,1478
14c3f3450c34a6b4ce2c63815441204eec512220,1,Michi Mutsuzaki,2014-03-25 21:13:19+00:00,['71989813100ed91620ec18989cd2d0b1b7c8a9df'],18,248,266,534351,7,0.113207547,0.987421384,0.672955975,1478
183a0c8e527eb588d533ee77fb21a2d3a690c292,0,Michi Mutsuzaki,2014-03-26 21:13:46+00:00,['14c3f3450c34a6b4ce2c63815441204eec512220'],3,18,21,534372,3,0,1,1,1478
3f307c4f9c8520d4fdab2c82353704209378d6a2,0,Michi Mutsuzaki,2014-03-26 21:25:14+00:00,['183a0c8e527eb588d533ee77fb21a2d3a690c292'],9,15,24,534396,1,0,1,1,1478
bf399b1cbc94f6d90258be699a3c92525cecfa65,1,Camille Fournier,2014-03-28 00:58:20+00:00,['3f307c4f9c8520d4fdab2c82353704209378d6a2'],1,162,163,534559,4,0.584615385,0.969230769,1,1480
153cc794b33dcdac3c68b10be10f88d5a86d478c,1,Michi Mutsuzaki,2014-03-29 03:23:57+00:00,['bf399b1cbc94f6d90258be699a3c92525cecfa65'],6,31,37,534596,4,,,,1480
0ad01693759ea809bca14597f24a35d0465acf97,1,Michi Mutsuzaki,2014-03-29 03:33:53+00:00,['153cc794b33dcdac3c68b10be10f88d5a86d478c'],30,102,132,534728,9,0,0.931034483,1,1480
d30292be3cf8e497976352267a7c593a5200f892,0,Michi Mutsuzaki,2014-03-29 23:01:40+00:00,['0ad01693759ea809bca14597f24a35d0465acf97'],1,54,55,534783,3,0,1,1,1480
704af2e35ca68a26b72cb5ecdbcb08ff3c177727,1,Michi Mutsuzaki,2014-03-31 23:47:08+00:00,['d30292be3cf8e497976352267a7c593a5200f892'],3,61,64,534847,3,0,0.84375,0.84375,1480
256f95f52cd94b6b2e0b24bf69799d79b9011ffa,1,Michi Mutsuzaki,2014-03-31 23:56:32+00:00,['704af2e35ca68a26b72cb5ecdbcb08ff3c177727'],1,64,65,534912,3,0,1,1,1481
d12eaac21d56efca9b2d677d2521a6d5c4f63020,1,Michi Mutsuzaki,2014-04-01 01:45:52+00:00,['256f95f52cd94b6b2e0b24bf69799d79b9011ffa'],2,12,14,534926,2,0,0,1,1481
2b8f98be7407da4417dd192f3de4605a99e3cd15,0,Michi Mutsuzaki,2014-04-01 02:03:02+00:00,['d12eaac21d56efca9b2d677d2521a6d5c4f63020'],2,146,148,535074,6,0.4,1,1,1484
bc2b5f7460d8c64cc457295f672a9436579f6d43,0,Michi Mutsuzaki,2014-04-01 20:58:07+00:00,['2b8f98be7407da4417dd192f3de4605a99e3cd15'],1,17,18,535092,3,1,1,1,1484
4d7af83cbc0156cae23b145e85b60f270c241462,1,Michi Mutsuzaki,2014-04-03 22:39:16+00:00,['bc2b5f7460d8c64cc457295f672a9436579f6d43'],0,5,5,535097,2,0,0,1,1484
1b5e4ddef8979830dd58e86a365c640f298eae3e,1,Michi Mutsuzaki,2014-04-03 23:03:34+00:00,['4d7af83cbc0156cae23b145e85b60f270c241462'],0,434,434,535531,4,0.204724409,0.771653543,0.980314961,1486
d74987b1a645223bcf52f0da792a315cc97017d0,0,Michi Mutsuzaki,2014-04-03 23:13:29+00:00,['1b5e4ddef8979830dd58e86a365c640f298eae3e'],1,25,26,535557,2,,,,1486
b1befb0c4d51d13081690fcb0994bc306de7cc2f,0,Michi Mutsuzaki,2014-04-04 01:24:37+00:00,['d74987b1a645223bcf52f0da792a315cc97017d0'],7217,7217,14434,549991,37,,,,1486
257747486999fe0d3f44a6c8cd1c0b433ae0a518,0,Michi Mutsuzaki,2014-04-04 01:33:45+00:00,['b1befb0c4d51d13081690fcb0994bc306de7cc2f'],0,22,22,550013,2,,,,1487
4ba3dab7007416dc79aa90b9bb6095a40ca22d52,0,Michi Mutsuzaki,2014-04-07 01:30:49+00:00,['257747486999fe0d3f44a6c8cd1c0b433ae0a518'],4,4,8,550021,2,,,,1487
bf834b10ef709689070199d1b6b94aa189880651,0,Michi Mutsuzaki,2014-04-10 03:20:17+00:00,['4ba3dab7007416dc79aa90b9bb6095a40ca22d52'],47,48,95,550116,1,,,,1487
f7c4e5aae7d08fcd093c54fe44490fe3cf3f8554,1,Michi Mutsuzaki,2014-04-14 21:51:55+00:00,['bf834b10ef709689070199d1b6b94aa189880651'],9,13,22,550138,2,,,,1487
1dc931af0614501282db98541b1edf25a4005e7e,1,Michi Mutsuzaki,2014-04-16 06:15:28+00:00,['f7c4e5aae7d08fcd093c54fe44490fe3cf3f8554'],2,459,461,550599,7,0.14619883,0.666666667,0.304093567,1487
dcffe61b804ecf6bb007f475fa8d6447ee2bb0f6,1,Michi Mutsuzaki,2014-04-16 07:06:54+00:00,['1dc931af0614501282db98541b1edf25a4005e7e'],1,4,5,550604,2,,,,1487
5a882c303de74370c7e57a516b68d07260be9bc3,1,Rakesh Radhakrishnan,2014-04-17 06:47:18+00:00,['dcffe61b804ecf6bb007f475fa8d6447ee2bb0f6'],18,131,149,550753,7,0.169811321,0.264150943,0.58490566,1487
169539763762e38eaf08276a8f1e51835dc5387c,0,Michi Mutsuzaki,2014-04-18 22:31:53+00:00,['5a882c303de74370c7e57a516b68d07260be9bc3'],1,4,5,550758,2,,,,1487
9f2a90d8e0862e92c24d82518112843711f46748,0,Michi Mutsuzaki,2014-04-25 08:10:04+00:00,['169539763762e38eaf08276a8f1e51835dc5387c'],0,19,19,550777,2,,,,1487
c0a648f23eb228315fbbab5d0dd59970adaf308c,0,Michi Mutsuzaki,2014-04-25 19:35:56+00:00,['9f2a90d8e0862e92c24d82518112843711f46748'],1,4,5,550782,2,,,,1487
686dc0204c46081ddcc64d93c20b46803df56d84,0,Michi Mutsuzaki,2014-04-25 21:40:28+00:00,['c0a648f23eb228315fbbab5d0dd59970adaf308c'],1,30,31,550813,3,0.217391304,0.217391304,1,1487
a6bc130294da3c7473b3d215699b98fac1f2cd7f,0,Michi Mutsuzaki,2014-04-26 21:16:37+00:00,['686dc0204c46081ddcc64d93c20b46803df56d84'],3,148,151,550964,3,1,1,1,1488
a1cd9204d298ca9b5b30c2f272d55b306c393271,1,Camille Fournier,2014-04-29 00:23:58+00:00,['a6bc130294da3c7473b3d215699b98fac1f2cd7f'],58,565,623,551587,12,0.204851752,0.851752022,0.800539084,1488
6b77e2eff3c9f7958a6eeb79ea1654433b274e0e,1,Rakesh Radhakrishnan,2014-04-30 02:30:23+00:00,['a1cd9204d298ca9b5b30c2f272d55b306c393271'],14,28,42,551629,3,,,,1488
bccdf97d4cd82b475f009e338b6c9dfcccdd1219,0,Rakesh Radhakrishnan,2014-05-04 12:36:12+00:00,['6b77e2eff3c9f7958a6eeb79ea1654433b274e0e'],2,5,7,551636,2,,,,1488
c082d051d6e9214f5e6e81712700969f47dcf182,0,Michi Mutsuzaki,2014-05-08 21:45:57+00:00,['bccdf97d4cd82b475f009e338b6c9dfcccdd1219'],1,3,4,551640,2,,,,1488
6135724bd1bf98ff7c5716581494f57f6febc131,0,Michi Mutsuzaki,2014-05-09 21:37:39+00:00,['c082d051d6e9214f5e6e81712700969f47dcf182'],14,28,42,551682,5,,,,1488
85aac3dd0b1d925c20bacecc72c3da9940b296c7,1,Rakesh Radhakrishnan,2014-05-10 10:42:44+00:00,['6135724bd1bf98ff7c5716581494f57f6febc131'],12,8,20,551702,2,1,1,0,1488
74d8363cd562d4c082ae4bc9120d693def2ddb6b,0,Rakesh Radhakrishnan,2014-05-15 01:35:33+00:00,['85aac3dd0b1d925c20bacecc72c3da9940b296c7'],2,15,17,551719,2,0.6,0.6,0.4,1488
0d95c4cf49da7bb2ed895b62a1672fb1eeb2ac25,0,Michi Mutsuzaki,2014-05-15 20:39:36+00:00,['74d8363cd562d4c082ae4bc9120d693def2ddb6b'],1,4,5,551724,2,,,,1488
7550dbcf01bd2e6c54d5e9a6dd0457b106aae62a,0,Michi Mutsuzaki,2014-05-16 17:56:10+00:00,['0d95c4cf49da7bb2ed895b62a1672fb1eeb2ac25'],1,1,2,551726,1,,,,1488
fa7fe4d667a9b008cb409abec9505b07e9f34533,0,Michi Mutsuzaki,2014-05-16 22:31:11+00:00,['7550dbcf01bd2e6c54d5e9a6dd0457b106aae62a'],12,10,22,551748,2,,,,1488
0252993977bb42940aae2088f29a5e4898bcf3da,1,Rakesh Radhakrishnan,2014-05-17 11:23:25+00:00,['fa7fe4d667a9b008cb409abec9505b07e9f34533'],10,14,24,551772,2,0,0,1,1488
3f8cc1b8a6c754b992aec568b8e71b84f956ecdf,1,Michi Mutsuzaki,2014-05-18 01:01:55+00:00,['0252993977bb42940aae2088f29a5e4898bcf3da'],109,402,511,552283,4,0.085201794,0.843049327,0.887892377,1489
d3b2024b8198bd39a6823787a9fc0dde644a7f90,0,Michi Mutsuzaki,2014-05-18 02:42:14+00:00,['3f8cc1b8a6c754b992aec568b8e71b84f956ecdf'],2,5,7,552290,3,,,,1489
903ce8dff71fb53de27ba2c16563e4ed43bf504e,1,Michi Mutsuzaki,2014-05-18 03:49:06+00:00,['d3b2024b8198bd39a6823787a9fc0dde644a7f90'],36,157,193,552483,5,0.156862745,0.941176471,1,1490
48190161d4515021541a08c2b61a65be438df6ef,0,Rakesh Radhakrishnan,2014-05-20 15:10:30+00:00,['903ce8dff71fb53de27ba2c16563e4ed43bf504e'],1,14,15,552498,2,0,1,1,1490
a8e0d7ba7d9797be3aa021fe23d5aef52ef39b91,1,Michi Mutsuzaki,2014-05-20 21:42:51+00:00,['48190161d4515021541a08c2b61a65be438df6ef'],79,91,170,552668,3,0,0,1,1490
2e72f47750f3b97e9441fdb30b82dd3914a04ac5,0,Michi Mutsuzaki,2014-05-21 17:48:37+00:00,['a8e0d7ba7d9797be3aa021fe23d5aef52ef39b91'],0,82,82,552750,1,1,1,1,1491
d0d947e8c2587e6c18a002b4afbc987210529c9a,0,Flavio Paiva Junqueira,2014-05-21 21:03:47+00:00,['2e72f47750f3b97e9441fdb30b82dd3914a04ac5'],1,1,2,552752,1,,,,1491
89962e2603c3ec98abfec4c88caada15536bba34,0,Michi Mutsuzaki,2014-05-28 17:57:47+00:00,['d0d947e8c2587e6c18a002b4afbc987210529c9a'],1,3,4,552756,2,,,,1491
7a929407de4704f6ed27958075caddc6cb3f6508,1,Michi Mutsuzaki,2014-06-04 20:07:23+00:00,['89962e2603c3ec98abfec4c88caada15536bba34'],9,389,398,553154,9,0.145299145,0.696581197,0.901709402,1491
bce5c62c62b2fc171deee54c9d6d6cb229c597cc,1,Flavio Paiva Junqueira,2014-06-09 22:19:02+00:00,['7a929407de4704f6ed27958075caddc6cb3f6508'],14,484,498,553652,7,0.368644068,0.855932203,0.974576271,1495
7e262c717d4b99972278ee1e112bdd81dd171c02,1,Flavio Paiva Junqueira,2014-06-25 13:04:27+00:00,['bce5c62c62b2fc171deee54c9d6d6cb229c597cc'],14,41,55,553707,6,0.363636364,0.590909091,1,1495
c470840fb736ca15d99e73891146ba4b3bd28d43,0,Flavio Paiva Junqueira,2014-06-25 13:32:19+00:00,['7e262c717d4b99972278ee1e112bdd81dd171c02'],1,4,5,553712,2,,,,1495
d53be91194395c01d5f78361717e03439b8fb942,0,Patrick D. Hunt,2014-06-25 17:06:05+00:00,['c470840fb736ca15d99e73891146ba4b3bd28d43'],5,529,534,554246,4,0.91005291,1,0.968253968,1495
a457a6a686ddf453ea4d1c3a8d3eb9ba3dac199b,0,Patrick D. Hunt,2014-06-25 17:25:28+00:00,['d53be91194395c01d5f78361717e03439b8fb942'],2,9,11,554257,2,0,1,1,1495
bb6e3815328244f9d11db48435b8d88931a5834e,0,Patrick D. Hunt,2014-06-25 17:35:22+00:00,['a457a6a686ddf453ea4d1c3a8d3eb9ba3dac199b'],5,8,13,554270,4,,,,1495
8cfb9a0efa5c8934eb3c95ca69566c718a37d9ca,1,Camille Fournier,2014-06-27 21:47:49+00:00,['bb6e3815328244f9d11db48435b8d88931a5834e'],27,50,77,554347,4,0.6875,0.9375,1,1495
6abd85938f450587ec1c8973176261fb60a6838b,1,Alexander Shraer,2014-06-30 17:11:54+00:00,['8cfb9a0efa5c8934eb3c95ca69566c718a37d9ca'],1,35,36,554383,4,0,1,1,1495
0bb12aeff587835c71798b7c78f34e40a74b1472,1,Patrick D. Hunt,2014-07-03 03:57:19+00:00,['6abd85938f450587ec1c8973176261fb60a6838b'],7,128,135,554518,21,,,,1495
4934b821e0f2c5061f55661626adf50549046451,0,Patrick D. Hunt,2014-07-03 04:01:51+00:00,['0bb12aeff587835c71798b7c78f34e40a74b1472'],2,11,13,554531,3,0.666666667,0.666666667,0.833333333,1495
02bec21a44c022ec6f065c5ced17864e58fa1ae8,1,Rakesh Radhakrishnan,2014-07-04 02:19:59+00:00,['4934b821e0f2c5061f55661626adf50549046451'],90,512,602,555133,6,0.192028986,1,0.981884058,1497
dc40617ce0ab9161ca8ad22c6c010d198d9abae8,1,Flavio Paiva Junqueira,2014-07-07 21:43:44+00:00,['02bec21a44c022ec6f065c5ced17864e58fa1ae8'],340,753,1093,556226,17,0.084210526,0.852631579,0.821052632,1500
5a6535bf410ed223aac075241045ccd807b17b81,1,Michi Mutsuzaki,2014-07-08 03:25:56+00:00,['dc40617ce0ab9161ca8ad22c6c010d198d9abae8'],206,283,489,556715,13,0.474576271,0.881355932,0.101694915,1500
194be4b88e22c017e5649204afa5296128bfbcb5,1,Rakesh Radhakrishnan,2014-07-08 18:18:31+00:00,['5a6535bf410ed223aac075241045ccd807b17b81'],4,20,24,556739,4,0.285714286,1,0.714285714,1500
bae89355aac6f833ceda2d25b6a787c32bbfe143,0,Flavio Paiva Junqueira,2014-07-11 15:51:37+00:00,['194be4b88e22c017e5649204afa5296128bfbcb5'],0,515,515,557254,6,,,,1505
524895a2651bc7f2d2d9fe458361c33eaf339573,1,Flavio Paiva Junqueira,2014-07-14 17:45:38+00:00,['bae89355aac6f833ceda2d25b6a787c32bbfe143'],9,35,44,557298,2,0.777777778,1,1,1505
fc71a77591007be0053a6314eca3ebc22602dc3f,0,Camille Fournier,2014-07-15 21:54:32+00:00,['524895a2651bc7f2d2d9fe458361c33eaf339573'],37,195,232,557530,3,0.558823529,0.882352941,1,1506
ff2112bdce8ed865bfe707c27cb2581f8b48802f,0,Flavio Paiva Junqueira,2014-07-16 15:54:29+00:00,['fc71a77591007be0053a6314eca3ebc22602dc3f'],511,0,511,558041,5,,,,1506
d94dcda0dfd2365bae8e72f06d79b467435e6345,1,Flavio Paiva Junqueira,2014-07-16 16:00:11+00:00,['ff2112bdce8ed865bfe707c27cb2581f8b48802f'],0,515,515,558556,7,,,,1511
c7c937566ab5c16ef2ef4f1f7b841c334148952c,0,Flavio Paiva Junqueira,2014-07-17 09:40:18+00:00,['d94dcda0dfd2365bae8e72f06d79b467435e6345'],508,508,1016,559572,5,,,,1511
9a97169a433b6eff5c58ff563bbb783c17248fb5,1,Michi Mutsuzaki,2014-07-17 20:56:43+00:00,['c7c937566ab5c16ef2ef4f1f7b841c334148952c'],63,244,307,559879,5,0.08,0.144,1,1511
0dff24161455a8ca1ee7c6bcd91798b8d1bcff68,1,Patrick D. Hunt,2014-07-18 00:19:01+00:00,['9a97169a433b6eff5c58ff563bbb783c17248fb5'],266,3033,3299,563178,66,0.803607214,0.913827655,0.94488978,1532
36c82e116c14a63152e7ffaa229d31f55db887e2,0,Patrick D. Hunt,2014-07-18 17:04:25+00:00,['0dff24161455a8ca1ee7c6bcd91798b8d1bcff68'],2,7,9,563187,2,1,1,1,1532
25ea38a87b73edfe934886a51b694fe9493a2be2,0,Patrick D. Hunt,2014-07-18 17:28:31+00:00,['36c82e116c14a63152e7ffaa229d31f55db887e2'],2,7,9,563196,2,,,,1532
bcf09c846cc68c85479659cb1b7c1a076af068cb,1,Rakesh Radhakrishnan,2014-07-18 17:46:51+00:00,['25ea38a87b73edfe934886a51b694fe9493a2be2'],30,247,277,563473,7,0.838461538,0.961538462,1,1533
0214cfcdde243e0adf2e81c94bb3d48e25308f2b,1,Flavio Paiva Junqueira,2014-07-18 18:48:56+00:00,['bcf09c846cc68c85479659cb1b7c1a076af068cb'],191,423,614,564087,5,0.151515152,0.436363636,0.987878788,1533
1e4be0b02caa30026499b192c08972ad28b41b52,0,Patrick D. Hunt,2014-07-19 04:39:05+00:00,['0214cfcdde243e0adf2e81c94bb3d48e25308f2b'],6,62,68,564155,6,,,,1533
5d3675d4bc5867f90a96986337ce570e171508d7,0,Patrick D. Hunt,2014-07-20 02:50:20+00:00,['1e4be0b02caa30026499b192c08972ad28b41b52'],34,40,74,564229,6,,,,1533
83a012880184b88834a45ad28d5f659c426e69f4,0,Patrick D. Hunt,2014-07-21 17:58:36+00:00,['5d3675d4bc5867f90a96986337ce570e171508d7'],11,7,18,564247,2,1,0,0,1533
50619824472f6782e987a72bce3ea6732a1b57d3,0,Patrick D. Hunt,2014-07-21 18:01:25+00:00,['83a012880184b88834a45ad28d5f659c426e69f4'],0,8,8,564255,2,,,,1533
13e628085acadaa4ee32fbab094e94880fed04b0,0,Patrick D. Hunt,2014-07-22 04:45:41+00:00,['50619824472f6782e987a72bce3ea6732a1b57d3'],1,4,5,564260,2,,,,1533
43deb9b8a8efb0befd4e17cd5ab3e907a700d5c8,0,Patrick D. Hunt,2014-07-22 04:51:17+00:00,['13e628085acadaa4ee32fbab094e94880fed04b0'],2,21,23,564283,6,0,0.1875,0.625,1533
a6b0e9efbfacb954cf03a7e6ea55920a3e1ab2e2,0,Patrick D. Hunt,2014-07-23 16:35:52+00:00,['43deb9b8a8efb0befd4e17cd5ab3e907a700d5c8'],7,3,10,564293,2,1,0,0,1533
892e10f6a45cca0464dae4089265511b7d0b9a38,0,Patrick D. Hunt,2014-07-23 17:36:19+00:00,['a6b0e9efbfacb954cf03a7e6ea55920a3e1ab2e2'],7,67,74,564367,3,0,0.96969697,1,1533
16e14c8d6b3c10d4697fab51c74cb4a7640f1b4f,1,Patrick D. Hunt,2014-07-23 18:17:17+00:00,['892e10f6a45cca0464dae4089265511b7d0b9a38'],15,53,68,564435,2,0.772727273,1,0.636363636,1533
4fcc59ff15bfd7e456ae342581eff330923edac5,0,Patrick D. Hunt,2014-07-24 22:58:38+00:00,['16e14c8d6b3c10d4697fab51c74cb4a7640f1b4f'],8,14,22,564457,2,,,,1533
33b652ebef8af747cc1fae326a1e58f728e62adc,0,Patrick D. Hunt,2014-07-24 23:16:09+00:00,['4fcc59ff15bfd7e456ae342581eff330923edac5'],1,4,5,564462,2,,,,1533
693f81bd103d14c80c38609bbc6cddb356310b3d,1,Patrick D. Hunt,2014-07-24 23:31:57+00:00,['33b652ebef8af747cc1fae326a1e58f728e62adc'],52,138,190,564652,4,0.117647059,0,0.31372549,1534
877a731524e103ca69900c9d4d63350956947e2a,0,Patrick D. Hunt,2014-07-25 16:23:40+00:00,['693f81bd103d14c80c38609bbc6cddb356310b3d'],1,5,6,564658,2,,,,1534
68bc2d165e8b88f9f352b3b50bbae84bba844657,1,Patrick D. Hunt,2014-07-25 16:57:45+00:00,['877a731524e103ca69900c9d4d63350956947e2a'],27,58,85,564743,5,1,1,1,1534
883cd4d446224bccd227acbad8f59f97405fef9e,1,Rakesh Radhakrishnan,2014-07-26 02:11:37+00:00,['68bc2d165e8b88f9f352b3b50bbae84bba844657'],213,198,411,565154,9,1,0,1,1535
bad9ede36559615bb7eafe8e4d333f2c7c353faa,1,Alexander Shraer,2014-08-01 05:38:05+00:00,['883cd4d446224bccd227acbad8f59f97405fef9e'],183,326,509,565663,4,0.111111111,0.288888889,0.8,1535
53060de087f46001b4fe28b53eab95f081d50484,0,Patrick D. Hunt,2014-08-01 21:42:12+00:00,['bad9ede36559615bb7eafe8e4d333f2c7c353faa'],7,1,8,565671,1,,,,1535
6473f832a4e1a6b91edfac9aafadd165bc44a7a4,0,Patrick D. Hunt,2014-08-01 21:45:38+00:00,['53060de087f46001b4fe28b53eab95f081d50484'],3,12,15,565686,4,,,,1535
d25cfdf63fb4c7747c65d1f8298b4060b9776ae6,1,Alexander Shraer,2014-08-14 06:08:48+00:00,['6473f832a4e1a6b91edfac9aafadd165bc44a7a4'],191,609,800,566486,9,0.220149254,0.421641791,0.951492537,1536
135a315933c4899fe0f0d6fe5d89c2fc1f881e4a,1,Alexander Shraer,2014-08-14 07:32:06+00:00,['d25cfdf63fb4c7747c65d1f8298b4060b9776ae6'],9,27,36,566522,4,0,0.066666667,1,1536
8df127063cc890e276999f3335c150ec83ebacf1,0,Alexander Shraer,2014-08-14 12:33:18+00:00,['135a315933c4899fe0f0d6fe5d89c2fc1f881e4a'],2,2,4,566526,1,,,,1536
0b585528c8d8c36715b3489900e77c9198301102,1,Alexander Shraer,2014-08-19 20:50:41+00:00,['8df127063cc890e276999f3335c150ec83ebacf1'],94,190,284,566810,5,1,1,0.807692308,1536
3c4a30ee13ac127ca97bbe375bbc555125b3ab3e,0,Michi Mutsuzaki,2014-08-20 04:07:16+00:00,['0b585528c8d8c36715b3489900e77c9198301102'],46,42,88,566898,2,0,0,1,1536
1c9c0b13b78644bff61d397fea44a652d433bc07,0,Alexander Shraer,2014-08-20 17:18:39+00:00,['3c4a30ee13ac127ca97bbe375bbc555125b3ab3e'],2,4,6,566904,2,,,,1536
55d178451ac9d58f31f4910dc08f6cda22aaae68,1,Michi Mutsuzaki,2014-08-24 05:42:45+00:00,['1c9c0b13b78644bff61d397fea44a652d433bc07'],44,289,333,567237,5,0.04,0.632,1,1537
f919cc6b8dee66c16aecf2b3d15d4f91db88296e,0,Alexander Shraer,2014-08-29 14:23:53+00:00,['55d178451ac9d58f31f4910dc08f6cda22aaae68'],2,825,827,568064,45,,,,1538
55d9130276ecf172490259c662c96dc0d65f91bc,0,Alexander Shraer,2014-09-10 07:00:31+00:00,['f919cc6b8dee66c16aecf2b3d15d4f91db88296e'],0,12,12,568076,2,0,0.428571429,1,1538
7af77531b0dd0e641e10bac1b25482df6b335b89,1,Michi Mutsuzaki,2014-09-17 05:34:28+00:00,['55d9130276ecf172490259c662c96dc0d65f91bc'],1,9,10,568086,2,0,0,0,1538
375d298996e01ffabedaecb3dd62eb2b35070e1b,0,Flavio Paiva Junqueira,2014-09-18 15:47:50+00:00,['7af77531b0dd0e641e10bac1b25482df6b335b89'],10,12,22,568108,2,,,,1538
ac76ee731ac65e06e78219b25aed0d8abe15a276,0,Rakesh Radhakrishnan,2014-09-27 06:20:31+00:00,['375d298996e01ffabedaecb3dd62eb2b35070e1b'],1,4,5,568113,2,0,1,1,1538
3a3014ad265095bea004bcccea0f28dd960d2234,0,Rakesh Radhakrishnan,2014-09-28 17:15:05+00:00,['ac76ee731ac65e06e78219b25aed0d8abe15a276'],2,75,77,568190,4,0.559322034,1,1,1538
b8ad636c14e1e89d3bf279174de58da9d61a315f,1,Michi Mutsuzaki,2014-09-29 06:20:00+00:00,['3a3014ad265095bea004bcccea0f28dd960d2234'],0,9,9,568199,2,,,,1538
9800f2f5ae15bca521d007901a30fff70bfd92a1,0,Rakesh Radhakrishnan,2014-09-29 17:14:44+00:00,['b8ad636c14e1e89d3bf279174de58da9d61a315f'],1,24,25,568224,2,,,,1538
2eca451820cbf158cfff3a49214b9a108c69f925,0,Rakesh Radhakrishnan,2014-10-08 08:16:28+00:00,['9800f2f5ae15bca521d007901a30fff70bfd92a1'],1,2,3,568227,2,,,,1538
4bb2b80499092d392e5b85dd9ee3184e5ed3c67e,0,Rakesh Radhakrishnan,2014-10-13 03:10:10+00:00,['2eca451820cbf158cfff3a49214b9a108c69f925'],7,7,14,568241,1,,,,1538
ab603c2b1b6899c4451b00bdf418d2ece489f306,1,Rakesh Radhakrishnan,2014-10-13 03:19:27+00:00,['4bb2b80499092d392e5b85dd9ee3184e5ed3c67e'],0,3,3,568244,2,,,,1538
92794f1722d00ae2b5e6a9ed45d5d398d274d3e7,0,Michi Mutsuzaki,2014-10-16 04:44:41+00:00,['ab603c2b1b6899c4451b00bdf418d2ece489f306'],11,14,25,568269,5,,,,1538
a935c31e22d4967c9e97750e9b2f6d3be2fa0f3a,0,Camille Fournier,2014-10-25 02:38:22+00:00,['92794f1722d00ae2b5e6a9ed45d5d398d274d3e7'],7,10,17,568286,2,,,,1538
783382d89c58561a9ac8b3d886b4b564a7b211c9,1,Rakesh Radhakrishnan,2014-10-28 04:35:14+00:00,['a935c31e22d4967c9e97750e9b2f6d3be2fa0f3a'],85,257,342,568628,4,0.684782609,1,1,1538
d2ec24288a823846223e9d97e892dbeb6cbcd851,1,Alexander Shraer,2014-11-07 06:15:49+00:00,['783382d89c58561a9ac8b3d886b4b564a7b211c9'],0,1110,1110,569738,18,,,,1540
798145eea96be097330cc3accca342256540bb8a,0,Michi Mutsuzaki,2014-11-17 06:47:25+00:00,['d2ec24288a823846223e9d97e892dbeb6cbcd851'],1,4,5,569743,2,,,,1540
576cee6a81f83fec5ab203cc89be47e2c7fc2d7f,1,Flavio Paiva Junqueira,2014-11-19 22:36:57+00:00,['798145eea96be097330cc3accca342256540bb8a'],3,7,10,569753,2,0,0,1,1540
6aec8db7185cfc17022d90279f83f01ff237346a,0,Flavio Paiva Junqueira,2014-11-29 15:53:52+00:00,['576cee6a81f83fec5ab203cc89be47e2c7fc2d7f'],6,36,42,569795,8,0,1,1,1540
63080fe0a2a3e884a5cb373a50e1359e726184da,0,Flavio Paiva Junqueira,2014-11-29 16:10:03+00:00,['6aec8db7185cfc17022d90279f83f01ff237346a'],2,2,4,569799,1,,,,1540
7a92708d475f5042fc7eaffaa2af081901f26957,0,Flavio Paiva Junqueira,2014-12-17 21:59:37+00:00,['63080fe0a2a3e884a5cb373a50e1359e726184da'],3,6,9,569808,3,,,,1540
4bfe04276f2219b93904b710a2b003e2f817949f,1,Flavio Paiva Junqueira,2014-12-20 14:29:07+00:00,['7a92708d475f5042fc7eaffaa2af081901f26957'],175,758,933,570741,11,0.510373444,0.68879668,1,1544
a268bf9628b3b96aca0e4cb148500baae52a0edc,0,Flavio Paiva Junqueira,2014-12-20 14:32:57+00:00,['4bfe04276f2219b93904b710a2b003e2f817949f'],2,1,3,570744,1,,,,1544
967437328de3b7b8794c8b9a80e0fdaa41a00570,0,Alexander Shraer,2015-01-25 00:22:12+00:00,['a268bf9628b3b96aca0e4cb148500baae52a0edc'],1,3,4,570748,2,,,,1544
95e96374e3a6d23c9d46ac5fa4c197165ee40901,1,Rakesh Radhakrishnan,2015-01-27 16:27:34+00:00,['967437328de3b7b8794c8b9a80e0fdaa41a00570'],13,15,28,570776,8,,,,1544
a95add82db688000a7dc2ceb15464c368e7702fb,0,Rakesh Radhakrishnan,2015-01-30 02:23:50+00:00,['95e96374e3a6d23c9d46ac5fa4c197165ee40901'],26,23,49,570825,3,0,0,0,1544
ffb584be6c5cf020136208e3d93d880b3f141773,1,Rakesh Radhakrishnan,2015-01-31 07:05:54+00:00,['a95add82db688000a7dc2ceb15464c368e7702fb'],11,22,33,570858,2,0,0.5,0.5,1544
2789d1df02e697ea511867546dc569ff6b405ece,1,Michi Mutsuzaki,2015-02-06 05:17:31+00:00,['ffb584be6c5cf020136208e3d93d880b3f141773'],115,310,425,571283,37,0.981132075,0.962264151,0.981132075,1546
6edc5a35b403072d14b898229fff098fad479f3e,0,Michi Mutsuzaki,2015-02-09 05:36:26+00:00,['2789d1df02e697ea511867546dc569ff6b405ece'],3,10,13,571296,2,0.75,0.75,1,1546
c6bceab5321498d5bc59780f6cc26366b0884bf1,0,Michi Mutsuzaki,2015-02-11 06:59:46+00:00,['6edc5a35b403072d14b898229fff098fad479f3e'],2,5,7,571303,2,,,,1546
e5a705c9efda066c47ae27cedc20f9f27ad9fba2,0,Michi Mutsuzaki,2015-02-22 21:08:05+00:00,['c6bceab5321498d5bc59780f6cc26366b0884bf1'],1,4,5,571308,2,,,,1546
5be6b6751a1ba86982465e64dec594b561b4d04b,0,Michi Mutsuzaki,2015-02-22 22:05:20+00:00,['e5a705c9efda066c47ae27cedc20f9f27ad9fba2'],0,3,3,571311,2,,,,1546
024fe1a0a613ed0c3f3882a53ad46d8cb061dae7,0,Rakesh Radhakrishnan,2015-02-24 17:41:58+00:00,['5be6b6751a1ba86982465e64dec594b561b4d04b'],12,10,22,571333,2,,,,1546
3819022566c1c13ba7ccdfd02fe34c141178dfd0,0,Rakesh Radhakrishnan,2015-03-01 16:45:48+00:00,['024fe1a0a613ed0c3f3882a53ad46d8cb061dae7'],13,25,38,571371,9,,,,1546
640f63f8010f96b9a52c5a872e6af9d6b6a35e8c,1,Michi Mutsuzaki,2015-03-08 22:07:59+00:00,['3819022566c1c13ba7ccdfd02fe34c141178dfd0'],75,223,298,571669,26,0.647058824,1,0.960784314,1548
e08f210b41ab138bbce535d9fa584bca3bbe4f08,0,Rakesh Radhakrishnan,2015-03-09 18:22:02+00:00,['640f63f8010f96b9a52c5a872e6af9d6b6a35e8c'],4,4,8,571677,2,0,0,0,1548
015f6708c95cbd9c956012a73a7874d799deccb9,1,Michi Mutsuzaki,2015-03-14 22:28:06+00:00,['e08f210b41ab138bbce535d9fa584bca3bbe4f08'],10,3,13,571690,2,0.25,0.25,0,1548
125d3b4dac1aad83f6acf059a02d7e56904ac021,1,Michi Mutsuzaki,2015-03-14 22:47:06+00:00,['015f6708c95cbd9c956012a73a7874d799deccb9'],1,3,4,571694,2,,,,1548
11187e13da0430cdc90d8aed63a6f270d7612e2d,0,Camille Fournier,2015-03-15 00:14:39+00:00,['125d3b4dac1aad83f6acf059a02d7e56904ac021'],0,3,3,571697,2,,,,1548
22ccb2e0fe3f93a7b904c7d3d24f514fe9e7562b,0,Michi Mutsuzaki,2015-03-15 07:54:59+00:00,['11187e13da0430cdc90d8aed63a6f270d7612e2d'],7,121,128,571825,3,0.5,0.352941176,0.852941176,1548
0ad9f41c52eb844d4596b6deee855bcbb4101baa,0,Rakesh Radhakrishnan,2015-03-16 05:24:07+00:00,['22ccb2e0fe3f93a7b904c7d3d24f514fe9e7562b'],1,3,4,571829,2,,,,1548
2ba2ae309e6d11f224bab84e68e0d23f963b3aaa,1,Rakesh Radhakrishnan,2015-03-16 08:09:04+00:00,['0ad9f41c52eb844d4596b6deee855bcbb4101baa'],17,241,258,572087,3,1,1,0.837209302,1549
af814bd812c1bad13f413004895de5ea1c781f78,1,Rakesh Radhakrishnan,2015-03-17 17:06:07+00:00,['2ba2ae309e6d11f224bab84e68e0d23f963b3aaa'],124,834,958,573045,28,0.391727494,0.153284672,0.849148418,1555
75928cb8af4dfda71d99e35e232a2075f3c7b923,1,Michi Mutsuzaki,2015-03-25 07:38:44+00:00,['af814bd812c1bad13f413004895de5ea1c781f78'],8,58,66,573111,3,1,1,1,1556
f615439cce121e7eb24f6a0f53d9c37c9dcd2d9f,0,Michi Mutsuzaki,2015-03-25 07:48:54+00:00,['75928cb8af4dfda71d99e35e232a2075f3c7b923'],3,6,9,573120,2,,,,1556
809ebb2a300005265617ac7ce92694f688342ff4,1,Rakesh Radhakrishnan,2015-03-28 19:08:52+00:00,['f615439cce121e7eb24f6a0f53d9c37c9dcd2d9f'],39,975,1014,574134,17,0.642857143,0.885714286,0.853061224,1560
9467bc94758b8ead60623efc7e0fad3274c88f6d,0,Raúl Gutiérrez Segalés,2015-04-06 23:54:51+00:00,['809ebb2a300005265617ac7ce92694f688342ff4'],2,5,7,574141,2,,,,1560
090e465482329115d56c98614b6d344255588fa7,0,Hongchao Deng,2015-04-07 17:23:00+00:00,['9467bc94758b8ead60623efc7e0fad3274c88f6d'],1,4,5,574146,2,,,,1560
b52252aeb460b65a7e53f31af241160c6b6c5b56,1,Rakesh Radhakrishnan,2015-04-09 18:16:37+00:00,['090e465482329115d56c98614b6d344255588fa7'],4,72,76,574222,3,0,0.511111111,1,1560
62ec21999b721516d86afbcda0ae49509ec82fd0,0,Hongchao Deng,2015-04-10 20:22:34+00:00,['b52252aeb460b65a7e53f31af241160c6b6c5b56'],4,9,13,574235,2,0.5,1,1,1560
9e82f58502ee94d28e2e65c00ff3cd3dbe8291ab,1,Michi Mutsuzaki,2015-04-11 21:40:22+00:00,['62ec21999b721516d86afbcda0ae49509ec82fd0'],11,82,93,574328,7,0.346153846,1,1,1560
a3b80499f9d5ccb883471e318715a29a016a35b5,0,Camille Fournier,2015-04-27 18:36:46+00:00,['9e82f58502ee94d28e2e65c00ff3cd3dbe8291ab'],1,10,11,574339,2,,,,1560
b92709ede9bce52f7b1061fe660ed6322d876f26,0,Raúl Gutiérrez Segalés,2015-05-03 17:55:28+00:00,['a3b80499f9d5ccb883471e318715a29a016a35b5'],4,21,25,574364,2,0.125,0,1,1560
ac95f335bfd515ebeaf0ac72a38990bb822d44ad,0,Raúl Gutiérrez Segalés,2015-05-04 06:31:43+00:00,['b92709ede9bce52f7b1061fe660ed6322d876f26'],2,16,18,574382,3,,,,1560
c88423a925b69e7446b75bc127e2fd2dac30eee7,0,Rakesh Radhakrishnan,2015-05-05 02:38:36+00:00,['ac95f335bfd515ebeaf0ac72a38990bb822d44ad'],29,92,121,574503,2,0.342857143,1,0.657142857,1560
506a4964151a1ebff055647f9cbed7c9eaf77967,0,Hongchao Deng,2015-05-05 17:16:50+00:00,['c88423a925b69e7446b75bc127e2fd2dac30eee7'],1,4,5,574508,2,,,,1560
b9721711ce4fee34fe5aab37bf357b5c27a96fd2,0,Hongchao Deng,2015-05-05 17:29:23+00:00,['506a4964151a1ebff055647f9cbed7c9eaf77967'],8,57,65,574573,3,,,,1560
81840d5f9bb99bc5f511f41846c352fb98abfd20,0,Hongchao Deng,2015-05-06 15:45:30+00:00,['b9721711ce4fee34fe5aab37bf357b5c27a96fd2'],1,1,2,574575,1,,,,1560
bd2a1bc422f1a555bb8a4af23cf07bf67ae0459b,1,Michi Mutsuzaki,2015-05-09 22:27:47+00:00,['81840d5f9bb99bc5f511f41846c352fb98abfd20'],208,36,244,574819,15,0.657894737,0,0.026315789,1560
16c91abe606aa84fa84747313b7fa3a5485ce3ce,0,Hongchao Deng,2015-05-10 21:29:15+00:00,['bd2a1bc422f1a555bb8a4af23cf07bf67ae0459b'],4,7,11,574830,4,0,1,1,1560
692bfe67ad63fb7cf2e1b901f06f1787c74e5f8d,1,Michi Mutsuzaki,2015-05-14 05:10:01+00:00,['16c91abe606aa84fa84747313b7fa3a5485ce3ce'],33,191,224,575054,3,0.152173913,0.717391304,1,1560
a358280fb2b3cc7852cded3fe67769765a519beb,1,Hongchao Deng,2015-05-14 16:40:52+00:00,['692bfe67ad63fb7cf2e1b901f06f1787c74e5f8d'],57,341,398,575452,15,0.209302326,0.457364341,0.945736434,1561
4dae58c3ced30b570c3d9da57240178d9a598f5e,0,Raúl Gutiérrez Segalés,2015-05-14 19:53:44+00:00,['a358280fb2b3cc7852cded3fe67769765a519beb'],5,5,10,575462,2,1,1,0,1561
fb13c80bd3400f6b2c7a21a952e49c3a196c4d2f,0,Rakesh Radhakrishnan,2015-05-15 04:05:28+00:00,['4dae58c3ced30b570c3d9da57240178d9a598f5e'],2,7,9,575471,2,0,0,1,1561
663236c9266850cc62fbb4fb9036c9dda65fbdc1,1,Raúl Gutiérrez Segalés,2015-05-18 07:35:50+00:00,['fb13c80bd3400f6b2c7a21a952e49c3a196c4d2f'],11,44,55,575526,7,,,,1561
d2a5192d9ee2e52e50f3c943790ce4b09eaab820,0,Rakesh Radhakrishnan,2015-05-20 07:29:50+00:00,['663236c9266850cc62fbb4fb9036c9dda65fbdc1'],3,9,12,575538,2,,,,1561
111d60b6253e3e2911a6ff525f0af792e7793ce5,0,Rakesh Radhakrishnan,2015-05-22 05:24:39+00:00,['d2a5192d9ee2e52e50f3c943790ce4b09eaab820'],39,90,129,575667,3,,,,1561
3a7a240ef7381edf15925045e9f94408177e51cd,0,Hongchao Deng,2015-05-29 17:45:53+00:00,['111d60b6253e3e2911a6ff525f0af792e7793ce5'],107,14,121,575788,6,1,1,0.754098361,1561
fe63c1c4fdbfce201e193cd8723488d9a40dc498,0,Raúl Gutiérrez Segalés,2015-05-29 19:48:23+00:00,['3a7a240ef7381edf15925045e9f94408177e51cd'],1,3,4,575792,2,,,,1561
63884670328f09a3814db54cb4644d683822e4d4,1,Hongchao Deng,2015-05-29 21:46:49+00:00,['fe63c1c4fdbfce201e193cd8723488d9a40dc498'],2,10,12,575804,2,,,,1561
daf766aa74c0e2f584b1a30f33f946e4ac282e3a,0,Hongchao Deng,2015-05-30 16:39:30+00:00,['63884670328f09a3814db54cb4644d683822e4d4'],1,1,2,575806,1,,,,1561
891b12d004842e6ea09509765eaa2a18eca727c4,0,Michi Mutsuzaki,2015-05-31 09:21:07+00:00,['daf766aa74c0e2f584b1a30f33f946e4ac282e3a'],3,5,8,575814,3,,,,1561
b0141aa40e44cc747d7899a2a038a3bbe19e67a7,0,Michi Mutsuzaki,2015-06-01 06:45:11+00:00,['891b12d004842e6ea09509765eaa2a18eca727c4'],3,16,19,575833,2,0,0,1,1561
7f52bebb90ff2d61a2428013771ce0df09890876,0,Raúl Gutiérrez Segalés,2015-06-02 05:21:26+00:00,['b0141aa40e44cc747d7899a2a038a3bbe19e67a7'],14,17,31,575864,9,,,,1561
ea500b8911223fb36555b12c391adc9a20c9e28d,0,Raúl Gutiérrez Segalés,2015-06-02 19:17:09+00:00,['7f52bebb90ff2d61a2428013771ce0df09890876'],0,18,18,575882,3,,,,1561
9f89dd30187a48e39556b6305246d835b54e00ae,0,Raúl Gutiérrez Segalés,2015-06-04 16:26:06+00:00,['ea500b8911223fb36555b12c391adc9a20c9e28d'],1,9,10,575892,2,1,1,1,1561
feb90fabcab3a14b075eb56f2618e6483acfebfb,0,Raúl Gutiérrez Segalés,2015-06-04 17:37:26+00:00,['9f89dd30187a48e39556b6305246d835b54e00ae'],2,10,12,575904,2,,,,1561
78b84f3ae01ca477fb94404c78bf3a098b0fcba4,1,Raúl Gutiérrez Segalés,2015-06-04 17:51:16+00:00,['feb90fabcab3a14b075eb56f2618e6483acfebfb'],110,813,923,576827,26,0.356807512,0.65258216,0.922535211,1563
ee7ff36dcbbd3ea1dac690c7fe15891ac6fc87e2,0,Raúl Gutiérrez Segalés,2015-06-05 18:38:41+00:00,['78b84f3ae01ca477fb94404c78bf3a098b0fcba4'],2,5,7,576834,2,,,,1563
5847d0d15ffc2f13d513b189d73125e98700e850,0,Raúl Gutiérrez Segalés,2015-06-05 18:51:44+00:00,['ee7ff36dcbbd3ea1dac690c7fe15891ac6fc87e2'],0,27,27,576861,2,0,0,1,1563
b90a32fa1518c4f6c46d5c7d25cda4937a4f496f,0,Raúl Gutiérrez Segalés,2015-06-05 19:15:36+00:00,['5847d0d15ffc2f13d513b189d73125e98700e850'],4,8,12,576873,4,0,0,1,1563
ec3ee9469aeff60d65de38fa91bf4e6ca9f6a28a,0,Raúl Gutiérrez Segalés,2015-06-05 19:25:41+00:00,['b90a32fa1518c4f6c46d5c7d25cda4937a4f496f'],0,3,3,576876,1,0,0,1,1563
bedcfed45550b59d088e556ce463e1fdcba3242b,0,Raúl Gutiérrez Segalés,2015-06-05 19:28:23+00:00,['ec3ee9469aeff60d65de38fa91bf4e6ca9f6a28a'],0,3,3,576879,1,,,,1563
71dd96a232cb590e90601fde4bfafcd4eef1f82a,1,Raúl Gutiérrez Segalés,2015-06-06 01:48:52+00:00,['bedcfed45550b59d088e556ce463e1fdcba3242b'],5,70,75,576954,3,0,1,1,1563
9bee4674c015a71785daeb7a6da93676a3450699,0,Raúl Gutiérrez Segalés,2015-06-11 18:09:19+00:00,['71dd96a232cb590e90601fde4bfafcd4eef1f82a'],21,42,63,577017,3,1,1,1,1563
b58a0621fb0f3495d7c010308d2822f245a56a00,0,Raúl Gutiérrez Segalés,2015-06-12 21:02:55+00:00,['9bee4674c015a71785daeb7a6da93676a3450699'],3,5,8,577025,2,1,1,0,1563
2d94a794d33a27567b37b772c08316277ee4e547,0,Raúl Gutiérrez Segalés,2015-06-13 00:42:49+00:00,['b58a0621fb0f3495d7c010308d2822f245a56a00'],9,131,140,577165,3,0,0,1,1563
6a2f5e3e76f85e7aeba72f94397315bec96ea4f1,1,Raúl Gutiérrez Segalés,2015-06-15 23:05:25+00:00,['2d94a794d33a27567b37b772c08316277ee4e547'],8,16,24,577189,2,0,0,1,1563
61df2ce2aeda8df79fa3f33c07cac23b9f6b1ca3,0,Raúl Gutiérrez Segalés,2015-06-18 19:23:18+00:00,['6a2f5e3e76f85e7aeba72f94397315bec96ea4f1'],6,26,32,577221,4,,,,1563
b9c65eb6be6959639eb691642d60a88960888b49,0,Raúl Gutiérrez Segalés,2015-06-22 00:18:57+00:00,['61df2ce2aeda8df79fa3f33c07cac23b9f6b1ca3'],1,25,26,577247,2,0,0,1,1563
c520e1e826d88955db7637a33cd4f20c20c0bd7a,0,Raúl Gutiérrez Segalés,2015-06-27 00:03:30+00:00,['b9c65eb6be6959639eb691642d60a88960888b49'],24,77,101,577348,3,0.277777778,0.277777778,1,1563
352022265deb93110b7370e0fc2df6809985a60a,1,Raúl Gutiérrez Segalés,2015-06-28 19:09:49+00:00,['c520e1e826d88955db7637a33cd4f20c20c0bd7a'],977,977,1954,579302,21,0.486013986,0.311188811,0,1579
a61b4e1b528cb4c70627e9f9295b34bb05a79303,0,Raúl Gutiérrez Segalés,2015-06-30 18:50:11+00:00,['352022265deb93110b7370e0fc2df6809985a60a'],13,40,53,579355,3,1,1,0,1579
9a9d587861606884cca5b4a532078f925b50e40c,0,Rakesh Radhakrishnan,2015-07-05 04:05:33+00:00,['a61b4e1b528cb4c70627e9f9295b34bb05a79303'],7,50,57,579412,3,0.631578947,0,0.421052632,1579
3c9c66ac68e430a435b6bd02a9ab5cde03f31e11,1,Raúl Gutiérrez Segalés,2015-07-07 05:11:49+00:00,['9a9d587861606884cca5b4a532078f925b50e40c'],168,276,444,579856,59,1,1,1,1580
359fa97e5888e4e209128f0d26edaa7125bc20e6,1,Raúl Gutiérrez Segalés,2015-07-10 06:19:22+00:00,['3c9c66ac68e430a435b6bd02a9ab5cde03f31e11'],6,153,159,580015,12,0.826086957,0.971014493,0.971014493,1581
f4e25ac70d808bd9a3b38a3a54122edf8a7be0ea,1,Michi Mutsuzaki,2015-07-28 04:35:27+00:00,['359fa97e5888e4e209128f0d26edaa7125bc20e6'],6,384,390,580405,7,,,,1586
d95b521be0d275fcf3495ae31ebff94a469bb26d,0,Raúl Gutiérrez Segalés,2015-08-05 20:16:29+00:00,['f4e25ac70d808bd9a3b38a3a54122edf8a7be0ea'],1,4,5,580410,2,,,,1586
1c715735d4386ee9b01f2fddb5fe04e78135a452,0,Raúl Gutiérrez Segalés,2015-08-23 17:12:03+00:00,['d95b521be0d275fcf3495ae31ebff94a469bb26d'],3,17,20,580430,3,0.4,1,1,1586
2055affe94924fe5f16aaabf08c0d32dcd1a3e25,1,Raúl Gutiérrez Segalés,2015-08-25 05:11:15+00:00,['1c715735d4386ee9b01f2fddb5fe04e78135a452'],10,30,40,580470,2,,,,1586
2c163cb3cd0ab040c03b93bab2b342eb282562ff,0,Rakesh Radhakrishnan,2015-08-27 04:13:49+00:00,['2055affe94924fe5f16aaabf08c0d32dcd1a3e25'],11,15,26,580496,2,,,,1586
cfc9f24934f920ad45b8c522f0bd05220e5aaf74,1,Rakesh Radhakrishnan,2015-09-06 18:02:42+00:00,['2c163cb3cd0ab040c03b93bab2b342eb282562ff'],3,82,85,580581,3,1,1,1,1587
fee4876cd568feac318cc44518aa1fd9a2cc9c31,0,Raúl Gutiérrez Segalés,2015-09-10 04:07:41+00:00,['cfc9f24934f920ad45b8c522f0bd05220e5aaf74'],1,13,14,580595,2,1,1,1,1587
239556e2344f75626b5c6c3f656508e797093011,1,Raúl Gutiérrez Segalés,2015-09-10 04:35:52+00:00,['fee4876cd568feac318cc44518aa1fd9a2cc9c31'],1,53,54,580649,3,1,1,1,1588
c506b39fdea26b56e3735af7bd50f834890024e3,0,Chris Nauroth,2015-09-11 05:56:55+00:00,['239556e2344f75626b5c6c3f656508e797093011'],1,4,5,580654,2,,,,1588
1ea6879ba784aacc1cd0b4a91967f64f51d7aae9,0,Rakesh Radhakrishnan,2015-09-25 06:33:36+00:00,['c506b39fdea26b56e3735af7bd50f834890024e3'],1,4,5,580659,2,,,,1588
7cd37c2ef9ee44256cc9ef0f33a2f46ec768c802,0,Rakesh Radhakrishnan,2015-09-25 06:49:38+00:00,['1ea6879ba784aacc1cd0b4a91967f64f51d7aae9'],0,9,9,580668,2,,,,1588
fe2b9019c535c9e4c8cb6a5d73ec6afcebb445e6,0,Raúl Gutiérrez Segalés,2015-09-26 20:22:25+00:00,['7cd37c2ef9ee44256cc9ef0f33a2f46ec768c802'],44,67,111,580779,3,0,1,1,1588
b2f66fae04438602ee9b0092ac0c6657177e10e1,0,Rakesh Radhakrishnan,2015-09-29 01:56:44+00:00,['fe2b9019c535c9e4c8cb6a5d73ec6afcebb445e6'],2,81,83,580862,3,0,0,0.981132075,1588
090481b8f005ce108f0b5079f08197fb49d22a18,0,Chris Nauroth,2015-10-03 21:02:32+00:00,['b2f66fae04438602ee9b0092ac0c6657177e10e1'],1,4,5,580867,2,,,,1588
86c1671a6e97186bdb78e1b705346dcc8766aeb4,0,Chris Nauroth,2015-10-03 21:07:25+00:00,['090481b8f005ce108f0b5079f08197fb49d22a18'],2,7,9,580876,2,,,,1588
08cc9187d9eb327b2a71bc9a8c62636815dfe9e5,1,Chris Nauroth,2015-10-18 17:00:41+00:00,['86c1671a6e97186bdb78e1b705346dcc8766aeb4'],10,70,80,580956,3,0.595238095,1,1,1588
500dea711a6bc214d35183c8ae6b92e70c006ee4,0,Flavio Paiva Junqueira,2015-10-28 21:54:09+00:00,['08cc9187d9eb327b2a71bc9a8c62636815dfe9e5'],2,5,7,580963,3,,,,1588
495f7f99d46a4baf4896adac8afe5b9eba158db1,0,Michi Mutsuzaki,2015-10-31 22:18:39+00:00,['500dea711a6bc214d35183c8ae6b92e70c006ee4'],0,7,7,580970,2,1,1,1,1588
e65986980ee173e19b36cd8f5a3dd4dae786ca30,1,Raúl Gutiérrez Segalés,2015-11-03 07:11:27+00:00,['495f7f99d46a4baf4896adac8afe5b9eba158db1'],60,88,148,581118,6,0,1,1,1588
ee0daa7a8223dad09071893ef2e2c3a1aeb8eec9,1,Raúl Gutiérrez Segalés,2015-11-08 21:21:38+00:00,['e65986980ee173e19b36cd8f5a3dd4dae786ca30'],16,164,180,581298,3,0.168539326,1,1,1588
80803034aabb68229730b9d7429525bd460c3183,0,Raúl Gutiérrez Segalés,2015-11-08 21:36:17+00:00,['ee0daa7a8223dad09071893ef2e2c3a1aeb8eec9'],3,53,56,581354,4,0.964285714,0.964285714,1,1588
df7e637a4d073c75270c32b107b7c1ceab29d148,1,Raúl Gutiérrez Segalés,2015-11-08 21:54:06+00:00,['80803034aabb68229730b9d7429525bd460c3183'],9,79,88,581442,4,0.653061224,1,1,1588
0285b134ee5c1cad56e24f6a66736cdfab8cb5d0,0,Raúl Gutiérrez Segalés,2015-11-08 23:05:49+00:00,['df7e637a4d073c75270c32b107b7c1ceab29d148'],8,17,25,581467,2,0,0,0.6,1588
08f0b13e00a02d835f959670b34657d0cb63851c,1,Raúl Gutiérrez Segalés,2015-11-08 23:23:05+00:00,['0285b134ee5c1cad56e24f6a66736cdfab8cb5d0'],3,50,53,581520,3,,,,1588
81889eaf4a7aa2d638f3651c7da1fe07e222d144,0,Raúl Gutiérrez Segalés,2015-11-11 07:58:07+00:00,['08f0b13e00a02d835f959670b34657d0cb63851c'],0,110,110,581630,2,,,,1588
9f16d988649e68594180e94143a5178ec2c8f2bb,0,Raúl Gutiérrez Segalés,2015-11-21 20:01:15+00:00,['81889eaf4a7aa2d638f3651c7da1fe07e222d144'],1,7,8,581638,2,0,0,0,1588
31b61db08a87b5939ea3fce5328d7ce69df536e6,1,Raúl Gutiérrez Segalés,2015-11-21 21:18:10+00:00,['9f16d988649e68594180e94143a5178ec2c8f2bb'],117,233,350,581988,15,0.394736842,0.894736842,0.973684211,1588
0dc51fc123a8a67380890d4dadc0a2f15d50381b,0,Raúl Gutiérrez Segalés,2015-11-21 23:33:59+00:00,['31b61db08a87b5939ea3fce5328d7ce69df536e6'],7,12,19,582007,7,,,,1588
8d52816fbd5e7457eef97b65771b6242cdc0fbc1,1,Raúl Gutiérrez Segalés,2015-12-05 21:32:41+00:00,['0dc51fc123a8a67380890d4dadc0a2f15d50381b'],1,14,15,582022,3,1,1,1,1588
c502e93d4f829dfe8060ef50cf369c23ec7cc78c,1,Raúl Gutiérrez Segalés,2015-12-05 21:43:26+00:00,['8d52816fbd5e7457eef97b65771b6242cdc0fbc1'],2,7,9,582031,2,0,0,1,1588
9bb9b1d7016433ce98cd33be904ee1e77d484ffd,0,Raúl Gutiérrez Segalés,2015-12-06 18:58:29+00:00,['c502e93d4f829dfe8060ef50cf369c23ec7cc78c'],1,4,5,582036,2,,,,1588
0437e0047a144a53fd6b61f9b368cf6486e0de01,0,Raúl Gutiérrez Segalés,2015-12-06 19:21:07+00:00,['9bb9b1d7016433ce98cd33be904ee1e77d484ffd'],2,19,21,582057,2,0,1,1,1588
28573d112600863f6918a963cb3583a09d69aa1e,0,Raúl Gutiérrez Segalés,2015-12-06 20:30:07+00:00,['0437e0047a144a53fd6b61f9b368cf6486e0de01'],61,81,142,582199,6,0,0,0,1589
0a3f9d123af076341022ae81697257c5ff8a9428,0,Raúl Gutiérrez Segalés,2015-12-06 20:37:20+00:00,['28573d112600863f6918a963cb3583a09d69aa1e'],8,4,12,582211,2,0,0,0,1589
5bcdb84bda57b06d0d4a38ce587ab91cd010e9a2,1,Raúl Gutiérrez Segalés,2015-12-07 04:59:37+00:00,['0a3f9d123af076341022ae81697257c5ff8a9428'],7,112,119,582330,4,0.333333333,1,0.666666667,1590
8d11ef90f71733a59b28828ee84e9955f297d1e2,1,Raúl Gutiérrez Segalés,2015-12-07 05:06:45+00:00,['5bcdb84bda57b06d0d4a38ce587ab91cd010e9a2'],2,91,93,582423,3,0.129032258,1,1,1591
b2a953f15101eceb302992cdfb46ced79fadcf72,0,Raúl Gutiérrez Segalés,2015-12-07 05:26:27+00:00,['8d11ef90f71733a59b28828ee84e9955f297d1e2'],0,132,132,582555,4,0.68627451,1,1,1592
205ea86b2ad3e3bc639db746b96d4798388c225a,1,Raúl Gutiérrez Segalés,2015-12-08 04:52:45+00:00,['b2a953f15101eceb302992cdfb46ced79fadcf72'],0,1,1,582556,1,,,,1592
54480f6ab72cafb68231695a1f41064e24ebf65d,0,Raúl Gutiérrez Segalés,2015-12-09 04:05:19+00:00,['205ea86b2ad3e3bc639db746b96d4798388c225a'],3,7,10,582566,2,0,0,1,1592
354bfdb22d90c14a81fe8f8d092ace80c79cd794,0,Raúl Gutiérrez Segalés,2015-12-10 05:28:07+00:00,['54480f6ab72cafb68231695a1f41064e24ebf65d'],1,4,5,582571,2,,,,1592
fe1ac5d508c90943c34ec5c77aa9594ebf25edd7,1,Chris Nauroth,2015-12-10 20:42:50+00:00,['354bfdb22d90c14a81fe8f8d092ace80c79cd794'],3,6,9,582580,2,,,,1592
a9dd447a5efada9eb83b420847d45567c62e315d,1,Chris Nauroth,2015-12-11 20:14:28+00:00,['fe1ac5d508c90943c34ec5c77aa9594ebf25edd7'],88,127,215,582795,5,1,1,1,1592
750bd2a92efdf178f60394ca736ab12c7401c55e,0,Chris Nauroth,2015-12-15 19:15:30+00:00,['a9dd447a5efada9eb83b420847d45567c62e315d'],33,41,74,582869,4,,,,1592
b286cccd5a56aed88a7d74cffff87a09790ac97d,0,Rakesh Radhakrishnan,2016-01-21 06:07:04+00:00,['750bd2a92efdf178f60394ca736ab12c7401c55e'],2,5,7,582876,4,1,,,1592
94e26732af2c3a2bf51c2e4e5bb4f86fbc9ca0fc,1,Rakesh Radhakrishnan,2016-01-23 05:06:58+00:00,['b286cccd5a56aed88a7d74cffff87a09790ac97d'],5,2,7,582883,4,0,,,1592
576d5c5c4c0c51499e090eafdfdee86f18b4f67a,0,Chris Nauroth,2016-02-05 00:31:51+00:00,['94e26732af2c3a2bf51c2e4e5bb4f86fbc9ca0fc'],3,9,12,582895,3,,,,1592
eb38f5b5db860a35c58dde976dce540d7958fdba,0,Chris Nauroth,2016-02-08 21:32:41+00:00,['576d5c5c4c0c51499e090eafdfdee86f18b4f67a'],16,76,92,582987,2,,,,1592
153a7e64068644a56e69e29ff4a3a277af862bcb,1,Rakesh Radhakrishnan,2016-03-02 06:46:43+00:00,['eb38f5b5db860a35c58dde976dce540d7958fdba'],7,14,21,583008,2,0,0,1,1592
7b4fd668ac2d9049072bcc5ad93d85e5880a738e,0,Patrick D. Hunt,2016-03-02 18:29:08+00:00,['153a7e64068644a56e69e29ff4a3a277af862bcb'],1,1,2,583010,1,,,,1592
2ab0821db4e2f37a4ecfae4a8cc204c22a7b72f4,0,Patrick D. Hunt,2016-03-03 16:12:55+00:00,['7b4fd668ac2d9049072bcc5ad93d85e5880a738e'],1173,16,1189,584199,22,,,,1592
dd5f7bde4deb6e277448bbb488cb00ce672f493d,0,Patrick D. Hunt,2016-03-03 17:26:47+00:00,['2ab0821db4e2f37a4ecfae4a8cc204c22a7b72f4'],2,4,6,584205,1,,,,1592
47577a334d2afbd9d3f01a08cc20fa944c0714c3,0,Patrick D. Hunt,2016-03-03 17:54:45+00:00,['dd5f7bde4deb6e277448bbb488cb00ce672f493d'],1,1,2,584207,1,,,,1592
cba3e52fb0eaa12ee42843aae595d29dbba5c077,1,Patrick D. Hunt,2016-03-03 17:56:52+00:00,['47577a334d2afbd9d3f01a08cc20fa944c0714c3'],2,4,6,584213,1,,,,1592
e51fc32fe30aeb1d8eb4be63bb24e42540c6da41,0,Patrick D. Hunt,2016-03-03 21:16:24+00:00,['cba3e52fb0eaa12ee42843aae595d29dbba5c077'],0,41,41,584254,1,,,,1593
47da0276906c6fc27a482eb7568bcabc9721cdba,0,Chris Nauroth,2016-03-05 00:03:57+00:00,['e51fc32fe30aeb1d8eb4be63bb24e42540c6da41'],1,6,7,584261,2,0,0,1,1593
bdec65ef165361bc7ae1d654dcb35045904f3ef8,0,Patrick D. Hunt,2016-03-10 04:28:23+00:00,['47da0276906c6fc27a482eb7568bcabc9721cdba'],87,286,373,584634,7,0.983333333,1,0.533333333,1596
7870727577f95220a0d16e33da494f6d936bd8f2,0,Patrick D. Hunt,2016-03-11 06:33:27+00:00,['bdec65ef165361bc7ae1d654dcb35045904f3ef8'],1,4,5,584639,2,,,,1596
e214e401d73205953e43346e634701619505e15f,0,Patrick D. Hunt,2016-03-11 06:48:06+00:00,['7870727577f95220a0d16e33da494f6d936bd8f2'],0,15,15,584654,1,,,,1596
c76b4e37fd76cf976ac598ac56fcb0139249f1af,1,Patrick D. Hunt,2016-03-14 06:50:03+00:00,['e214e401d73205953e43346e634701619505e15f'],134,456,590,585244,37,,,,1596
509c25188a64e581d3da7ee2f94b593e1f93fc85,0,Patrick D. Hunt,2016-03-15 16:03:37+00:00,['c76b4e37fd76cf976ac598ac56fcb0139249f1af'],1,4,5,585249,2,,,,1596
f7eb9fcad397722eb678d82d301793490a3a8e61,0,Patrick D. Hunt,2016-03-17 06:13:02+00:00,['509c25188a64e581d3da7ee2f94b593e1f93fc85'],12,15,27,585276,3,1,0,0,1596
d1401da94d5d106d998841cf54b6e42a4508ba68,0,Patrick D. Hunt,2016-03-18 17:22:23+00:00,['f7eb9fcad397722eb678d82d301793490a3a8e61'],1,3,4,585280,2,,,,1596
c1c42eee0bd6e3d99f2a94a8bd6020cfae5f8b85,1,Chris Nauroth,2016-03-19 21:48:11+00:00,['d1401da94d5d106d998841cf54b6e42a4508ba68'],58,20,78,585358,24,,,,1596
2f470b8bb793da9a64158f1356f7098312ce7e57,0,Patrick D. Hunt,2016-03-20 04:23:03+00:00,['c1c42eee0bd6e3d99f2a94a8bd6020cfae5f8b85'],5,112,117,585475,21,,,,1596
7e889d125f4a19f710dc9276402061ba6900e8a4,0,Patrick D. Hunt,2016-03-20 18:31:58+00:00,['2f470b8bb793da9a64158f1356f7098312ce7e57'],3,10,13,585488,20,0,1,1,1596
7e115a62173f47108ae6739113c7af41ab281a1a,1,Chris Nauroth,2016-03-21 20:43:52+00:00,['7e889d125f4a19f710dc9276402061ba6900e8a4'],1250,332,1582,587070,19,,,,1597
a3d24843bcc298fa635cf447d35f901116b06cda,1,Camille Fournier,2016-03-22 23:30:42+00:00,['7e115a62173f47108ae6739113c7af41ab281a1a'],141,550,691,587761,7,0.730769231,0.974358974,0.935897436,1599
6380270281f9bb79b7ccfff6cfedbce22f734ca4,0,Camille Fournier,2016-04-06 18:06:30+00:00,['a3d24843bcc298fa635cf447d35f901116b06cda'],46,17,63,587824,2,0,0.928571429,0,1599
21ae2cf7dfbfd12e8160503c43b5f379fd049d79,0,Flavio Paiva Junqueira,2016-04-24 21:21:34+00:00,['6380270281f9bb79b7ccfff6cfedbce22f734ca4'],0,4,4,587828,2,1,1,1,1599
b7a03643afda3306accd4c58e39daeb31870dc6e,1,Flavio Paiva Junqueira,2016-05-02 16:15:28+00:00,['21ae2cf7dfbfd12e8160503c43b5f379fd049d79'],234,1000,1234,589062,27,0.493449782,0.965065502,0.257641921,1602
62936753faefb229ad64287ef24e87b344e5b3f8,0,Patrick D. Hunt,2016-05-03 18:27:12+00:00,['b7a03643afda3306accd4c58e39daeb31870dc6e'],4,0,4,589066,1,,,,1602
53d23e663fcd6fdf9ba97806c89f87c0c3dae37e,0,Patrick D. Hunt,2016-05-05 20:50:39+00:00,['62936753faefb229ad64287ef24e87b344e5b3f8'],1,4,5,589071,2,,,,1602
9fc632c4f0a340b0a00ec6dff39c7b454c802822,1,Alexander Shraer,2016-05-15 21:31:54+00:00,['53d23e663fcd6fdf9ba97806c89f87c0c3dae37e'],236,621,857,589928,4,0.045454545,0.741258741,0.842657343,1602
4f08284bec4c9f22604ca41ab36102941ecad2ea,0,Flavio Paiva Junqueira,2016-05-23 21:30:27+00:00,['9fc632c4f0a340b0a00ec6dff39c7b454c802822'],14,110,124,590052,3,,,,1602
bba49d85fc715a568bc6ee7bf9caf42ccb7e410b,0,Patrick D. Hunt,2016-05-25 20:44:35+00:00,['4f08284bec4c9f22604ca41ab36102941ecad2ea'],1,5,6,590058,2,1,1,1,1602
3496911f7fb14294483640ab29f4e8c089dd8283,0,Patrick D. Hunt,2016-06-01 22:59:24+00:00,['bba49d85fc715a568bc6ee7bf9caf42ccb7e410b'],3,12,15,590073,5,1,1,1,1602
0c4b4483338d9c71f313f66d3d5bd7912a8ea30a,1,Raúl Gutiérrez Segalés,2016-06-08 15:43:15+00:00,['3496911f7fb14294483640ab29f4e8c089dd8283'],23,22,45,590118,2,1,1,0,1602
5ccea64951f9e6ffa6a6bf4d0f273861948559da,1,Patrick D. Hunt,2016-06-15 17:11:39+00:00,['0c4b4483338d9c71f313f66d3d5bd7912a8ea30a'],17,39,56,590174,2,0.571428571,0.571428571,0.071428571,1602
4f7354c9b4412f955f1ff0a6c7add414df3ffef7,0,Patrick D. Hunt,2016-06-15 20:30:05+00:00,['5ccea64951f9e6ffa6a6bf4d0f273861948559da'],7,17,24,590198,2,0,0,1,1602
aa4a217ca85966ee135adb27804992e97ec18cbc,1,Flavio Paiva Junqueira,2016-06-23 17:42:11+00:00,['4f7354c9b4412f955f1ff0a6c7add414df3ffef7'],2,65,67,590265,5,0.948717949,0.923076923,1,1602
2cea41e38e7597a1d5901381f2fc72fce8625b7e,1,Chris Nauroth,2016-06-23 21:25:34+00:00,['aa4a217ca85966ee135adb27804992e97ec18cbc'],11,286,297,590562,6,0.524137931,0.848275862,0.944827586,1603
01aea04fe49e0e218e06a898780758c1bb0f2600,1,Chris Nauroth,2016-06-23 21:45:43+00:00,['2cea41e38e7597a1d5901381f2fc72fce8625b7e'],35,143,178,590740,8,0.263888889,1,1,1603
2fb9fee9732ac462950567fe26a86d3fc1fe8e89,0,Patrick D. Hunt,2016-06-30 03:54:30+00:00,['01aea04fe49e0e218e06a898780758c1bb0f2600'],93,3,96,590836,2,,,,1603
6f216245e8876015e5863ed0a060252419105e2e,0,Patrick D. Hunt,2016-06-30 04:06:00+00:00,['2fb9fee9732ac462950567fe26a86d3fc1fe8e89'],4,99,103,590939,2,,,,1603
0954df854ca69adc5238541a140732a74c73d554,0,Patrick D. Hunt,2016-07-26 22:26:47+00:00,['6f216245e8876015e5863ed0a060252419105e2e'],1,1,2,590941,1,,,,1603
fade262a8a4fa744bd768dc7569d8f4c9d84f275,1,Patrick D. Hunt,2016-07-26 23:33:27+00:00,['0954df854ca69adc5238541a140732a74c73d554'],259,550,809,591750,28,0.49044586,1,0.974522293,1608
fa01affcfd0d2cb4a84fbf09c0f77fd1f2593172,0,Patrick D. Hunt,2016-07-29 22:00:43+00:00,['fade262a8a4fa744bd768dc7569d8f4c9d84f275'],232,158,390,592140,26,,,,1608
beb1dd6afeadb8ec2d00ae4b3efdf66380f4949a,0,Patrick D. Hunt,2016-07-29 23:02:27+00:00,['fa01affcfd0d2cb4a84fbf09c0f77fd1f2593172'],2,9,11,592151,2,0,0,1,1608
8cf1ce3164a25f17c7d526038fb64b8c2ee89d5b,0,Raúl Gutiérrez Segalés,2016-08-03 18:16:19+00:00,['beb1dd6afeadb8ec2d00ae4b3efdf66380f4949a'],3,7,10,592161,2,,,,1608
257c47c5e5e825a452d7e54b35803bfb5da3ef5d,0,Patrick D. Hunt,2016-08-05 21:05:32+00:00,['8cf1ce3164a25f17c7d526038fb64b8c2ee89d5b'],0,8,8,592169,6,,,,1608
c0a5d8ba561cf8f9ad8fece964f5cf8894c154ee,0,Patrick D. Hunt,2016-08-10 17:32:22+00:00,['257c47c5e5e825a452d7e54b35803bfb5da3ef5d'],3,13,16,592185,3,1,1,1,1608
dfb63d9ab23ecf0262fa944e9b13988dab891e98,0,Flavio Paiva Junqueira,2016-08-10 21:01:21+00:00,['c0a5d8ba561cf8f9ad8fece964f5cf8894c154ee'],2,25,27,592212,3,0,0,1,1608
a9a0624823d0704b766e5208079c232dce8f25ea,1,Flavio Paiva Junqueira,2016-08-13 13:01:51+00:00,['dfb63d9ab23ecf0262fa944e9b13988dab891e98'],35,456,491,592703,15,0.37755102,0.494897959,0.994897959,1611
e6ab0c949ffb113f059f161ba055799ddf99b450,0,Patrick D. Hunt,2016-08-23 23:03:58+00:00,['a9a0624823d0704b766e5208079c232dce8f25ea'],2,5,7,592710,2,,,,1611
685a5268056a92159875dd58daa27817b69fa1c4,1,Patrick D. Hunt,2016-08-23 23:36:09+00:00,['e6ab0c949ffb113f059f161ba055799ddf99b450'],341,106,447,593157,23,0.675862069,0.475862069,0,1611
ffe4dbd9d0726315473bfdaed5bc74115e5de267,0,Patrick D. Hunt,2016-08-24 18:33:36+00:00,['685a5268056a92159875dd58daa27817b69fa1c4'],1,17,18,593175,4,1,1,1,1611
eab677af808e3ddee98c50d41ba190810393b8f0,0,Patrick D. Hunt,2016-08-25 00:23:55+00:00,['ffe4dbd9d0726315473bfdaed5bc74115e5de267'],20,56,76,593251,21,0,1,0,1611
bcb0d889933d25ece93e9b457c039e93e61b054a,1,Patrick D. Hunt,2016-09-07 22:12:19+00:00,['eab677af808e3ddee98c50d41ba190810393b8f0'],17,23,40,593291,2,,,,1611
5f91336295a3ae87296e9495686edbd138d8e6c1,0,Patrick D. Hunt,2016-09-08 02:57:36+00:00,['bcb0d889933d25ece93e9b457c039e93e61b054a'],4,11,15,593306,2,0,1,1,1611
84bbf894673f23cf9aa0ab745cf3a42e7509b3ef,0,Patrick D. Hunt,2016-09-08 04:02:37+00:00,['5f91336295a3ae87296e9495686edbd138d8e6c1'],0,7,7,593313,2,,,,1611
d8c783d6def783b3208c73a83a09febbb719eefc,0,Patrick D. Hunt,2016-09-08 14:21:26+00:00,['84bbf894673f23cf9aa0ab745cf3a42e7509b3ef'],6,12,18,593331,2,0,0,1,1611
32c709c0f0d69a34377cc934796869e80ebc6741,0,Patrick D. Hunt,2016-09-08 14:33:59+00:00,['d8c783d6def783b3208c73a83a09febbb719eefc'],1,4,5,593336,2,,,,1611
10dc80a2929862c2b1a20656354e435ec696b45e,0,Patrick D. Hunt,2016-09-08 20:52:26+00:00,['32c709c0f0d69a34377cc934796869e80ebc6741'],56,196,252,593588,4,0.721649485,0.793814433,0.721649485,1611
c38787f355b6dcd612fc57db0202fc68a01108f7,1,Patrick D. Hunt,2016-09-08 20:59:36+00:00,['10dc80a2929862c2b1a20656354e435ec696b45e'],9,268,277,593865,3,0.338461538,0.461538462,0.961538462,1612
fa5955afa0962147268241163b7ca47dcdd074e0,1,Chris Nauroth,2016-09-08 21:38:14+00:00,['c38787f355b6dcd612fc57db0202fc68a01108f7'],0,67,67,593932,2,,,,1612
12efc9f88705796cb905b46159e1d519323b1d9c,1,Patrick D. Hunt,2016-09-08 22:10:09+00:00,['fa5955afa0962147268241163b7ca47dcdd074e0'],97,105,202,594134,2,0,1,1,1612
8c4082647f89b0a92fa00a2af8de84b3c7314e23,0,Raul Gutierrez S,2016-09-12 10:13:42-07:00,['12efc9f88705796cb905b46159e1d519323b1d9c'],14,29,43,594177,2,,,,1612
b2a484cfe743116d2531fe5d1e1d78b3960c511e,0,Raul Gutierrez Segales,2016-09-12 20:21:06-07:00,['8c4082647f89b0a92fa00a2af8de84b3c7314e23'],3,6,9,594186,2,,,,1612
ec20c5434cc8a334b3fd25e27d26dccf4793c8f3,0,Patrick Hunt,2016-09-18 14:21:51-07:00,['b2a484cfe743116d2531fe5d1e1d78b3960c511e'],9,96,105,594291,3,0.075471698,0.886792453,0.905660377,1612
8d0154bcc21e58b6166eb5e360f72ce37699e072,0,Patrick Hunt,2016-10-05 09:30:00-07:00,['ec20c5434cc8a334b3fd25e27d26dccf4793c8f3'],10,8,18,594309,4,,,,1612
0a4971d5efb12a35a00cf794dce1efb3f08a998c,1,Camille Fournier,2016-10-07 15:51:52-04:00,['8d0154bcc21e58b6166eb5e360f72ce37699e072'],104,779,883,595192,26,0.427792916,0.634877384,0.798365123,1615
df5519ab9dac9940f35cc4b308b560f2603aec7f,0,Camille Fournier,2016-10-08 13:28:05-04:00,['0a4971d5efb12a35a00cf794dce1efb3f08a998c'],0,0,0,595192,15,,,,1615
f78061aafb19b102c37cb6d744ec6258d5f5b66e,1,Raul Gutierrez Segales,2016-10-09 13:40:36-07:00,['df5519ab9dac9940f35cc4b308b560f2603aec7f'],3,26,29,595221,3,0,1,1,1615
422058c222a8a31ec7cfd4113fbdc036181f751d,1,Rakesh Radhakrishnan,2016-10-16 17:39:43+05:18,['f78061aafb19b102c37cb6d744ec6258d5f5b66e'],1,26,27,595248,3,1,1,1,1615
cef5978969bedfe066f903834a9ea4af6d508844,0,fpj,2016-10-17 09:37:12+01:00,['422058c222a8a31ec7cfd4113fbdc036181f751d'],2,5,7,595255,2,,,,1615
f6349d16fcd5f04b560095417fd2a1813ac3e855,1,Benjamin Reed,2016-10-25 19:06:02-07:00,['cef5978969bedfe066f903834a9ea4af6d508844'],0,521,521,595776,1,0.261437908,0.411764706,0.535947712,1616
bcb07a09b06c91243ed244f04a71b8daf629e286,0,Alexander Shraer,2016-11-03 11:07:36-04:00,['f6349d16fcd5f04b560095417fd2a1813ac3e855'],13,25,38,595814,3,0.444444444,0.444444444,0.111111111,1616
440e0923dd9e3be533a196fdd6ada960860ca7f6,0,Raul Gutierrez Segales,2016-11-06 10:50:03-08:00,['bcb07a09b06c91243ed244f04a71b8daf629e286'],0,633,633,596447,2,,,,1617
881256ea97a19e51b1c6e9a114e6e61ad83bd4ec,0,Raul Gutierrez Segales,2016-11-12 19:53:43-08:00,['440e0923dd9e3be533a196fdd6ada960860ca7f6'],7,14,21,596468,2,,,,1617
73e102a58d01b27bc6208bbfbde2d12f0deba1f4,1,fpj,2016-11-13 11:59:29-08:00,['881256ea97a19e51b1c6e9a114e6e61ad83bd4ec'],244,1273,1517,597985,36,0.395652174,0.810869565,0.87173913,1620
179c8db6df20beccd64fac2c99ca77dbe8a3242c,0,fpj,2016-11-15 21:21:09-08:00,['73e102a58d01b27bc6208bbfbde2d12f0deba1f4'],41,588,629,598614,11,0.79342723,0.995305164,0.901408451,1624
d310d45bb938852c332646ccc2202091b9e472c8,0,Patrick Hunt,2016-11-18 14:04:03-08:00,['179c8db6df20beccd64fac2c99ca77dbe8a3242c'],4,19,23,598637,2,1,0,1,1624
b9beabf5cfbb8e447f67a8050486ca2821132f61,1,fpj,2016-11-24 16:18:08+00:00,['d310d45bb938852c332646ccc2202091b9e472c8'],579,585,1164,599801,14,1,1,1,1624
d72f27279a13986ee0c011e1e5b34edf3a310da9,0,fpj,2016-11-25 06:08:55+00:00,['b9beabf5cfbb8e447f67a8050486ca2821132f61'],106,99,205,600006,1,1,1,0,1624
73d6bf5353586e49740f77291d1fd98b07f916cc,1,Raul Gutierrez Segales,2016-12-03 09:09:06-08:00,['d72f27279a13986ee0c011e1e5b34edf3a310da9'],15,25,40,600046,3,,,,1624
cd0e323831c8b4cde64976325bfc79bb53cdd9b7,0,fpj,2016-12-11 20:08:45+00:00,['73d6bf5353586e49740f77291d1fd98b07f916cc'],16,273,289,600335,31,,,,1624
482ce218d815b7a613ed9728b82602ddecc61996,1,fpj,2016-12-16 10:43:47+00:00,['cd0e323831c8b4cde64976325bfc79bb53cdd9b7'],264,276,540,600875,9,0.473684211,0.473684211,0,1624
dfcf4da75c35c12d08496ded2612031f887c0765,0,fpj,2016-12-16 13:40:01+00:00,['482ce218d815b7a613ed9728b82602ddecc61996'],1,0,1,600876,1,,,,1624
8616a9ec8ce4bc8ac2987b7417a6f0c4b7333658,0,fpj,2016-12-20 13:47:25+00:00,['dfcf4da75c35c12d08496ded2612031f887c0765'],10,78,88,600964,8,0.333333333,0.888888889,1,1624
eac693cc76a34f96b9116ef33d1e92af7129416d,0,fpj,2016-12-21 22:32:01+00:00,['8616a9ec8ce4bc8ac2987b7417a6f0c4b7333658'],14,292,306,601270,15,0.449367089,1,0.943037975,1625
ef0a8ae686c100f1dc71d7526af962c635696466,0,Michael Han,2016-12-21 19:11:20-08:00,['eac693cc76a34f96b9116ef33d1e92af7129416d'],4,61,65,601335,2,1,1,1,1626
f588e1982f382a586fea53a1fbb11914d48560de,0,Michael Han,2016-12-22 14:23:29-08:00,['ef0a8ae686c100f1dc71d7526af962c635696466'],14,20,34,601369,12,,,,1626
085a7ab4efe04e566e952af1123e98eda609bd1b,0,Michael Han,2016-12-22 21:58:23-08:00,['f588e1982f382a586fea53a1fbb11914d48560de'],1,3,4,601373,1,,,,1626
de5c0e9abeb87721f4157662210dfcd38a7c15ea,1,Michael Han,2016-12-30 14:01:55-08:00,['085a7ab4efe04e566e952af1123e98eda609bd1b'],8,125,133,601506,5,0.259259259,1,1,1627
670bb5d5ecc2d6a94bf24effcc7bf497e8778cc5,0,Michael Han,2016-12-30 14:59:26-08:00,['de5c0e9abeb87721f4157662210dfcd38a7c15ea'],1,1,2,601508,1,,,,1627
0753f4cdceaa2e5386072d129d897417da47d959,0,Michael Han,2017-01-05 13:33:20-08:00,['670bb5d5ecc2d6a94bf24effcc7bf497e8778cc5'],0,12,12,601520,1,,,,1627
1d38d30cfd1aa47f22451f4df53ae2363ea20a82,0,Rakesh Radhakrishnan,2017-01-06 17:29:31+05:18,['0753f4cdceaa2e5386072d129d897417da47d959'],2,16,18,601538,1,1,1,1,1627
7c51b01e89acb38165553366f7e3b2a46c00aa27,1,Michael Han,2017-01-06 16:09:54-08:00,['1d38d30cfd1aa47f22451f4df53ae2363ea20a82'],1,154,155,601693,4,0.117647059,0.867647059,0.867647059,1628
c2434883dcdd85450ac73b7e69f3deed83fa5bf4,0,Michael Han,2017-01-09 13:49:58-08:00,['7c51b01e89acb38165553366f7e3b2a46c00aa27'],1,23,24,601717,2,1,1,1,1628
5f60374d060c18ccad322c7f18883284dbac0fed,0,Michael Han,2017-01-10 21:27:38-08:00,['c2434883dcdd85450ac73b7e69f3deed83fa5bf4'],0,2,2,601719,1,,,,1628
8773ecb78a4bbd5ed066493a09adf7f1a73fa74e,1,benjamin reed,2017-01-13 10:29:52-08:00,['5f60374d060c18ccad322c7f18883284dbac0fed'],88,267,355,602074,12,0.3625,0.6625,0.5375,1629
42c75b5f2457f8ea5b4106ce5dc1c34c330361c0,0,Michael Han,2017-01-13 21:32:15-08:00,['8773ecb78a4bbd5ed066493a09adf7f1a73fa74e'],5,10,15,602089,1,0,0,1,1629
3bd4ed98021b033acdd5eae583d84e86fc3430e4,0,Michael Han,2017-01-22 16:42:36-08:00,['42c75b5f2457f8ea5b4106ce5dc1c34c330361c0'],2,2,4,602093,2,,,,1629
762f4af65bb1056a582a6f36183a9e28fe0ccab8,1,Michael Han,2017-01-22 17:13:37-08:00,['3bd4ed98021b033acdd5eae583d84e86fc3430e4'],48,244,292,602385,5,0.207317073,0.951219512,0.926829268,1629
8771ffdaacb87126a485ae740558f6a288ab980b,1,Rakesh Radhakrishnan,2017-01-25 17:18:56+05:18,['762f4af65bb1056a582a6f36183a9e28fe0ccab8'],22,33,55,602440,6,0.75,0,0.75,1629
edf75b5e31f0d9e2fbfadbd95bae9d1d6c4737f6,0,arshad,2017-01-28 11:01:53+05:18,['8771ffdaacb87126a485ae740558f6a288ab980b'],7,5,12,602452,1,1,1,0,1629
26aee2228451257f3b0b5093bc0c101822e06bc8,0,Michael Han,2017-02-04 22:22:51-08:00,['edf75b5e31f0d9e2fbfadbd95bae9d1d6c4737f6'],40,88,128,602580,6,1,1,1,1630
ee5615d31ff4da2b2111f5a3b5d5b650f60bf936,0,Rakesh Radhakrishnan,2017-02-07 13:11:26+05:18,['26aee2228451257f3b0b5093bc0c101822e06bc8'],2,7,9,602589,1,,,,1630
434abbbb7eef271fab02306bcc9c8ad29ec2fe2e,1,Rakesh Radhakrishnan,2017-02-09 15:58:23+05:18,['ee5615d31ff4da2b2111f5a3b5d5b650f60bf936'],98,128,226,602815,2,0.72,0.64,1,1630
f35bca0b36c3d5ac0282cc5519fbd372e6632394,0,Rakesh Radhakrishnan,2017-02-10 14:05:36+05:18,['434abbbb7eef271fab02306bcc9c8ad29ec2fe2e'],3302,0,3302,606117,1,,,,1630
bbfd0169417c316bbdd22ff7a38176845aa0efc6,1,Michael Han,2017-02-11 15:12:00-08:00,['f35bca0b36c3d5ac0282cc5519fbd372e6632394'],17,69,86,606203,4,0.12,0.04,1,1630
c5df1c9acec07036da225b1251cb30be60301224,0,Michael Han,2017-02-11 15:34:24-08:00,['bbfd0169417c316bbdd22ff7a38176845aa0efc6'],28,28,56,606259,9,,,,1630
201cac20e1a66e7d4180a6c7e18834c0ca6094dc,0,Michael Han,2017-02-13 13:09:59-08:00,['c5df1c9acec07036da225b1251cb30be60301224'],28,28,56,606315,2,0,0,1,1630
15e3f7fccc770783786e8097f7a6618509bfee0f,0,Rakesh Radhakrishnan,2017-02-14 13:42:22+05:18,['201cac20e1a66e7d4180a6c7e18834c0ca6094dc'],24,24,48,606363,12,,,,1630
fd211a5275b6231e668268fb9df2820e07f5f33c,0,Rakesh Radhakrishnan,2017-02-16 03:22:18+05:18,['15e3f7fccc770783786e8097f7a6618509bfee0f'],2,3,5,606368,1,,,,1630
d13d2f08c730a81d73d58f64a0ae448639dede2b,0,Michael Han,2017-02-15 16:17:02-08:00,['fd211a5275b6231e668268fb9df2820e07f5f33c'],2,16,18,606386,1,1,1,1,1630
5fe68506f217246c7ebd96803f9c78e13ec2f11a,1,Michael Han,2017-03-04 10:22:03-08:00,['d13d2f08c730a81d73d58f64a0ae448639dede2b'],15,466,481,606867,7,0.368181818,0.840909091,0.95,1632
cf4f119516ca3d232fe077477c7a91b2e5825de2,0,Michael Han,2017-03-08 17:48:41-08:00,['5fe68506f217246c7ebd96803f9c78e13ec2f11a'],8,18,26,606893,1,,,,1632
6949af062d5ad3cdb36c86afc3728ede78c8039d,0,Michael Han,2017-03-14 09:06:28-07:00,['cf4f119516ca3d232fe077477c7a91b2e5825de2'],0,3,3,606896,1,0,1,1,1632
86438f9c6e65b2a95d709bf575cdcc2abc1c2e8b,0,Rakesh Radhakrishnan,2017-03-16 21:31:45+05:18,['6949af062d5ad3cdb36c86afc3728ede78c8039d'],1,1,2,606898,1,,,,1632
b4dded46f901fbc2128c7f752107a1391d676968,0,Mohammad Arshad,2017-03-16 23:25:22+05:18,['86438f9c6e65b2a95d709bf575cdcc2abc1c2e8b'],31,14,45,606943,3,,,,1632
0313a0e0b6c47b316271533165e5830d1ca04478,0,Michael Han,2017-03-16 12:57:12-07:00,['b4dded46f901fbc2128c7f752107a1391d676968'],2,2,4,606947,1,,,,1632
63577ba52a829391ded3ae11c62c0e996865b5c7,0,Michael Han,2017-03-21 09:49:56-07:00,['0313a0e0b6c47b316271533165e5830d1ca04478'],8,169,177,607124,2,0.472527473,0.56043956,1,1633
9a6aff269e5c1ac25e1aca1877b06f725799bfee,1,Michael Han,2017-03-21 12:09:55-07:00,['63577ba52a829391ded3ae11c62c0e996865b5c7'],49,147,196,607320,30,,,,1633
fb7ddacfc42acb01275ca8d69ae219d6413832b4,0,Michael Han,2017-03-23 10:22:25-07:00,['9a6aff269e5c1ac25e1aca1877b06f725799bfee'],3,3,6,607326,3,,,,1633
54c7f6b472ed7bb10fd86cb3c28262fa4f7351d9,1,Michael Han,2017-03-23 10:46:42-07:00,['fb7ddacfc42acb01275ca8d69ae219d6413832b4'],5,32,37,607363,1,0,0,1,1633
d8adc547f9856747905b7d46450f13fa98df147f,0,Michael Han,2017-03-27 10:32:02-07:00,['54c7f6b472ed7bb10fd86cb3c28262fa4f7351d9'],1,1,2,607365,1,,,,1633
d061f1b5a5eca108e566a68e6f7aa07913c90ac3,0,Michael Han,2017-04-04 17:02:55-07:00,['d8adc547f9856747905b7d46450f13fa98df147f'],1,0,1,607366,1,1,1,0,1633
b3ef40bffe49c1e42aee23a600a775194f36bca0,0,Michael Han,2017-04-10 10:19:34-07:00,['d061f1b5a5eca108e566a68e6f7aa07913c90ac3'],1,6,7,607373,1,,,,1633
3946f0b1dfaa847eaa73cae5634d7d28da94eec9,0,Michael Han,2017-04-17 16:37:32-07:00,['b3ef40bffe49c1e42aee23a600a775194f36bca0'],7,46,53,607426,2,0.111111111,1,1,1633
6e91424b220ccbefc8456e1b8a5e0ba0e5130f9a,0,Michael Han,2017-04-17 16:57:44-07:00,['3946f0b1dfaa847eaa73cae5634d7d28da94eec9'],0,2,2,607428,1,,,,1633
a43b98268bfe5aadfa8036b49dc8b1b8f0a4d67a,0,Michael Han,2017-04-17 17:02:29-07:00,['6e91424b220ccbefc8456e1b8a5e0ba0e5130f9a'],3,3,6,607434,1,,,,1633
5d86165250aeed6c109bd74f66814711b88ba015,1,Michael Han,2017-04-18 16:19:29-07:00,['a43b98268bfe5aadfa8036b49dc8b1b8f0a4d67a'],2,3,5,607439,1,0,1,1,1633
a6b168a813089c4b52e9bd883452672a128fa7f8,0,Michael Han,2017-04-24 10:07:58-07:00,['5d86165250aeed6c109bd74f66814711b88ba015'],1,1,2,607441,1,,,,1633
f7281f30467bfecb679f3e3d436337dfd16c810a,0,Michael Han,2017-04-27 14:20:32-07:00,['a6b168a813089c4b52e9bd883452672a128fa7f8'],3,3,6,607447,1,,,,1633
425fdbb8fa64ea839072701187fa7a24bfe10bda,0,Michael Han,2017-04-27 22:14:08-07:00,['f7281f30467bfecb679f3e3d436337dfd16c810a'],4,109,113,607560,8,0.24,1,1,1633
017ca1a24c1fa5988dd3c718f90b4beedb8a6a45,0,Mohammad Arshad,2017-04-30 02:17:03+08:00,['425fdbb8fa64ea839072701187fa7a24bfe10bda'],2,4,6,607566,1,,,,1633
acfc471eca0aab57707b59ed8d19221360d19b85,0,Michael Han,2017-05-01 08:19:15-07:00,['017ca1a24c1fa5988dd3c718f90b4beedb8a6a45'],6,25,31,607597,3,1,1,1,1633
a680655a3569bfc546712cb85eeaea8c9b7de3ad,0,Mohammad Arshad,2017-05-11 22:59:42+08:00,['acfc471eca0aab57707b59ed8d19221360d19b85'],902,51,953,608550,11,0.944111776,0.876247505,0.033932136,1633
0a3e2d1d4bdbb96f41da7111db3913ef08068722,1,Michael Han,2017-05-18 14:14:39-07:00,['a680655a3569bfc546712cb85eeaea8c9b7de3ad'],0,1,1,608551,1,0,0,1,1633
b0b194533c08c8a111497e853668f751b28ae4e9,1,Michael Han,2017-05-26 15:52:37-07:00,['0a3e2d1d4bdbb96f41da7111db3913ef08068722'],10,71,81,608632,16,0,0,0.815789474,1634
5bfcc13fd6820c212d67c39fede4dc4a50d84d83,0,Michael Han,2017-05-26 16:03:46-07:00,['b0b194533c08c8a111497e853668f751b28ae4e9'],4,4,8,608640,1,,,,1634
ce0aa2bac7faf1eff3a6317aa8fc889ba13e7130,0,Michael Han,2017-05-30 10:43:52-07:00,['5bfcc13fd6820c212d67c39fede4dc4a50d84d83'],1,1,2,608642,1,,,,1634
e358a808d172c31e114eee1cc2957fe92d0d142e,0,Michael Han,2017-05-30 16:01:59-07:00,['ce0aa2bac7faf1eff3a6317aa8fc889ba13e7130'],5,0,5,608647,1,,,,1634
3824da0b649c6a6a698cfe6c79ca3d44a9e94f29,1,Michael Han,2017-05-31 20:45:49-07:00,['e358a808d172c31e114eee1cc2957fe92d0d142e'],4,31,35,608682,2,0,1,0,1634
1f2eb3a0409ff4f3b09896f2148dfbcb9d4c5081,0,Michael Han,2017-06-01 09:34:42-07:00,['3824da0b649c6a6a698cfe6c79ca3d44a9e94f29'],2,0,2,608684,1,1,1,0,1634
1038966e8289c09a6f3b863dd2713b9f1c83b4cf,0,Michael Han,2017-06-08 08:51:19-07:00,['1f2eb3a0409ff4f3b09896f2148dfbcb9d4c5081'],16,24,40,608724,2,1,1,1,1634
fa1dc109d4c1bb7913fee43170ed6131e3dc1b1f,0,Michael Han,2017-06-08 08:59:05-07:00,['1038966e8289c09a6f3b863dd2713b9f1c83b4cf'],24,93,117,608841,2,0.364864865,0.986486486,1,1634
4517050510f8db354589d054c9ded4c78b36902f,0,Michael Han,2017-06-09 09:37:53-07:00,['fa1dc109d4c1bb7913fee43170ed6131e3dc1b1f'],0,30,30,608871,2,1,1,1,1634
77ceace9475453c2799e84f198d25db738ae73d0,0,Michael Han,2017-06-09 11:03:18-07:00,['4517050510f8db354589d054c9ded4c78b36902f'],1,1,2,608873,1,,,,1634
c38febe2dde261babc459b27bb84ef5d11da88df,1,Michael Han,2017-06-15 15:35:08-07:00,['77ceace9475453c2799e84f198d25db738ae73d0'],8,5,13,608886,2,0,0,0,1634
111ae5a5b67999925f1921736a14fcfbdb1b7348,0,Michael Han,2017-06-18 10:23:04-07:00,['c38febe2dde261babc459b27bb84ef5d11da88df'],35,83,118,609004,3,0.1,1,1,1634
fb267672d219c73c0cf2527fafebc1a0b17d3bee,1,Michael Han,2017-06-23 09:39:05-07:00,['111ae5a5b67999925f1921736a14fcfbdb1b7348'],5,153,158,609162,4,0.130434783,1,1,1635
8ec4c58eb37880a812bb2e23e8b3ec2a5e3b7f32,1,Michael Han,2017-06-25 15:07:06-07:00,['fb267672d219c73c0cf2527fafebc1a0b17d3bee'],63,49,112,609274,5,1,0.857142857,0.142857143,1635
a0eba7abd002498631da8d8127261c297c911590,1,Michael Han,2017-06-25 15:16:07-07:00,['8ec4c58eb37880a812bb2e23e8b3ec2a5e3b7f32'],37,31,68,609342,4,0.333333333,0,0.666666667,1635
eab6e7a139eed285973950b8d4f95dfc3d52b5a6,0,Michael Han,2017-06-30 13:43:53-07:00,['a0eba7abd002498631da8d8127261c297c911590'],5,15,20,609362,1,0,1,1,1635
69710181042a8c1f0461c1739b96171d88f2b126,0,Michael Han,2017-07-03 22:39:58-07:00,['eab6e7a139eed285973950b8d4f95dfc3d52b5a6'],2,225,227,609589,2,0.212389381,0.991150442,1,1636
7db83eb9dcbd26b79f852e93520db821dabff047,0,Michael Han,2017-07-03 22:56:09-07:00,['69710181042a8c1f0461c1739b96171d88f2b126'],9,9,18,609607,2,,,,1636
ddf0364903bf7ac7cd25b2e1927f0d9d3c7203c4,1,Michael Han,2017-07-06 09:48:47-07:00,['7db83eb9dcbd26b79f852e93520db821dabff047'],15,287,302,609909,7,0.327160494,0.648148148,0.938271605,1637
f60928787a908f358a64763f802a6d0371ad4404,1,Michael Han,2017-07-18 10:42:22-07:00,['ddf0364903bf7ac7cd25b2e1927f0d9d3c7203c4'],1517,523,2040,611949,24,,,,1639
41b30a74ec8b33255e99d97a102de53d315c28b3,0,Michael Han,2017-07-26 17:24:20-07:00,['f60928787a908f358a64763f802a6d0371ad4404'],1,1,2,611951,1,,,,1639
32794ca5d5a233abc6e019b07aadbfd375060bbd,1,Michael Han,2017-07-27 14:10:51-07:00,['41b30a74ec8b33255e99d97a102de53d315c28b3'],3,11,14,611965,3,0.75,0.75,1,1639
0cb4011dac7ec28637426cafd98b4f8f299ef61d,0,Michael Han,2017-07-27 15:37:00-07:00,['32794ca5d5a233abc6e019b07aadbfd375060bbd'],21,125,146,612111,27,0,0,1,1639
3f7e4133f3abc17df5eb4f0145d0833417bfdb33,0,Michael Han,2017-08-03 11:28:20-07:00,['0cb4011dac7ec28637426cafd98b4f8f299ef61d'],4,29,33,612144,2,0.086956522,1,1,1639
69c8cbea1dcc95bb1b4eb01cbfd667a1bfba1f5d,0,Michael Han,2017-08-03 11:32:38-07:00,['3f7e4133f3abc17df5eb4f0145d0833417bfdb33'],3,5,8,612152,1,,,,1639
5c4e44332e55bbf21ca59583f3e8ca97fc4bb266,0,Michael Han,2017-08-03 11:41:30-07:00,['69c8cbea1dcc95bb1b4eb01cbfd667a1bfba1f5d'],61,63,124,612276,1,0,0,1,1639
fe6eac364c3888d1b23dec568e8985ac0a6b0a51,0,Michael Han,2017-08-05 21:22:30-07:00,['5c4e44332e55bbf21ca59583f3e8ca97fc4bb266'],0,8,8,612284,3,,,,1639
31501b8abba16a82e03eeb1b7ccced23474101df,0,Michael Han,2017-08-05 21:49:17-07:00,['fe6eac364c3888d1b23dec568e8985ac0a6b0a51'],1,109,110,612394,1,,,,1639
e104175bb47baeb800354078c015e78bfcb7c953,0,Michael Han,2017-08-09 11:31:21-07:00,['31501b8abba16a82e03eeb1b7ccced23474101df'],2,10,12,612406,1,0.5,0.5,0.5,1639
3408b62b5b18a02a4ef689137c8cb8e5ce083cf2,0,Michael Han,2017-08-10 13:04:45-07:00,['e104175bb47baeb800354078c015e78bfcb7c953'],0,204,204,612610,1,0.514851485,1,0.801980198,1640
0c5b320060bdda854b530dc8a22993ba8cbbd655,0,Michael Han,2017-08-10 13:14:22-07:00,['3408b62b5b18a02a4ef689137c8cb8e5ce083cf2'],2,13,15,612625,1,1,1,1,1640
5bcffe9bc242d825ad97ff4f9d2dea6476983a9a,0,Michael Han,2017-08-12 22:21:25-07:00,['0c5b320060bdda854b530dc8a22993ba8cbbd655'],12,11,23,612648,1,,,,1640
29d25c4d76a3a33a3cf6ab0f3dec3819edad8f1c,1,Michael Han,2017-08-12 22:28:58-07:00,['5bcffe9bc242d825ad97ff4f9d2dea6476983a9a'],6,6,12,612660,1,,,,1640
ab182d4561f1c6725af0e89e0b76d92186732195,1,Michael Han,2017-08-17 21:20:49-07:00,['29d25c4d76a3a33a3cf6ab0f3dec3819edad8f1c'],1,3,4,612664,1,,,,1640
0706b40afad079f19fe9f76c99bbb7ec69780dbd,1,Michael Han,2017-08-17 21:32:43-07:00,['ab182d4561f1c6725af0e89e0b76d92186732195'],18,34,52,612716,7,0,0.75,0,1640
d7c192c1829cc657d3312f47ecb5b97519d1b30d,0,Michael Han,2017-08-18 14:35:24-07:00,['0706b40afad079f19fe9f76c99bbb7ec69780dbd'],12,112,124,612840,3,0.104477612,1,1,1640
09742f2d050105689592ffb5f5240ebde6f79dee,0,Michael Han,2017-08-18 15:30:06-07:00,['d7c192c1829cc657d3312f47ecb5b97519d1b30d'],2,2,4,612844,1,,,,1640
b64d50441792587d75b9a32a1e2014578d132d31,0,Michael Han,2017-08-21 16:50:59-07:00,['09742f2d050105689592ffb5f5240ebde6f79dee'],0,8,8,612852,1,,,,1640
52aff3eca439bba70f2b4d175ce331754dcd03db,0,Camille Fournier,2017-08-22 20:16:27-04:00,['b64d50441792587d75b9a32a1e2014578d132d31'],6,13,19,612871,1,0,0,1,1640
86577c9d81bd40067bc084e49a7172884ac9ae49,0,Michael Han,2017-08-23 17:11:04-07:00,['52aff3eca439bba70f2b4d175ce331754dcd03db'],0,0,0,612871,1,,,,1640
faab8d97fdc426341cfa38ebca3701fee8dc121e,1,Michael Han,2017-09-10 21:33:29-07:00,['86577c9d81bd40067bc084e49a7172884ac9ae49'],0,25,25,612896,2,,,,1640
1165794be9587acccc02782dbff95bc482222528,1,Michael Han,2017-09-11 09:55:05-07:00,['faab8d97fdc426341cfa38ebca3701fee8dc121e'],121,159,280,613176,54,,,,1640
563f892da0e03e23715bddf236b10582bd51e429,0,Michael Han,2017-09-11 13:43:11-07:00,['1165794be9587acccc02782dbff95bc482222528'],5,9,14,613190,1,,,,1640
ef8b751c491bbc57b628ea9685a774fe40ba43dc,0,Michael Han,2017-09-11 13:56:46-07:00,['563f892da0e03e23715bddf236b10582bd51e429'],13,33,46,613236,1,0,0,1,1640
f33a75db1cc18124b6d0a4ee15967901fa6ec493,0,Michael Han,2017-09-11 14:30:45-07:00,['ef8b751c491bbc57b628ea9685a774fe40ba43dc'],1,1,2,613238,1,,,,1640
523b7fb2c37c927feb4c099c084aebc3c3f76052,0,Patrick Hunt,2017-09-27 14:27:51-07:00,['f33a75db1cc18124b6d0a4ee15967901fa6ec493'],5,0,5,613243,1,,,,1640
0fee905684a82eefb2d7d4a999290fb2f2378b41,0,Patrick Hunt,2017-09-27 15:18:15-07:00,['523b7fb2c37c927feb4c099c084aebc3c3f76052'],6,3,9,613252,2,,,,1640
086359a6945df3ea5548c7a65730294cf612ce66,1,Patrick Hunt,2017-09-27 20:09:59-07:00,['0fee905684a82eefb2d7d4a999290fb2f2378b41'],26,60,86,613338,2,,,,1640
54cd7519a3afc43dabbf49490b9b012d6be68fee,0,Patrick Hunt,2017-09-29 15:54:07-07:00,['086359a6945df3ea5548c7a65730294cf612ce66'],4,13,17,613355,2,,,,1640
aa35571ea2be1791430349fcc1485b1bdccec6a1,0,Patrick Hunt,2017-10-04 10:26:21-07:00,['54cd7519a3afc43dabbf49490b9b012d6be68fee'],3,0,3,613358,1,,,,1640
fb10c2b54698c8aab4477670bb0d6f7fe99c5c43,1,Patrick Hunt,2017-10-07 12:22:42-07:00,['aa35571ea2be1791430349fcc1485b1bdccec6a1'],4,5,9,613367,4,0,1,1,1640
194f43e749e231f78b31cbbe040eed37385209aa,0,Patrick Hunt,2017-10-09 10:57:13-07:00,['fb10c2b54698c8aab4477670bb0d6f7fe99c5c43'],0,5,5,613372,1,,,,1640
43a50ebc658dd25b8b9f9f91cf4c32c2c0e3e000,0,Patrick Hunt,2017-10-10 11:50:22-07:00,['194f43e749e231f78b31cbbe040eed37385209aa'],0,1,1,613373,1,,,,1640
575e850c4d75191e27368e87ad5945cc5aba673d,0,Patrick Hunt,2017-10-11 07:28:25-07:00,['43a50ebc658dd25b8b9f9f91cf4c32c2c0e3e000'],12,24,36,613409,2,,,,1640
98ff4f9dd9b67503ffa3f5852df499a46efd6241,1,Patrick Hunt,2017-10-13 16:14:04-07:00,['575e850c4d75191e27368e87ad5945cc5aba673d'],36,263,299,613708,19,,,,1640
c510be675d4b532d552a2f0bfa9df5d6feef1a9b,0,Patrick Hunt,2017-11-01 09:51:24-07:00,['98ff4f9dd9b67503ffa3f5852df499a46efd6241'],2,2,4,613712,1,,,,1640
1392a8b3d8ac3d042a51dac18e33e144674b1b5b,0,Alexander Shraer,2017-11-02 21:04:56-07:00,['c510be675d4b532d552a2f0bfa9df5d6feef1a9b'],19,172,191,613903,2,0.013888889,1,1,1640
efeebd0a1ba7f6be3b4ffe262ab4045656bb1eb3,0,Patrick Hunt,2017-11-15 12:27:10-08:00,['1392a8b3d8ac3d042a51dac18e33e144674b1b5b'],14,36,50,613953,17,,,,1640
0fe7a09ab57c73c3a5c91e68a889f600c0739136,0,Patrick Hunt,2017-11-15 13:44:29-08:00,['efeebd0a1ba7f6be3b4ffe262ab4045656bb1eb3'],4,3,7,613960,1,,,,1640
f6d2abf58adeda5a8c5da8192ea4a6549285e561,1,Patrick Hunt,2017-11-15 14:08:13-08:00,['0fe7a09ab57c73c3a5c91e68a889f600c0739136'],21,21,42,614002,3,,,,1640
f299303add79250ec2181f6c03b15e3754825284,0,Patrick Hunt,2017-11-15 15:21:33-08:00,['f6d2abf58adeda5a8c5da8192ea4a6549285e561'],9,23,32,614034,2,1,1,1,1640
b5621c698baf5d3258ebcf9342a23aa4889d03ca,0,Patrick Hunt,2017-11-21 09:38:20-08:00,['f299303add79250ec2181f6c03b15e3754825284'],1,1,2,614036,1,,,,1640
cbe524cdccd5f8fc52bc3644ca15a5fd85347600,0,Patrick Hunt,2017-11-21 09:45:52-08:00,['b5621c698baf5d3258ebcf9342a23aa4889d03ca'],2,2,4,614040,17,,,,1640
851075b5e388525a89fb0579150c2a3ed9e59bcd,0,Patrick Hunt,2017-11-21 10:20:33-08:00,['cbe524cdccd5f8fc52bc3644ca15a5fd85347600'],5,10,15,614055,1,0.75,1,1,1640
81fe5262fe9ba47f716fc5b786cffe3d83f51c05,1,Patrick Hunt,2017-11-22 09:42:56-08:00,['851075b5e388525a89fb0579150c2a3ed9e59bcd'],4,4,8,614063,1,,,,1640
748585d200da3a137f6ee37ee543d4f32c30d9c6,0,Patrick Hunt,2017-11-22 12:13:55-08:00,['81fe5262fe9ba47f716fc5b786cffe3d83f51c05'],4,7,11,614074,2,,,,1640
75411ab34a3d53c43c2d508b12314a9788aa417d,1,Patrick Hunt,2017-11-27 15:10:13-08:00,['748585d200da3a137f6ee37ee543d4f32c30d9c6'],396,3755,4151,618225,51,0.398399015,0.806650246,0.706280788,1661
d857e042fe4d188a7ba750ea6947f93f39cb7ed1,0,Patrick Hunt,2017-12-06 14:14:10-08:00,['75411ab34a3d53c43c2d508b12314a9788aa417d'],281,212,493,618718,2,1,0,0,1662
665038e0698cd471a25b7ead4c8a50f767a3e7ed,0,Patrick Hunt,2017-12-06 14:54:44-08:00,['d857e042fe4d188a7ba750ea6947f93f39cb7ed1'],14,80,94,618812,4,,,,1662
dcfbe45241855f2caccf3848be2e66e7aa23aa96,0,Patrick Hunt,2017-12-12 10:39:45-08:00,['665038e0698cd471a25b7ead4c8a50f767a3e7ed'],0,3,3,618815,1,,,,1662
9e30b9bf8fac56db3846c8cc42997cdc23a9358d,0,Patrick Hunt,2017-12-12 10:44:32-08:00,['dcfbe45241855f2caccf3848be2e66e7aa23aa96'],3,15,18,618833,1,0.454545455,0.454545455,1,1662
aa8b60670875e509dc22f338aebcc023c166d880,0,Patrick Hunt,2017-12-13 14:00:08-08:00,['9e30b9bf8fac56db3846c8cc42997cdc23a9358d'],22,24,46,618879,3,,,,1663
f2cbcc7e0d7adff08bd73a27f2193b1198e4c7f7,1,Patrick Hunt,2017-12-15 16:25:30-08:00,['aa8b60670875e509dc22f338aebcc023c166d880'],121,151,272,619151,3,0.466666667,0.733333333,0.733333333,1663
e129e7a0b64d6555460d240be2d79e53aaa1bef9,0,Patrick Hunt,2017-12-19 10:27:25-08:00,['f2cbcc7e0d7adff08bd73a27f2193b1198e4c7f7'],17,17,34,619185,1,,,,1663
4d629d289fc4b1079fff2244b92a337e4068e240,0,Patrick Hunt,2018-01-18 15:43:11-08:00,['e129e7a0b64d6555460d240be2d79e53aaa1bef9'],30,142,172,619357,3,0.533333333,1,0.977777778,1664
77d6b763a7772553ecfa81e3d3ef177452ad16a7,1,Patrick Hunt,2018-01-18 15:52:43-08:00,['4d629d289fc4b1079fff2244b92a337e4068e240'],2,3,5,619362,1,,,,1664
78708a8587841ccdcb3d07f33d3114e0c8cfc380,0,Patrick Hunt,2018-01-18 16:12:03-08:00,['77d6b763a7772553ecfa81e3d3ef177452ad16a7'],2,2,4,619366,1,,,,1664
d1b07d588e445085eff4abeb42cf730cc7c57e83,0,Abraham Fine,2018-01-29 23:02:41-08:00,['78708a8587841ccdcb3d07f33d3114e0c8cfc380'],5,1,6,619372,1,0,0,0,1664
66554218a557cbc86924354bdb20e20b20ff934f,0,Abraham Fine,2018-01-30 12:56:37-08:00,['d1b07d588e445085eff4abeb42cf730cc7c57e83'],2,10,12,619384,1,1,1,1,1664
069c3e4fccbd56307b19b57864fbf6312ace2219,0,Abraham Fine,2018-02-01 15:26:58-08:00,['66554218a557cbc86924354bdb20e20b20ff934f'],1,3,4,619388,1,0,0,1,1664
aefb13f2b289e19e32c0fcc5714711b07989d67f,0,Abraham Fine,2018-02-06 16:05:18-08:00,['069c3e4fccbd56307b19b57864fbf6312ace2219'],44,736,780,620168,19,0.530612245,1,1,1670
bebe4162bc915b15b4fd90df9446bdf9f83ef3a8,0,Abraham Fine,2018-02-14 12:23:30-08:00,['aefb13f2b289e19e32c0fcc5714711b07989d67f'],85,265,350,620518,5,1,0.97979798,0.797979798,1670
f0b67b6e49acec5f022bee25e08f82a29572c97a,0,Abraham Fine,2018-02-20 14:38:00-08:00,['bebe4162bc915b15b4fd90df9446bdf9f83ef3a8'],1,1,2,620520,1,,,,1670
722ba9409a44a35d287aac803813f508cff2420a,1,Abraham Fine,2018-02-23 14:49:00-08:00,['f0b67b6e49acec5f022bee25e08f82a29572c97a'],45,209,254,620774,4,0.345794393,1,0.962616822,1670
ecb1162ec7f381963fb3263c7971a85fc35b27c8,0,Abraham Fine,2018-03-02 14:12:17-08:00,['722ba9409a44a35d287aac803813f508cff2420a'],4,0,4,620778,1,,,,1670
99c9bbb0ab1eef469e1662086532c58078b9909a,0,Michael Han,2018-03-04 18:51:25-08:00,['ecb1162ec7f381963fb3263c7971a85fc35b27c8'],1,1,2,620780,1,,,,1670
8cfca3add9c7fd705f9114daf4adaac9fc90f040,0,Michael Han,2018-03-25 18:49:14-07:00,['99c9bbb0ab1eef469e1662086532c58078b9909a'],3,3,6,620786,1,,,,1670
29a892907eb175adc0c6908a1fde3e7bf8d655b6,0,Michael Han,2018-03-25 19:16:35-07:00,['8cfca3add9c7fd705f9114daf4adaac9fc90f040'],1,1,2,620788,1,,,,1670
13c9f899ff62be6a2eacb28e522d06703f1dab08,0,Michael Han,2018-03-25 19:19:01-07:00,['29a892907eb175adc0c6908a1fde3e7bf8d655b6'],5,0,5,620793,1,,,,1670
fbd21329d32f185d198344f2d394175c92a82f9e,0,Michael Han,2018-04-05 21:04:07-07:00,['13c9f899ff62be6a2eacb28e522d06703f1dab08'],1,18,19,620812,2,1,1,1,1670
67378512285c4b8dc9be50b90bbd2967068fc24e,0,Michael Han,2018-04-15 21:22:25-07:00,['fbd21329d32f185d198344f2d394175c92a82f9e'],1,1,2,620814,1,,,,1670
9ba4aeb4f92c1fc3167ff8e2b56e02f3e344d3ba,0,Michael Han,2018-04-15 21:29:43-07:00,['67378512285c4b8dc9be50b90bbd2967068fc24e'],6,8,14,620828,1,,,,1670
519db3f5c585f63a0a55e9f7929a07f9715bd729,0,Michael Han,2018-04-16 21:57:24-07:00,['9ba4aeb4f92c1fc3167ff8e2b56e02f3e344d3ba'],6,6,12,620840,3,,,,1670
154f9c536f7c696b774361937c6b4b08603d16cf,1,Patrick Hunt,2018-04-23 15:20:26-07:00,['519db3f5c585f63a0a55e9f7929a07f9715bd729'],74,784,858,621698,12,0.47080292,0.693430657,0.897810219,1676
cb6cae91c71b679d5bbc3fb48bf707fd1bb14493,0,Patrick Hunt,2018-04-23 17:25:44-07:00,['154f9c536f7c696b774361937c6b4b08603d16cf'],0,1,1,621699,1,,,,1676
3783ed58656f8719d7213329451f396f5c1e3dce,0,Patrick Hunt,2018-04-24 16:41:54-07:00,['cb6cae91c71b679d5bbc3fb48bf707fd1bb14493'],126,138,264,621963,4,1,0,0,1677
79627c6e07a901150709896f7c22597164badfc5,1,Patrick Hunt,2018-04-25 15:17:09-07:00,['3783ed58656f8719d7213329451f396f5c1e3dce'],81,99,180,622143,2,,,,1677
2c0168ad37b529447ac8cb1bf866d014f8a97981,0,Patrick Hunt,2018-04-26 15:21:36-07:00,['79627c6e07a901150709896f7c22597164badfc5'],1,31,32,622175,2,0,1,1,1677
5c96887643b2465caabbfd4763c7ebb3cd1aa024,0,Patrick Hunt,2018-04-27 11:28:15-07:00,['2c0168ad37b529447ac8cb1bf866d014f8a97981'],0,26,26,622201,3,1,1,1,1677
2022766ec907f63b1b43fc5455e9e7761cd332f6,0,Michael Han,2018-04-29 21:34:57-07:00,['5c96887643b2465caabbfd4763c7ebb3cd1aa024'],21,140,161,622362,2,0.153846154,0.051282051,1,1677
b1f6279a8c4708d1df7dd1128dc4fdf41fc7e24a,0,Flavio Junqueira (fpj),2018-05-09 00:54:02+02:00,['2022766ec907f63b1b43fc5455e9e7761cd332f6'],0,3,3,622365,1,0,1,1,1677
ceaeccd6e310983d37e685a9d5fff3d7e75cf125,1,Patrick Hunt,2018-05-09 14:57:41-07:00,['b1f6279a8c4708d1df7dd1128dc4fdf41fc7e24a'],57,633,690,623055,20,0.618421053,0.701754386,0.978070175,1680
43f117ef5098573d7378956358c653475a4b993e,0,Patrick Hunt,2018-05-09 15:14:18-07:00,['ceaeccd6e310983d37e685a9d5fff3d7e75cf125'],0,52,52,623107,1,0.230769231,1,1,1680
088dfdf188663f6bad79b0e87b710737b318537d,0,Alexander Shraer,2018-05-09 21:00:15-07:00,['43f117ef5098573d7378956358c653475a4b993e'],146,379,525,623632,5,0.219047619,0.980952381,1,1682
6e64125f2aafc29253904c43ee44233c907e5fca,0,Patrick Hunt,2018-05-09 21:13:16-07:00,['088dfdf188663f6bad79b0e87b710737b318537d'],13,5,18,623650,4,0,0,0,1682
2fa315b7d0ed65828479fcdcc9e76ca8552fba4a,0,Patrick Hunt,2018-05-10 13:14:24-07:00,['6e64125f2aafc29253904c43ee44233c907e5fca'],20,16,36,623686,2,1,0,0,1682
dacd27568c0a20244d40f42ff8ee84b5f917128e,0,Patrick Hunt,2018-05-16 10:30:31-07:00,['2fa315b7d0ed65828479fcdcc9e76ca8552fba4a'],1,1,2,623688,1,,,,1682
587898ac9fc2a8588971197b977ecd9c00a7221e,0,Patrick Hunt,2018-05-21 11:12:40-07:00,['dacd27568c0a20244d40f42ff8ee84b5f917128e'],2,7,9,623697,2,0.75,0.75,1,1682
ae6ee236658e8133b0f3cb950d6d4c97553b8eb7,0,Michael Han,2018-05-21 21:37:04-07:00,['587898ac9fc2a8588971197b977ecd9c00a7221e'],1,1,2,623699,1,,,,1682
24f093b9c10bcfa5f890f378087e48736ed5bac5,0,Michael Han,2018-05-22 20:34:19-07:00,['ae6ee236658e8133b0f3cb950d6d4c97553b8eb7'],15,14,29,623728,3,,,,1682
07228badc4691ca96f0d35e5aaa5ebcb2b9891cb,0,Michael Han,2018-05-22 20:42:47-07:00,['24f093b9c10bcfa5f890f378087e48736ed5bac5'],1,0,1,623729,1,,,,1682
9c4bd4d335c52beb44f303b8b6e0abfe03cb9241,0,Patrick Hunt,2018-05-29 16:27:43-07:00,['07228badc4691ca96f0d35e5aaa5ebcb2b9891cb'],72,187,259,623988,5,0.769230769,1,0.230769231,1682
fa34d0d01e33a40465ebd72497f37d62f0a4bce0,0,Patrick Hunt,2018-05-29 17:02:56-07:00,['9c4bd4d335c52beb44f303b8b6e0abfe03cb9241'],3,3,6,623994,2,,,,1682
1c3aac025528faf8c776f5b715c23c4cc58138b8,0,Patrick Hunt,2018-05-29 17:28:51-07:00,['fa34d0d01e33a40465ebd72497f37d62f0a4bce0'],4,18,22,624016,1,,,,1682
4c5674ce4ca1ca473c897bfe8d7f848227e8b706,0,Michael Han,2018-05-30 20:54:52-07:00,['1c3aac025528faf8c776f5b715c23c4cc58138b8'],1,1,2,624018,1,,,,1682
a35690cd60c1d5010454056b7011e3abbbbe9116,0,Patrick Hunt,2018-05-31 12:57:21-07:00,['4c5674ce4ca1ca473c897bfe8d7f848227e8b706'],1,66,67,624085,3,,,,1682
a2623a625a4778720f7d5482d0a66e9b37ae556f,0,Andor Molnar,2018-06-08 16:52:58+02:00,['a35690cd60c1d5010454056b7011e3abbbbe9116'],1,280,281,624366,19,0.646153846,0.784615385,0.992307692,1683
d6490d590725345638b5973a97e6e8d8bee67d22,0,Michael Han,2018-06-14 22:41:07-07:00,['a2623a625a4778720f7d5482d0a66e9b37ae556f'],9,12,21,624387,3,,,,1683
13dd5d0db7a5c4fa926d1e44fc2047c24d5d012c,0,Michael Han,2018-06-14 23:02:41-07:00,['d6490d590725345638b5973a97e6e8d8bee67d22'],1,4,5,624392,1,0,1,1,1683
2a951868bda3b7343069f9155f6404c3d9d5aa8e,0,Andor Molnar,2018-06-20 15:22:30+02:00,['13dd5d0db7a5c4fa926d1e44fc2047c24d5d012c'],1,69,70,624462,3,0,0.928571429,1,1683
1fb644662b8e0530dec2c5668a3e49b3f614e9de,0,Andor Molnar,2018-06-25 12:30:19+02:00,['2a951868bda3b7343069f9155f6404c3d9d5aa8e'],4,47,51,624513,2,0,0.897435897,1,1683
3465e0ced5edda2e1299662f6b75a1979b6bdc6e,0,Andor Molnar,2018-06-26 11:18:38+02:00,['1fb644662b8e0530dec2c5668a3e49b3f614e9de'],14,140,154,624667,9,0.80952381,0.80952381,1,1683
4607a3e156f36c52349bfb370e879dbd9e4d0691,0,Andor Molnar,2018-07-04 13:02:19+02:00,['3465e0ced5edda2e1299662f6b75a1979b6bdc6e'],1,1,2,624669,40,,,,1684
25fd549dcd4e01de073a2e25ef07c170389b28ea,0,Andor Molnar,2018-07-04 17:11:39+02:00,['4607a3e156f36c52349bfb370e879dbd9e4d0691'],4,22,26,624695,3,0.636363636,0.636363636,1,1684
b593a8de1cc48534661526685e39d812aa680d36,0,benjamin reed,2018-07-10 03:46:36-07:00,['25fd549dcd4e01de073a2e25ef07c170389b28ea'],6,58,64,624759,2,0,0.828571429,1,1684
5d187ff0adc836e6d18fd4c78188f52cdbb56c25,0,benjamin reed,2018-07-10 03:50:07-07:00,['b593a8de1cc48534661526685e39d812aa680d36'],1,1,2,624761,1,,,,1684
32e4a1676656df57f9c73a249cb88bed5cb927ee,0,benjamin reed,2018-07-10 03:58:32-07:00,['5d187ff0adc836e6d18fd4c78188f52cdbb56c25'],22,0,22,624783,1,,,,1684
5fdd70ac49c7a5334bdcae309719ac4ada352dde,0,benjamin reed,2018-07-10 04:29:20-07:00,['32e4a1676656df57f9c73a249cb88bed5cb927ee'],13,13,26,624809,11,,,,1684
c2e7ed1e6f8f2de48778db7f3d63f9629c086ea8,1,Michael Han,2018-07-10 21:04:17-07:00,['5fdd70ac49c7a5334bdcae309719ac4ada352dde'],49,58,107,624916,1,0,0,1,1684
328b9de0152f987429534c8adcb2ce2866c5733e,1,Patrick Hunt,2018-07-11 16:35:55-07:00,['c2e7ed1e6f8f2de48778db7f3d63f9629c086ea8'],199,368,567,625483,42,1,1,1,1686
536dda2c48cb76829a738377c1ef2b2a976804ab,0,Andor Molnar,2018-07-13 12:47:39+02:00,['328b9de0152f987429534c8adcb2ce2866c5733e'],0,7,7,625490,1,,,,1686
28de451aa8b45e94d1261d5e0e369f86bf3815da,0,Andor Molnar,2018-07-13 14:58:03+02:00,['536dda2c48cb76829a738377c1ef2b2a976804ab'],10,11,21,625511,54,,,,1686
0a311873deb1847703c9b62716c626ce43d4ba48,0,Michael Han,2018-07-15 20:45:45-07:00,['28de451aa8b45e94d1261d5e0e369f86bf3815da'],80,527,607,626118,4,0.356877323,1,0.959107807,1686
cea251a185435e88f54efc5defb92ec9584fc80f,1,Andor Molnar,2018-07-17 10:41:24+02:00,['0a311873deb1847703c9b62716c626ce43d4ba48'],5,31,36,626154,1,0.863636364,0.909090909,1,1686
81b51554922d4cee5dde4a848a106f286f4c407b,0,Andor Molnar,2018-07-18 15:49:21+02:00,['cea251a185435e88f54efc5defb92ec9584fc80f'],4,4,8,626162,1,,,,1686
f6bba09481dffc7db1d47be732d3cc8067603767,1,Michael Han,2018-07-18 20:59:14-07:00,['81b51554922d4cee5dde4a848a106f286f4c407b'],20,27,47,626209,5,0,0,1,1686
25035f10ec188a2f3d5c29dbda4b84391eee267d,0,Patrick Hunt,2018-07-19 09:58:49-07:00,['f6bba09481dffc7db1d47be732d3cc8067603767'],1,1,2,626211,1,,,,1686
fc9c9fc3b2c24f78c90bd4c7b717e3410afd5e58,0,Patrick Hunt,2018-07-19 10:14:59-07:00,['25035f10ec188a2f3d5c29dbda4b84391eee267d'],1,1,2,626213,1,,,,1686
4c12f75a9dd546032eafb2d2840061399c2a6a5e,0,Patrick Hunt,2018-07-19 10:28:38-07:00,['fc9c9fc3b2c24f78c90bd4c7b717e3410afd5e58'],4,10,14,626227,1,,,,1686
ed4689fbf81c56f09be26cf32ede66ad191f4aed,0,Andor Molnar,2018-07-20 17:40:42+02:00,['4c12f75a9dd546032eafb2d2840061399c2a6a5e'],20,35,55,626282,2,0.636363636,1,1,1686
75c652f45090f5309060ab7defb37f337d327d2c,0,Michael Han,2018-07-26 20:13:22-07:00,['ed4689fbf81c56f09be26cf32ede66ad191f4aed'],9,2,11,626293,1,0.857142857,0,0,1686
9f82798415351a20136ceb1640b1781723e51cc1,0,Michael Han,2018-07-26 20:16:04-07:00,['75c652f45090f5309060ab7defb37f337d327d2c'],13,311,324,626617,6,0.438709677,0.690322581,0.774193548,1687
7b7c6587733dba3c9f3862a034b354d067e0dc47,0,Michael Han,2018-07-26 20:28:37-07:00,['9f82798415351a20136ceb1640b1781723e51cc1'],0,3,3,626620,1,1,1,1,1687
ba8932dccb227b5b52de98e33c46054014f951b7,1,Andor Molnar,2018-07-27 12:32:45+02:00,['7b7c6587733dba3c9f3862a034b354d067e0dc47'],69,258,327,626947,10,0.818181818,0.893939394,1,1690
01132edbd4df3df4472a2f8d3077fe585035cce1,0,Andor Molnar,2018-07-27 12:40:33+02:00,['ba8932dccb227b5b52de98e33c46054014f951b7'],3,70,73,627020,5,1,1,1,1691
726587ef50339f071960d153cc4599882aa71ac7,0,Benjamin Reed,2018-07-27 19:30:06-07:00,['01132edbd4df3df4472a2f8d3077fe585035cce1'],1,8,9,627029,1,0,0,0,1691
2a372fcdce3c0142c0bb23f06098a2c1a49f807e,0,Benjamin Reed,2018-07-27 19:37:08-07:00,['726587ef50339f071960d153cc4599882aa71ac7'],16,14,30,627059,1,1,1,0,1691
932fee861001c158343c0bc64dbe80f253f0bb6d,0,Benjamin Reed,2018-07-27 19:46:31-07:00,['2a372fcdce3c0142c0bb23f06098a2c1a49f807e'],4,20,24,627083,3,1,1,1,1691
78e4a1047c701006dd4ec8d09065eda0e7adedb5,0,Michael Han,2018-07-29 21:22:23-07:00,['932fee861001c158343c0bc64dbe80f253f0bb6d'],6,112,118,627201,2,0,1,0.583333333,1692
7cf8035c3a5ca05bce2d183b41bf410709a5f6ee,0,Patrick Hunt,2018-08-01 12:19:34-07:00,['78e4a1047c701006dd4ec8d09065eda0e7adedb5'],3,6,9,627210,2,,,,1692
148c2cd6ba73e66b1879a2e10ecda4ce4e0e2c7b,0,Benjamin Reed,2018-08-03 09:52:08-07:00,['7cf8035c3a5ca05bce2d183b41bf410709a5f6ee'],134,443,577,627787,3,0.113300493,0.359605911,0.980295567,1692
e3bae03d20f5d722957897bc1bc97ebeeae5e982,0,Andor Molnar,2018-08-06 10:47:35+02:00,['148c2cd6ba73e66b1879a2e10ecda4ce4e0e2c7b'],1,18,19,627806,1,,,,1692
44d2736124f2292ca167b199df7f0d2373be9310,1,Andor Molnar,2018-08-06 14:11:08+02:00,['e3bae03d20f5d722957897bc1bc97ebeeae5e982'],55,144,199,628005,23,1,1,1,1692
b0df8fe1e10e63aa2b268e126d109cc61ea2d33c,1,Andor Molnar,2018-08-06 14:13:17+02:00,['44d2736124f2292ca167b199df7f0d2373be9310'],36,62,98,628103,327,,,,1692
cd209456b67cde5aba771b1a240ebe5607398459,0,Michael Han,2018-08-07 21:21:37-07:00,['b0df8fe1e10e63aa2b268e126d109cc61ea2d33c'],159,497,656,628759,16,0.350877193,0.538011696,1,1693
df2b3f4fd9944f0dd544b808ea3bad702534625d,0,Michael Han,2018-08-07 21:29:16-07:00,['cd209456b67cde5aba771b1a240ebe5607398459'],3,0,3,628762,1,1,1,1,1693
82776922af9a0931e8053c0b93b82311e0f0b4b3,0,Andor Molnar,2018-08-14 14:33:45+02:00,['df2b3f4fd9944f0dd544b808ea3bad702534625d'],0,300,300,629062,6,1,1,1,1699
b5d6786b9531240dadc369344098a001430e32b7,0,Andor Molnar,2018-08-17 10:34:02+02:00,['82776922af9a0931e8053c0b93b82311e0f0b4b3'],0,1,1,629063,1,,,,1699
2584625cdf4bb917192479f637222d6e64518336,0,Andor Molnar,2018-08-17 11:56:09+02:00,['b5d6786b9531240dadc369344098a001430e32b7'],28,36,64,629127,49,,,,1699
290f1fc4b907c7d51ec81985e87ef46b8528b8f7,0,Andor Molnar,2018-08-17 14:40:02+02:00,['2584625cdf4bb917192479f637222d6e64518336'],7,29,36,629163,5,1,1,1,1699
176bd68222f3a3bddac9deb412eee7f538cb01ca,1,Andor Molnar,2018-08-21 07:30:53+02:00,['290f1fc4b907c7d51ec81985e87ef46b8528b8f7'],54,56,110,629273,81,,,,1699
4d7b9e8f34775261fed517d232094f0247a4d3cf,1,Michael Han,2018-08-28 21:26:58-07:00,['176bd68222f3a3bddac9deb412eee7f538cb01ca'],74,280,354,629627,5,0.427350427,0.564102564,0.623931624,1699
b7181d2c5a48accbd47e30430ccfe1291a91d900,0,Andor Molnar,2018-09-03 11:57:50+02:00,['4d7b9e8f34775261fed517d232094f0247a4d3cf'],7,28,35,629662,39,,,,1699
687ea7e7cecf1449687e05819502be28cb49cb66,0,Andor Molnar,2018-09-04 11:54:23+02:00,['b7181d2c5a48accbd47e30430ccfe1291a91d900'],12,51,63,629725,6,0.75,0.8,0.9,1699
e7ac12c952b47921bfecbad52112be51f5b9ede5,0,Andor Molnar,2018-09-05 16:15:58+02:00,['687ea7e7cecf1449687e05819502be28cb49cb66'],1,17,18,629743,1,0.5,1,0.5,1699
e501d9cc67fbaa6e825292fd838711259b6c9789,1,Michael Han,2018-09-05 13:35:38-07:00,['e7ac12c952b47921bfecbad52112be51f5b9ede5'],20,260,280,630023,4,0.390243902,0.658536585,0,1700
0b65e3d4cbb7647ea692bfea59c02e5b24bf821c,0,Michael Han,2018-09-05 16:11:01-07:00,['e501d9cc67fbaa6e825292fd838711259b6c9789'],1,1,2,630025,1,,,,1700
95557a30edbdfdf4479a1cb142e0d82a4ba6061d,0,Michael Han,2018-09-06 17:34:55-07:00,['0b65e3d4cbb7647ea692bfea59c02e5b24bf821c'],9,18,27,630052,2,0,0.5,1,1700
27db6bd28e3297cdafe19c204b42c3db20c45ad6,0,Michael Han,2018-09-06 17:49:10-07:00,['95557a30edbdfdf4479a1cb142e0d82a4ba6061d'],0,4,4,630056,1,0,0,0,1700
181de25c0dc703eaff77dd6415b676f09564277a,0,Andor Molnar,2018-09-10 11:44:50+02:00,['27db6bd28e3297cdafe19c204b42c3db20c45ad6'],2,2,4,630060,2,,,,1700
4ad2341c18020ecb08e7e26b79cacc3569b9d31e,0,Michael Han,2018-09-10 15:17:45-07:00,['181de25c0dc703eaff77dd6415b676f09564277a'],3,42,45,630105,3,0.36,1,1,1700
ef8b5ab263270e41504dddc5fcc8c6b3419e5b4b,0,Andor Molnar,2018-09-11 15:23:32+02:00,['4ad2341c18020ecb08e7e26b79cacc3569b9d31e'],3,950,953,631058,11,0.239786856,0.920071048,1,1703
6651a126cd85ced8b26786875b81be140ad97c80,1,Andor Molnar,2018-09-12 13:29:13+02:00,['ef8b5ab263270e41504dddc5fcc8c6b3419e5b4b'],8,142,150,631208,2,0.289473684,0.973684211,0.539473684,1703
14870ddd4b87afe3af497ec0569ce439c0488053,1,Andor Molnar,2018-09-12 13:32:07+02:00,['6651a126cd85ced8b26786875b81be140ad97c80'],3,43,46,631254,2,0,0.034482759,1,1703
71630081262f4b05e6a86beb7c0c10924e2f04d3,0,Michael Han,2018-09-14 15:03:48-07:00,['14870ddd4b87afe3af497ec0569ce439c0488053'],8,347,355,631609,4,0.261083744,0.566502463,0.645320197,1705
b58791016424e662c816e2253de96f3771f5d301,1,Michael Han,2018-09-14 15:08:19-07:00,['71630081262f4b05e6a86beb7c0c10924e2f04d3'],14,103,117,631726,2,0,1,1,1705
657e2e832ee31738d70d54a046d4254f3ed8267a,0,Michael Han,2018-09-14 16:09:36-07:00,['b58791016424e662c816e2253de96f3771f5d301'],34,150,184,631910,3,0,0,0.380434783,1705
f4cbb689ad7bb03ca6da0d5de3ecb344165f379a,0,Michael Han,2018-09-17 16:00:15-07:00,['657e2e832ee31738d70d54a046d4254f3ed8267a'],86,623,709,632619,24,0.766666667,0.945833333,0.9625,1710
e116d32b63039fe9f0677f0af76c0a77fe74c82b,1,Michael Han,2018-09-21 21:43:45-07:00,['f4cbb689ad7bb03ca6da0d5de3ecb344165f379a'],0,34,34,632653,2,0.15,0.95,1,1710
4ebb847bceb5ebd5c9fa53574f266c204f6f8ab7,0,Michael Han,2018-09-21 21:48:13-07:00,['e116d32b63039fe9f0677f0af76c0a77fe74c82b'],1,36,37,632690,2,0.166666667,1,1,1710
fdde8b006458f7b989c894af0eac7e124d271a1e,0,Michael Han,2018-09-28 14:38:24-07:00,['4ebb847bceb5ebd5c9fa53574f266c204f6f8ab7'],78,2583,2661,635351,33,0.519527702,0.801998183,0.933696639,1726
a8cf62678131626b778d0572290d582f70a2cbfc,0,Michael Han,2018-09-30 21:11:18-07:00,['fdde8b006458f7b989c894af0eac7e124d271a1e'],3,8,11,635362,2,0,0,1,1726
78f8b814d2855430b7917dffb5c989195cdb2630,0,Andor Molnar,2018-10-04 15:46:28+02:00,['a8cf62678131626b778d0572290d582f70a2cbfc'],5,49,54,635416,2,0,0,1,1726
faa7cec71fddfb959a7d67923acffdb67d93c953,1,Andor Molnar,2018-10-05 14:25:43+02:00,['78f8b814d2855430b7917dffb5c989195cdb2630'],91,902,993,636409,605,0.823321555,0.77385159,0.879858657,1733
d6a12a80babf1e226cb56695bbc5479ea4f92c78,1,Andor Molnar,2018-10-05 15:02:33+02:00,['faa7cec71fddfb959a7d67923acffdb67d93c953'],0,9966,9966,646375,49,0.861138861,0.835164835,0.915084915,1782
effa016c621aea5debd640181b3e07b86fc14e0d,1,Andor Molnar,2018-10-08 14:33:38+02:00,['d6a12a80babf1e226cb56695bbc5479ea4f92c78'],30,89,119,646494,6,0.760869565,0.891304348,1,1782
00c4c11853460923bdc9f3e4618382391d7b713c,1,Andor Molnar,2018-10-08 14:42:09+02:00,['effa016c621aea5debd640181b3e07b86fc14e0d'],0,1,1,646495,1,0,1,1,1782
ee250f141678f79e9517bfc8913956199fad55bb,0,Andor Molnar,2018-10-12 10:25:27+02:00,['00c4c11853460923bdc9f3e4618382391d7b713c'],150,144,294,646789,3,0,0,0,1782
6285f332a78f62272114b0f21e74b559974326ef,0,Andor Molnar,2018-10-12 10:28:29+02:00,['ee250f141678f79e9517bfc8913956199fad55bb'],8,0,8,646797,1,1,1,0,1782
e92fdfefb86df24d9ef6e68be827e21f55b1c971,1,Andor Molnar,2018-10-15 16:45:25+02:00,['6285f332a78f62272114b0f21e74b559974326ef'],11,283,294,647091,7,,,,1783
7b679bc9dd98f06ee10bbb0978cfee5dab7b74dc,1,Andor Molnar,2018-10-16 16:22:07+02:00,['e92fdfefb86df24d9ef6e68be827e21f55b1c971'],220,2918,3138,650229,35,0.528043776,0.756497948,0.879616963,1795
5c85a236c9eb0805ea8389a52dab3b1bc0efadac,0,Andor Molnar,2018-10-18 11:18:25+02:00,['7b679bc9dd98f06ee10bbb0978cfee5dab7b74dc'],6,33,39,650268,2,1,1,1,1795
cb9f303bda9137d1aebe8eff3eab85c8a59f3cdd,0,Andor Molnar,2018-10-19 14:39:50+02:00,['5c85a236c9eb0805ea8389a52dab3b1bc0efadac'],164,47,211,650479,280,,,,1795
1ce2ca8107438d283581d18d064a25bd6b74adf7,0,Michael Han,2018-10-23 19:03:01-07:00,['cb9f303bda9137d1aebe8eff3eab85c8a59f3cdd'],45,36,81,650560,4,1,0,0,1795
05d4d437d808f6cdf4c9dc5419a6e8d635c2ba5d,0,Fangmin Lyu,2018-11-04 23:45:40-08:00,['1ce2ca8107438d283581d18d064a25bd6b74adf7'],51,34,85,650645,1,1,0,0,1795
83fd6e298dda420125f8be35fda68cb226b0ee05,0,Andor Molnar,2018-11-05 10:40:55-08:00,['05d4d437d808f6cdf4c9dc5419a6e8d635c2ba5d'],9,214,223,650868,4,0.659090909,0.659090909,1,1797
e5fc1228104410728646982eff84d4fb21b361ca,0,Andor Molnar,2018-11-06 09:50:15-08:00,['83fd6e298dda420125f8be35fda68cb226b0ee05'],33100,45,33145,684013,157,0.199166667,0.175833333,0.080833333,1797
03286f29d29f4c1d3496ce87d1441df91422220e,0,Andor Molnar,2018-11-06 17:29:49-08:00,['e5fc1228104410728646982eff84d4fb21b361ca'],231,2676,2907,686920,21,0.727427598,1,0.765758092,1813
477fa0724fa66cc41d14e8a974ab4ac2a1b68433,0,Andor Molnar,2018-11-07 15:54:43-08:00,['03286f29d29f4c1d3496ce87d1441df91422220e'],26,47,73,686993,6,0,0,0.4,1813
fe25fed9390a159b24f4c4fa31e3a7911f2c3b81,0,Andor Molnar,2018-11-12 13:36:32-08:00,['477fa0724fa66cc41d14e8a974ab4ac2a1b68433'],2,197,199,687192,3,0.247058824,0.917647059,1,1813
db074423f09026446640242ecfcf26310467b1fa,0,Michael Han,2018-11-17 09:33:40-08:00,['fe25fed9390a159b24f4c4fa31e3a7911f2c3b81'],102,85,187,687379,8,0.4,0.15,0.4,1813
91460546a14c03d211d4126864c81a1b2dde2394,0,Michael Han,2018-11-17 09:37:08-08:00,['db074423f09026446640242ecfcf26310467b1fa'],8,8,16,687395,6,,,,1813
1507f67a06175155003722297daeb60bc912af1d,1,Michael Han,2018-11-21 08:56:08-08:00,['91460546a14c03d211d4126864c81a1b2dde2394'],13,28,41,687436,3,1,1,1,1813
caca062767c36525e6ecead2ae0f34c447394809,1,Andor Molnar,2018-11-22 17:56:01+01:00,['1507f67a06175155003722297daeb60bc912af1d'],519,1126,1645,689081,17,0.616724739,0.944250871,0.982578397,1816
c3babb94275ad667dc71c10dcb08a383a3c154c2,0,Andor Molnar,2018-11-23 11:51:32+01:00,['caca062767c36525e6ecead2ae0f34c447394809'],7,83,90,689171,2,0.741935484,0.741935484,1,1817
1c488cec08809a76202f6c66be9e46533e7c409c,0,Andor Molnar,2018-11-27 09:55:53+01:00,['c3babb94275ad667dc71c10dcb08a383a3c154c2'],112,32,144,689315,2,0,0,0,1817
91c6cb253c98a5c792314b1c7998ab5b939dddad,1,Andor Molnar,2018-11-27 09:57:53+01:00,['1c488cec08809a76202f6c66be9e46533e7c409c'],5,9,14,689329,2,0,1,1,1817
64104eaeaa6508f052edfd39c24243a8e26039dc,1,Andor Molnar,2018-11-27 10:02:24+01:00,['91c6cb253c98a5c792314b1c7998ab5b939dddad'],157,1794,1951,691280,13,0.590254707,1,0.915836102,1818
a109b8b5034a160c3ad0f4d2b790df962ff4dc47,0,Andor Molnar,2018-11-27 21:04:31+01:00,['64104eaeaa6508f052edfd39c24243a8e26039dc'],1,1,2,691282,1,,,,1818
061e76123e91db4b9c28ab77e58df1b723df00d9,0,Fangmin Lyu,2018-11-28 14:43:41-08:00,['a109b8b5034a160c3ad0f4d2b790df962ff4dc47'],5,11,16,691298,1,0.8,0,1,1818
b7403b790ff8729f817680afcdef38cb98b87720,0,Andor Molnar,2018-12-06 10:56:21+01:00,['061e76123e91db4b9c28ab77e58df1b723df00d9'],40,228,268,691566,4,0.4625,0.7375,1,1819
6ea3c0b6897ec3a833f5b86fe8612bc9b2ac672c,0,Andor Molnar,2018-12-07 12:41:50+01:00,['b7403b790ff8729f817680afcdef38cb98b87720'],73,129,202,691768,3,0,0,0.56,1819
b2513c114931dc377bac5e1d39e2f81c6e8cf17e,1,Fangmin Lyu,2018-12-08 18:16:58-08:00,['6ea3c0b6897ec3a833f5b86fe8612bc9b2ac672c'],385,2459,2844,694612,30,0.449682684,0.519492294,1,1825
b1fd480b2c8e0cc1429345ee04510d3849001c5c,0,Andor Molnar,2018-12-10 15:28:57+01:00,['b2513c114931dc377bac5e1d39e2f81c6e8cf17e'],1,84,85,694697,2,0.19047619,1,0.904761905,1825
a5ffb4c8dd49d1d6b03904d457eea62a3009c91a,0,Andor Molnar,2018-12-11 14:03:37+01:00,['b1fd480b2c8e0cc1429345ee04510d3849001c5c'],692,0,692,695389,7,0.176678445,0.22614841,0.120141343,1825
46fc819622bf08cbd0781dea279aff734b492902,0,Andor Molnar,2018-12-11 14:06:45+01:00,['a5ffb4c8dd49d1d6b03904d457eea62a3009c91a'],130,0,130,695519,1,,,,1825
e043c322f12d56da0fc88131628edf0731c0f8e4,1,Andor Molnar,2018-12-15 07:34:54+01:00,['46fc819622bf08cbd0781dea279aff734b492902'],106,760,866,696385,20,0.212264151,0.863207547,0.995283019,1827
05b774a1b05374618300f657c9c91b0d5c6ddf71,1,Andor Molnar,2018-12-20 07:24:17+01:00,['e043c322f12d56da0fc88131628edf0731c0f8e4'],21,948,969,697354,23,0,0,1,1832
b8c8937029ca7e15116e91c6a6c436368ac0f9bb,0,Fangmin Lyu,2018-12-20 22:07:14+08:00,['05b774a1b05374618300f657c9c91b0d5c6ddf71'],16,30,46,697400,1,0,1,1,1832
678138b84a433cc0aaf51388f086743aa84f3480,0,Fangmin Lyu,2018-12-20 22:13:46+08:00,['b8c8937029ca7e15116e91c6a6c436368ac0f9bb'],3,59,62,697462,5,1,1,1,1832
db53d02869faa7c9819689315daa3933125c89a8,0,Fangmin Lyu,2018-12-20 22:17:52+08:00,['678138b84a433cc0aaf51388f086743aa84f3480'],1,31,32,697494,2,0,0.904761905,1,1832
4212a5a4db4b46ad6da8ded59aa3533f852d1aad,0,Patrick Hunt,2018-12-22 17:57:36-08:00,['db53d02869faa7c9819689315daa3933125c89a8'],0,2,2,697496,1,,,,1832
2a3800f00f4c14dde97c42a54806ba3485f27183,0,Andor Molnar,2019-01-02 13:41:06+01:00,['4212a5a4db4b46ad6da8ded59aa3533f852d1aad'],1,1,2,697498,1,,,,1832
f4667d6fdf6e29ed7ec3c3ea18e0f4cd956cd360,0,Fangmin Lyu,2019-01-02 22:10:02+08:00,['2a3800f00f4c14dde97c42a54806ba3485f27183'],4,440,444,697942,7,0.92139738,1,0.92139738,1837
21c5611224de64deb2d01c51e36271adac33b40d,0,Andor Molnar,2019-01-02 15:27:05+01:00,['f4667d6fdf6e29ed7ec3c3ea18e0f4cd956cd360'],124,130,254,698196,3,,,,1837
95654e5543679b34b27d253b6d509e380a7dfc70,0,Andor Molnar,2019-01-02 15:32:18+01:00,['21c5611224de64deb2d01c51e36271adac33b40d'],18,705,723,698919,32,,,,1845
50aeb922a48ed07e48719f4def331b6ed4fcb4fb,0,Andor Molnar,2019-01-03 11:23:36+01:00,['95654e5543679b34b27d253b6d509e380a7dfc70'],4,4,8,698927,1,,,,1845
f644f3d63e3d1efd3a977b2f4621734dfe617f31,0,Andor Molnar,2019-01-03 15:57:39+01:00,['50aeb922a48ed07e48719f4def331b6ed4fcb4fb'],11,4,15,698942,1,1,0,0,1845
4a8fda7031d68236441b13bd878936b2607c5244,0,Andor Molnar,2019-01-03 16:32:46+01:00,['f644f3d63e3d1efd3a977b2f4621734dfe617f31'],0,26,26,698968,2,,,,1846
b752ef66876a141035a42f30aad69e3166cad746,0,Andor Molnar,2019-01-07 14:24:07+01:00,['4a8fda7031d68236441b13bd878936b2607c5244'],4,84,88,699056,16,0,1,1,1847
bc992480ec938a3fad4b90f75a52dd186e1b968a,0,Andor Molnar,2019-01-07 14:39:13+01:00,['b752ef66876a141035a42f30aad69e3166cad746'],27,36,63,699119,13,0.5,1,1,1847
9e309557c02315344d6b39012ff4c9633b54c3d3,0,Andor Molnar,2019-01-07 14:55:43+01:00,['bc992480ec938a3fad4b90f75a52dd186e1b968a'],2,54,56,699175,6,0.153846154,0.974358974,1,1847
36b8711ebfd7ea749d547a52ddcd7d8853931728,0,Andor Molnar,2019-01-07 15:34:02+01:00,['9e309557c02315344d6b39012ff4c9633b54c3d3'],2,4,6,699181,1,,,,1847
c358dce653874ae4b97ce26629e3ddba00c8b669,0,Andor Molnar,2019-01-08 17:21:00+01:00,['36b8711ebfd7ea749d547a52ddcd7d8853931728'],1,1,2,699183,1,,,,1847
a5b3114d70d03f70b068b209fe393388f3c77991,0,Andor Molnar,2019-01-09 15:09:14+01:00,['c358dce653874ae4b97ce26629e3ddba00c8b669'],0,2,2,699185,1,1,1,1,1847
14eefcb7bbd1cc93d4738998ca7343cd9cae8277,0,Andor Molnar,2019-01-14 07:36:15-07:00,['a5b3114d70d03f70b068b209fe393388f3c77991'],0,4,4,699189,1,0,1,1,1847
9828685d20bc99272ec0689a590d27b0f8f7ebb6,1,Andor Molnar,2019-01-14 11:38:53-07:00,['14eefcb7bbd1cc93d4738998ca7343cd9cae8277'],58,451,509,699698,14,0.469387755,0.479591837,1,1849
38fab85ab476ffea3dd9668eac6fd6e09a190a09,0,Andor Molnar,2019-01-14 11:40:19-07:00,['9828685d20bc99272ec0689a590d27b0f8f7ebb6'],1,109,110,699808,2,0.315068493,1,1,1849
d149b134049dc8527ba81a9546836942fcabc5b6,1,Andor Molnar,2019-01-14 11:43:00-07:00,['38fab85ab476ffea3dd9668eac6fd6e09a190a09'],1,123,124,699932,4,0.84375,0.84375,1,1850
b66802ef2f24181a3967152782d1cc8bb7886f35,0,Andor Molnar,2019-01-14 16:42:39-07:00,['d149b134049dc8527ba81a9546836942fcabc5b6'],1,3,4,699936,1,,,,1850
2eb8dd0baf91a1a7c09d76f22ff658009898ca0b,0,Andor Molnar,2019-01-16 06:21:28-07:00,['b66802ef2f24181a3967152782d1cc8bb7886f35'],4,460,464,700400,14,0.368821293,0.604562738,0.965779468,1852
ed4fad3c1af9b15f2c54ccd91f7c09a913c23c40,0,Andor Molnar,2019-01-16 15:23:04-07:00,['2eb8dd0baf91a1a7c09d76f22ff658009898ca0b'],3,3,6,700406,1,,,,1852
0b504dec95b09acb05b40505588f7cda8131fea6,0,Fangmin Lyu,2019-01-18 10:42:12+08:00,['ed4fad3c1af9b15f2c54ccd91f7c09a913c23c40'],2,47,49,700455,2,,,,1852
fd465ebf5380319b0ec9415ab832b01046e131ff,0,Fangmin Lyu,2019-01-18 10:49:12+08:00,['0b504dec95b09acb05b40505588f7cda8131fea6'],10,6,16,700471,1,0,0,0,1852
8b82c2694dc31238b04345a7bd95c6a7fb62c7f8,0,Andor Molnar,2019-01-22 06:43:44+01:00,['fd465ebf5380319b0ec9415ab832b01046e131ff'],64,109,173,700644,11,0,1,1,1852
668828503389f3e542b846019bace8b9842fa428,1,Andor Molnar,2019-01-23 14:00:13+01:00,['8b82c2694dc31238b04345a7bd95c6a7fb62c7f8'],5,666,671,701315,14,0.570909091,0.658181818,1,1855
0f44fd9629704e32cc9719eb26d14ecf11e61e90,0,Andor Molnar,2019-01-24 11:53:00+01:00,['668828503389f3e542b846019bace8b9842fa428'],81,345,426,701741,4,0.605633803,0.626760563,0.943661972,1856
045833b795a7041607337b192fa3dbcf2cc3f291,0,Andor Molnar,2019-01-25 14:32:24+01:00,['0f44fd9629704e32cc9719eb26d14ecf11e61e90'],4,63,67,701808,3,0.522727273,1,1,1856
3583bbf0f89861a20c23cb417a1fd93daf12a1e1,0,Andor Molnar,2019-01-25 14:37:30+01:00,['045833b795a7041607337b192fa3dbcf2cc3f291'],9,31,40,701848,1,1,1,1,1856
6094efde6a043462b464be7d93a541176a220b2f,0,Andor Molnar,2019-01-29 15:14:18+01:00,['3583bbf0f89861a20c23cb417a1fd93daf12a1e1'],1,1,2,701850,1,,,,1856
f40510534c34e6c239eb97a052caf54650593d4e,0,Andor Molnar,2019-01-29 15:17:46+01:00,['6094efde6a043462b464be7d93a541176a220b2f'],2,18,20,701870,2,,,,1856
22e4acc802904231d537ae18f479cfc729851d87,0,Andor Molnar,2019-01-29 15:57:36+01:00,['f40510534c34e6c239eb97a052caf54650593d4e'],5,5,10,701880,2,,,,1856
693b92e8615c3559f4f08032b94928447fa43e98,0,Andor Molnar,2019-01-29 16:08:22+01:00,['22e4acc802904231d537ae18f479cfc729851d87'],1,1,2,701882,1,,,,1856
de7b87cd69dfd38787270c71f00576f9a235e582,0,Andor Molnar,2019-01-29 16:31:58+01:00,['693b92e8615c3559f4f08032b94928447fa43e98'],10,13,23,701905,3,1,1,1,1856
bcbf64884f2ee3e8a150b0b3c20a8fa03a05162e,0,Andor Molnar,2019-01-30 11:43:37+01:00,['de7b87cd69dfd38787270c71f00576f9a235e582'],13,10,23,701928,3,0,0,0,1856
bc24f7c01a7060267c99ef3201fbe96be9a12835,0,Andor Molnar,2019-01-30 16:28:55+01:00,['bcbf64884f2ee3e8a150b0b3c20a8fa03a05162e'],2,25,27,701955,2,0.875,0.875,0.875,1856
3302031ee6040fbcbb8f0c54eb37e5e161c7afd2,0,Andor Molnar,2019-01-30 16:43:22+01:00,['bc24f7c01a7060267c99ef3201fbe96be9a12835'],11,593,604,702559,11,0.780141844,1,1,1862
29f95b18d9539c3f8932fee31798ca7332cb2ec6,0,Andor Molnar,2019-01-30 17:02:39+01:00,['3302031ee6040fbcbb8f0c54eb37e5e161c7afd2'],54,16,70,702629,1,1,0,0,1862
4a85ce2dc31cba45f8cb961721c9eb66e1237ef4,0,Andor Molnar,2019-01-31 11:47:58+01:00,['29f95b18d9539c3f8932fee31798ca7332cb2ec6'],0,16,16,702645,2,,,,1862
e1e69b986e6263c594042ab6288c5d6384babc6e,0,Andor Molnar,2019-01-31 14:18:06+01:00,['4a85ce2dc31cba45f8cb961721c9eb66e1237ef4'],1,1,2,702647,1,,,,1862
cbc63dbaad14fa22e8855bfdaa71c873e0796591,0,Andor Molnar,2019-01-31 15:50:59+01:00,['e1e69b986e6263c594042ab6288c5d6384babc6e'],13,9,22,702669,4,1,1,0,1862
8f62ee9740c9cdd0e4e3ec5c6d906236fe35a003,0,Andor Molnar,2019-01-31 15:55:07+01:00,['cbc63dbaad14fa22e8855bfdaa71c873e0796591'],29,21,50,702719,15,1,1,0,1862
97e51a41ae7b9e30d76d33b6d2d91c5ab15167f2,1,Patrick Hunt,2019-02-02 10:59:45-08:00,['8f62ee9740c9cdd0e4e3ec5c6d906236fe35a003'],4,17,21,702740,3,,,,1862
190df6abd661dfd5b07bc0657b6f8b0b14f86a8c,0,Andor Molnar,2019-02-04 17:08:49+01:00,['97e51a41ae7b9e30d76d33b6d2d91c5ab15167f2'],2,3,5,702745,1,,,,1862
f0f75d81087a2140e7f150bbb45a9fcec3d6644b,0,Andor Molnar,2019-02-06 09:46:37+01:00,['190df6abd661dfd5b07bc0657b6f8b0b14f86a8c'],7,37,44,702789,4,0.136363636,1,1,1862
af741cb319d4760cfab1cd3b560635adacd8deca,0,Andor Molnar,2019-02-06 12:36:37+01:00,['f0f75d81087a2140e7f150bbb45a9fcec3d6644b'],5,274,279,703068,3,0.237037037,0.822222222,1,1863
1718f1d4ad64ba9027ad148557e9f2443a9bad72,0,Andor Molnar,2019-02-07 11:12:44+01:00,['af741cb319d4760cfab1cd3b560635adacd8deca'],0,24,24,703092,1,,,,1864
f78cbd17bfb5ad6310afc50181ca56bc10b78aa7,0,Andor Molnar,2019-02-07 11:15:16+01:00,['1718f1d4ad64ba9027ad148557e9f2443a9bad72'],8,6,14,703106,1,,,,1864
8a2a1b5bced7810b9205d111181c8ae796670955,0,Andor Molnar,2019-02-07 11:20:05+01:00,['f78cbd17bfb5ad6310afc50181ca56bc10b78aa7'],1,1,2,703108,1,,,,1864
c418b4456794b3ee7fdb7adfb60a91e36345fa20,0,Andor Molnar,2019-02-07 11:22:55+01:00,['8a2a1b5bced7810b9205d111181c8ae796670955'],10,10,20,703128,1,0,0,1,1864
bd09fda553cf9b9334039a7b3bd9dbc7bab70602,0,Andor Molnar,2019-02-07 11:26:08+01:00,['c418b4456794b3ee7fdb7adfb60a91e36345fa20'],1,339,340,703468,16,0.488235294,0.788235294,0.935294118,1866
100c69233b75a9e484c546c450025c46c37d16fb,1,Andor Molnar,2019-02-11 12:34:42+01:00,['bd09fda553cf9b9334039a7b3bd9dbc7bab70602'],107,470,577,704045,12,,,,1867
c2b63926c1249c454319bffe15a7b9f340e0526f,0,Andor Molnar,2019-02-12 15:25:17+01:00,['100c69233b75a9e484c546c450025c46c37d16fb'],46,176,222,704267,5,0.12962963,0.240740741,1,1867
fa05ddf1de8b93ff492063b0299f9fc482a7dde9,0,Andor Molnar,2019-02-12 15:28:16+01:00,['c2b63926c1249c454319bffe15a7b9f340e0526f'],15,16,31,704298,1,,,,1867
af8ba12ab040e0f38679457a1ad93cd9e9251e71,0,Andor Molnar,2019-02-12 15:29:53+01:00,['fa05ddf1de8b93ff492063b0299f9fc482a7dde9'],2,2,4,704302,1,,,,1867
bc5083f85a72837d9cf5b32b82eecc6d0c06a35c,0,Andor Molnar,2019-02-12 15:31:55+01:00,['af8ba12ab040e0f38679457a1ad93cd9e9251e71'],1,1,2,704304,1,,,,1867
f3f7c79bb1fd4c03d557948199cd1ce363668bfa,0,Andor Molnar,2019-02-12 21:01:41+01:00,['bc5083f85a72837d9cf5b32b82eecc6d0c06a35c'],106,106,212,704516,14,,,,1867
8f3fbf25c63af54e00bad927a606f79ef0bf7fbf,1,Andor Molnar,2019-02-13 13:12:00+01:00,['f3f7c79bb1fd4c03d557948199cd1ce363668bfa'],52,172,224,704740,24,0.771428571,0.842857143,0.642857143,1867
dc909724700e39145c2ca71cee5864fe6c074e3e,0,Andor Molnar,2019-02-13 13:19:28+01:00,['8f3fbf25c63af54e00bad927a606f79ef0bf7fbf'],6,292,298,705038,9,0.655172414,0.784482759,1,1869
a7b00ed47784f101cbd38efaecb89192ae9d3344,0,Andor Molnar,2019-02-15 12:39:38+01:00,['dc909724700e39145c2ca71cee5864fe6c074e3e'],1,7,8,705046,2,,,,1869
226af6e29bc00fe4a33269351f20ddf5b6658fd2,0,Andor Molnar,2019-02-15 15:36:55+01:00,['a7b00ed47784f101cbd38efaecb89192ae9d3344'],5,7,12,705058,1,0,0,0,1869
5375c2542977223ff9beaeb62d6ee5aed783118e,0,Andor Molnar,2019-02-18 17:05:51+01:00,['226af6e29bc00fe4a33269351f20ddf5b6658fd2'],8,27,35,705093,1,1,1,1,1869
e556293793ef588f39ed2fd61ba8afda2678c0b3,0,Andor Molnar,2019-02-22 13:15:52+01:00,['5375c2542977223ff9beaeb62d6ee5aed783118e'],13,4,17,705110,1,,,,1869
e8357d746608fd2406ed1cc5eaf3994a24844eef,0,Andor Molnar,2019-02-22 16:26:33+01:00,['e556293793ef588f39ed2fd61ba8afda2678c0b3'],0,2,2,705112,1,,,,1869
b3577278ab23f142fdb104a07bd61fbc74a4f152,0,Andor Molnar,2019-02-26 16:31:46+01:00,['e8357d746608fd2406ed1cc5eaf3994a24844eef'],3,18,21,705133,3,,,,1869
54b4f8aa1ab23a175d460347d250fb9497a28a09,0,Andor Molnar,2019-02-26 17:03:51+01:00,['b3577278ab23f142fdb104a07bd61fbc74a4f152'],215,420,635,705768,13,,,,1873
879c513a8d58ebbaa37342c532ec220ee1ab3939,0,Andor Molnar,2019-02-27 12:30:08+01:00,['54b4f8aa1ab23a175d460347d250fb9497a28a09'],1,3,4,705772,1,,,,1873
d0b60bd3cb4fe724fe5ed1670bb7d3e30842373a,0,Patrick Hunt,2019-02-27 08:25:58-08:00,['879c513a8d58ebbaa37342c532ec220ee1ab3939'],1,1,2,705774,1,,,,1873
c4303e2ff6781b030ab84d94a30494a4048dc6a0,0,Fangmin Lyu,2019-03-03 23:07:00-08:00,['d0b60bd3cb4fe724fe5ed1670bb7d3e30842373a'],0,49,49,705823,2,1,1,1,1874
dafc40d59f3d4ed1d2586bf93fc340d20fb6f6c4,0,Andor Molnar,2019-03-04 17:04:10-06:00,['c4303e2ff6781b030ab84d94a30494a4048dc6a0'],1,186,187,706010,6,0.077669903,0.757281553,0.737864078,1874
87e93b7922191f838f064abe7af3592408d83282,0,Patrick Hunt,2019-03-05 18:23:38-08:00,['dafc40d59f3d4ed1d2586bf93fc340d20fb6f6c4'],0,1,1,706011,1,,,,1874
e10c93a590cc1b73eebad48d18cfcbceb3ec0d4d,0,Patrick Hunt,2019-03-05 18:32:04-08:00,['87e93b7922191f838f064abe7af3592408d83282'],1,77,78,706089,3,0.482758621,1,0.775862069,1874
372e713a9d2d9264417313e5d68e9437ffddd0f5,0,Patrick Hunt,2019-03-05 19:32:11-08:00,['e10c93a590cc1b73eebad48d18cfcbceb3ec0d4d'],0,1,1,706090,1,,,,1874
ad8cfd07ff0ccd77aa97ebb0c247a2fe7e067527,1,Andor Molnar,2019-03-11 11:47:08-07:00,['372e713a9d2d9264417313e5d68e9437ffddd0f5'],51,263,314,706404,4,0.545454545,0.545454545,1,1874
bb39b83e125bb40597346aa4412e21851d1e871e,0,Andor Molnar,2019-03-11 13:56:36-07:00,['ad8cfd07ff0ccd77aa97ebb0c247a2fe7e067527'],28,46,74,706478,1,1,1,1,1874
c000f96504198d999daee2b0ccb3c4217f16dc97,0,Andor Molnar,2019-03-12 11:08:39-07:00,['bb39b83e125bb40597346aa4412e21851d1e871e'],9,116,125,706603,2,0.2,1,0.7,1874
b2535835439961c6ba24d8c0e1145635d06d7e5e,0,Patrick Hunt,2019-03-14 08:45:02-07:00,['c000f96504198d999daee2b0ccb3c4217f16dc97'],2,2,4,706607,2,,,,1874
7256d01a26412cd35a46edab6de9ac8c5adf5bb3,0,Fangmin Lyu,2019-03-14 22:35:07-07:00,['b2535835439961c6ba24d8c0e1145635d06d7e5e'],1,2,3,706610,1,,,,1874
19cb6fb8f7989121025f91889462386eb8918c56,0,Patrick Hunt,2019-03-17 22:24:13-07:00,['7256d01a26412cd35a46edab6de9ac8c5adf5bb3'],1,1,2,706612,1,,,,1874
9fba2f6c93a78928df4841a66185f51e242653aa,0,Andor Molnar,2019-03-18 17:12:03-07:00,['19cb6fb8f7989121025f91889462386eb8918c56'],4,25,29,706641,4,1,1,1,1874
07c3aaf3d723fb3144c0aedc0c2b655325df70e9,0,Fangmin Lyu,2019-03-21 11:15:06-07:00,['9fba2f6c93a78928df4841a66185f51e242653aa'],0,91,91,706732,3,1,1,1,1875
0ec4ba71fcfdf8d8d5289ada554b92250e6ba1a1,0,Andor Molnar,2019-04-02 13:31:38+02:00,['07c3aaf3d723fb3144c0aedc0c2b655325df70e9'],7,7,14,706746,1,,,,1875
7ef0923241475768cb6e1129a208bdfe1f16b968,0,Andor Molnar,2019-04-03 10:13:37+02:00,['0ec4ba71fcfdf8d8d5289ada554b92250e6ba1a1'],12,208,220,706966,4,,,,1876
91cf67029f398ae4c99ae40231cc2bde0f7559f0,0,Andor Molnar,2019-04-03 10:44:00+02:00,['7ef0923241475768cb6e1129a208bdfe1f16b968'],3,39,42,707008,4,,,,1876
7335efc6662d85a774f49a0732cd922cfc843333,0,Andor Molnar,2019-04-03 12:54:58+02:00,['91cf67029f398ae4c99ae40231cc2bde0f7559f0'],21,21,42,707050,15,,,,1876
96c435f4a05312a357a2692650cc6eb858896af0,0,Andor Molnar,2019-04-05 14:13:25+02:00,['7335efc6662d85a774f49a0732cd922cfc843333'],2,2,4,707054,2,,,,1876
450869006e0f62790e974305eb079e1b0450dbfd,0,Andor Molnar,2019-04-09 10:07:35+02:00,['96c435f4a05312a357a2692650cc6eb858896af0'],10,33,43,707097,1,0,1,0,1876
1e8286faed13e8d8abb2d5205f99440853e4b47d,0,Andor Molnar,2019-04-09 10:12:11+02:00,['450869006e0f62790e974305eb079e1b0450dbfd'],57,14,71,707168,2,,,,1876
915c6acaea3f5c01d26f0bff93d1897a4da3e32c,0,Andor Molnar,2019-04-09 10:40:52+02:00,['1e8286faed13e8d8abb2d5205f99440853e4b47d'],0,1,1,707169,1,,,,1876
3b93f7671464bef1824288b13ee66dec547bb97e,0,Andor Molnar,2019-04-09 11:36:55+02:00,['915c6acaea3f5c01d26f0bff93d1897a4da3e32c'],100,502,602,707771,6,0.229508197,0.229508197,1,1876
9a7cebb96a8fe810fbeea18d911212076424feaa,0,Andor Molnar,2019-04-09 14:36:10+02:00,['3b93f7671464bef1824288b13ee66dec547bb97e'],2,2,4,707775,1,,,,1876
57e8318bc98dd3563085e08b0fcfcbc6a1c5fbcc,1,Andor Molnar,2019-04-09 15:35:40+02:00,['9a7cebb96a8fe810fbeea18d911212076424feaa'],58,64,122,707897,12,1,1,0,1876
6dc61adbe41c712fbce930e598b3556da54e0667,0,Andor Molnar,2019-04-09 16:08:29+02:00,['57e8318bc98dd3563085e08b0fcfcbc6a1c5fbcc'],3,2,5,707902,1,1,1,0,1876
73cdd09051df33189351f7c42131724e3270eeac,1,Andor Molnar,2019-04-10 13:19:02+02:00,['6dc61adbe41c712fbce930e598b3556da54e0667'],182,594,776,708678,9,0.497435897,1,1,1878
ff132ab9dd3dd83df1dbfae5bc9f0cc53f6a4d45,0,Andor Molnar,2019-04-12 12:29:32+02:00,['73cdd09051df33189351f7c42131724e3270eeac'],5,113,118,708796,3,0,0.975,0.8625,1878
f69ad1b0fed88da3c1b67fd73031e7248c0564f7,0,Andor Molnar,2019-04-12 19:01:37+02:00,['ff132ab9dd3dd83df1dbfae5bc9f0cc53f6a4d45'],216,647,863,709659,50,0.157894737,0.625,1,1881
a6abb9315bd8309a98393b406ed9f593d4fa25f2,0,Andor Molnar,2019-04-12 19:06:41+02:00,['f69ad1b0fed88da3c1b67fd73031e7248c0564f7'],14,4,18,709677,1,,,,1881
4b01c9374586423a96cc8ba1cdf707fe77880cf9,1,Andor Molnar,2019-04-12 19:08:38+02:00,['a6abb9315bd8309a98393b406ed9f593d4fa25f2'],1,32,33,709710,3,0,0,1,1881
d719b68d5a1076f963a7c11722b384d506221f5c,1,Andor Molnar,2019-04-12 21:47:55+02:00,['4b01c9374586423a96cc8ba1cdf707fe77880cf9'],0,41,41,709751,2,,,,1881
bbc39c42bba74add9a625adca3ee52fb1cd02335,0,Andor Molnar,2019-04-14 16:05:59+02:00,['d719b68d5a1076f963a7c11722b384d506221f5c'],1,203,204,709955,5,0.663043478,0.923913043,0.97826087,1882
3d2a30f5fed9cc77f84c0d27d80020656f21fc06,0,Andor Molnar,2019-04-14 20:00:14+02:00,['bbc39c42bba74add9a625adca3ee52fb1cd02335'],203,1,204,710159,5,0.336956522,0.076086957,0.02173913,1882
e57e7a371da9ba6161fa06c29683679f4271e346,0,Andor Molnar,2019-04-17 11:06:19+02:00,['3d2a30f5fed9cc77f84c0d27d80020656f21fc06'],1,203,204,710363,5,0.663043478,0.923913043,0.97826087,1883
8cc3d5e2a9b0900984f09b873aa810c563399069,0,Andor Molnar,2019-04-17 12:26:53+02:00,['e57e7a371da9ba6161fa06c29683679f4271e346'],203,1,204,710567,5,0.336956522,0.076086957,0.02173913,1883
ff47fc3dfda3487ca3a5aca2ea16831b2aebc7e2,0,Andor Molnar,2019-04-17 14:16:17+02:00,['8cc3d5e2a9b0900984f09b873aa810c563399069'],2,205,207,710774,5,0.616161616,0.929292929,0.97979798,1884
e9adf6ee09ef18258653d65c851fa84c3cd1a51d,0,Andor Molnar,2019-04-18 19:17:48+02:00,['ff47fc3dfda3487ca3a5aca2ea16831b2aebc7e2'],6,451,457,711231,10,0.504166667,0.9125,0.908333333,1886
d8db88914e7af7c11a2588be202d90b925791d31,0,Fangmin Lyu,2019-04-22 10:15:22-07:00,['e9adf6ee09ef18258653d65c851fa84c3cd1a51d'],0,265,265,711496,8,0.444444444,0.97037037,0.962962963,1887
a2aecb9acc420c95f60b6649ffcbd4e0184cc0cd,0,Andor Molnar,2019-04-24 18:55:40+02:00,['d8db88914e7af7c11a2588be202d90b925791d31'],27,265,292,711788,6,,,,1888
cb9727dc5b6f37984fef5f62473ae4064a9f15cb,0,Fangmin Lyu,2019-04-24 17:11:50-07:00,['a2aecb9acc420c95f60b6649ffcbd4e0184cc0cd'],11,711,722,712510,4,0.661971831,0.856338028,0.966197183,1889
b787770b9920a7ae99f9ed2dbe583ece1b2665cc,0,Andor Molnar,2019-04-29 13:41:50+02:00,['cb9727dc5b6f37984fef5f62473ae4064a9f15cb'],90,120,210,712720,13,,,,1889
46b2018dbe008e010462e0dc06ddb73981d19d2a,0,Andor Molnar,2019-04-29 16:49:30+02:00,['b787770b9920a7ae99f9ed2dbe583ece1b2665cc'],2,89,91,712811,2,0.222222222,1,1,1889
876aaf42ea721776b82633bb769f8813e881a444,0,Andor Molnar,2019-04-30 18:08:06+02:00,['46b2018dbe008e010462e0dc06ddb73981d19d2a'],93,92,185,712996,1,1,1,0,1889
36bca12d5e70f96de4701aa2fd41979ff8128a1f,0,Fangmin Lyu,2019-05-02 15:44:08-07:00,['876aaf42ea721776b82633bb769f8813e881a444'],2,163,165,713161,7,0.278481013,0.860759494,0.898734177,1890
b6e45c3676030e69f6b006c4f400c5e375a15d09,1,Andor Molnar,2019-05-03 17:08:37+02:00,['36bca12d5e70f96de4701aa2fd41979ff8128a1f'],57,212,269,713430,3,,,,1891
5e0bb11d3428fa3459140a3e935af49006e7f2c1,0,Andor Molnar,2019-05-03 17:28:02+02:00,['b6e45c3676030e69f6b006c4f400c5e375a15d09'],1,1,2,713432,1,,,,1891
bee2ef8da3c4a7a2a1925ac8fc5375a7dee702ae,0,Andor Molnar,2019-05-03 17:37:55+02:00,['5e0bb11d3428fa3459140a3e935af49006e7f2c1'],53,23,76,713508,7,,,,1891
3a25fe4b6c07937dc6859cafd94f3532b3a0befe,0,Fangmin Lyu,2019-05-06 08:48:57-07:00,['bee2ef8da3c4a7a2a1925ac8fc5375a7dee702ae'],0,191,191,713699,4,0.402597403,0.896103896,1,1892
c67760523492b8da033c7bc0ea3076ab4acf1a93,0,Fangmin Lyu,2019-05-06 09:32:30-07:00,['3a25fe4b6c07937dc6859cafd94f3532b3a0befe'],0,41,41,713740,2,0.055555556,1,0.944444444,1892
cb36d5a95fca6bc098890bde517ba76901adf43a,1,Andor Molnar,2019-05-08 17:51:13+02:00,['c67760523492b8da033c7bc0ea3076ab4acf1a93'],7,129,136,713876,7,,,,1894
999c834714aba859a96ba32d02e66fb63e70ab35,0,Andor Molnar,2019-05-08 21:54:42+02:00,['cb36d5a95fca6bc098890bde517ba76901adf43a'],35,61,96,713972,18,0,1,1,1894
4243b95f4c1a0c6c6e9a6d78a789fae647d43b20,0,Andor Molnar,2019-05-10 12:22:34+02:00,['999c834714aba859a96ba32d02e66fb63e70ab35'],4,9,13,713985,3,0,1,1,1894
31e92e0a4f287ca840e0c9418e3a9b706e9721db,1,Andor Molnar,2019-05-14 17:11:14+02:00,['4243b95f4c1a0c6c6e9a6d78a789fae647d43b20'],22,182,204,714189,8,1,1,0.476923077,1894
e45551fc7c691332ace7bff81926855e42ac2239,1,Andor Molnar,2019-05-15 11:56:42+02:00,['31e92e0a4f287ca840e0c9418e3a9b706e9721db'],74,161,235,714424,10,0.888888889,0.933333333,0.844444444,1894
7ca06c2cbb77695ec33a3d3d2f04e005bbbb63ad,0,Andor Molnar,2019-05-16 16:25:32+02:00,['e45551fc7c691332ace7bff81926855e42ac2239'],23,68,91,714515,2,0.441176471,1,1,1894
1264e9f2ba8e8724a9352387b22e784716816722,0,Andor Molnar,2019-05-20 12:24:52+02:00,['7ca06c2cbb77695ec33a3d3d2f04e005bbbb63ad'],4,9,13,714528,2,,,,1894
777f0c15e73a8401a648c3cff93d20b3d3e4ee17,1,Enrico Olivelli,2019-05-20 17:18:31+02:00,['1264e9f2ba8e8724a9352387b22e784716816722'],61,48,109,714637,18,1,0,0,1894
af59be25c564d34c6620cd931cd84ef5200aa1b3,0,Enrico Olivelli,2019-05-20 22:54:43+02:00,['777f0c15e73a8401a648c3cff93d20b3d3e4ee17'],0,63,63,714700,2,1,1,1,1895
6e9802b440b0c706a035a25aafe40b28d25dfadc,0,Enrico Olivelli,2019-05-20 23:13:44+02:00,['af59be25c564d34c6620cd931cd84ef5200aa1b3'],3,21,24,714724,3,1,1,1,1895
d08f51ad1514bfa512597b1ce4bbc2e8144be576,1,Fangmin Lyu,2019-05-21 14:34:38-07:00,['6e9802b440b0c706a035a25aafe40b28d25dfadc'],3,119,122,714846,3,0.090909091,0.840909091,0.772727273,1896
39a316a3bab747d879ef974308ad888808377983,0,Fangmin Lyu,2019-05-21 14:41:39-07:00,['d08f51ad1514bfa512597b1ce4bbc2e8144be576'],4,84,88,714934,5,1,1,1,1896
cc431f70020b9a2028edcc61e41cff9ee85b078f,1,Enrico Olivelli,2019-05-22 11:39:06+02:00,['39a316a3bab747d879ef974308ad888808377983'],6,138,144,715078,5,0.949152542,0.966101695,1,1896
e2bb6e80f598415bba975edcff166ff1bd750340,0,Andor Molnar,2019-05-23 18:42:39+02:00,['cc431f70020b9a2028edcc61e41cff9ee85b078f'],3,32,35,715113,2,0,1,1,1896
968f5f365e53d0bcbbe0225cc382327badbd8380,0,Enrico Olivelli,2019-05-25 19:43:31+02:00,['e2bb6e80f598415bba975edcff166ff1bd750340'],2,0,2,715115,2,0,0,0,1896
ea8536982c39fd1127a4e6e7a8229b64a5798447,0,Norbert Kalmar,2019-05-27 10:54:58+02:00,['968f5f365e53d0bcbbe0225cc382327badbd8380'],1,94,95,715210,6,0.965517241,1,0.896551724,1897
d713419bde97374a2d1b1cbe51fcb17b4416a196,0,Andor Molnar,2019-05-27 22:33:44+02:00,['ea8536982c39fd1127a4e6e7a8229b64a5798447'],17,21,38,715248,1,,,,1897
bb94aa44de61bfb2ecd5bbd12b4eb390c2cf39c1,0,Norbert Kalmar,2019-05-28 15:55:11+02:00,['d713419bde97374a2d1b1cbe51fcb17b4416a196'],3,6,9,715257,2,1,1,1,1897
78b3d1a8c1ea8453423682ad09675dfb1df04384,0,Norbert Kalmar,2019-05-28 16:04:34+02:00,['bb94aa44de61bfb2ecd5bbd12b4eb390c2cf39c1'],2,2,4,715261,2,,,,1897
f7bdab002aa01677145654f8a1f93a45969d22cd,0,Andor Molnar,2019-05-29 17:14:34+02:00,['78b3d1a8c1ea8453423682ad09675dfb1df04384'],5,7,12,715273,2,,,,1897
ca4b12430ef579f67785146a195ebfed5ca73f39,0,Norbert Kalmar,2019-05-30 15:53:35+02:00,['f7bdab002aa01677145654f8a1f93a45969d22cd'],2,2,4,715277,2,,,,1897
d3dbe787f37eb9e17402e4a3d55a441ca43b2160,0,Andor Molnar,2019-05-31 22:16:29+02:00,['ca4b12430ef579f67785146a195ebfed5ca73f39'],25,67,92,715369,5,0,0,0,1897
0d41fe80cd9218a44cd606f7bc0be61eaf696029,0,Enrico Olivelli,2019-06-03 19:40:34+02:00,['d3dbe787f37eb9e17402e4a3d55a441ca43b2160'],173,133,306,715675,73,,,,1897
ba6a0391082d984b38c509ce73ddc22896d95c7e,1,Norbert Kalmar,2019-06-04 10:47:08+02:00,['0d41fe80cd9218a44cd606f7bc0be61eaf696029'],61,60,121,715796,13,,,,1897
6af151a7e44760c33165e58d3b33a4d2760283a4,1,Norbert Kalmar,2019-06-04 10:55:09+02:00,['ba6a0391082d984b38c509ce73ddc22896d95c7e'],170,324,494,716290,15,0.976190476,1,1,1897
d98a692ff4482f1d97774f25a158ca5473c455e0,1,Michael Han,2019-06-04 15:29:24-07:00,['6af151a7e44760c33165e58d3b33a4d2760283a4'],61,244,305,716595,8,0.6,0,0.885714286,1897
f63a831d67bd12303a3e1578126f2a09819fecd5,0,Michael Han,2019-06-04 15:33:14-07:00,['d98a692ff4482f1d97774f25a158ca5473c455e0'],6,60,66,716661,5,0.891891892,0.891891892,1,1897
5cb10bb5c0e341d65471b70572654756ba088a1d,0,Fangmin Lyu,2019-06-04 15:46:58-07:00,['f63a831d67bd12303a3e1578126f2a09819fecd5'],0,139,139,716800,4,0.333333333,0.920634921,1,1898
5577d41da48feb8db3595d88a63096594c20fbb9,0,Norbert Kalmar,2019-06-05 12:14:51+02:00,['5cb10bb5c0e341d65471b70572654756ba088a1d'],4,2,6,716806,1,,,,1898
e732d3703137b4c3c4cacd680ed8388f8bf5e677,0,Fangmin Lyu,2019-06-05 14:57:36-07:00,['5577d41da48feb8db3595d88a63096594c20fbb9'],0,132,132,716938,3,0.31372549,0.921568627,0.921568627,1899
39c40bea3a04cda70a6f9e8caad64b26d4d046e6,1,Fangmin Lyu,2019-06-05 15:01:42-07:00,['e732d3703137b4c3c4cacd680ed8388f8bf5e677'],9,156,165,717103,3,0.01010101,0.525252525,0.646464646,1899
89e7e55811b7115a9155f25cd572520055af00fc,0,Enrico Olivelli,2019-06-07 14:13:24+02:00,['39c40bea3a04cda70a6f9e8caad64b26d4d046e6'],46,13,59,717162,11,0,0,0,1899
a5487e40b3065eea6c3beecb568d13e22fc2e494,0,Michael Han,2019-06-10 13:10:50-07:00,['89e7e55811b7115a9155f25cd572520055af00fc'],4,4,8,717170,1,,,,1899
3f4d0cda0f9688baa7ad0718e46c4ba95653dbfa,0,Norbert Kalmar,2019-06-12 10:25:14+02:00,['a5487e40b3065eea6c3beecb568d13e22fc2e494'],0,1803,1803,718973,14,0.310961969,0.888143177,0.982102908,1909
5874a0f355417024ce8ebe03ab2f6eaf5b9a228c,1,Enrico Olivelli,2019-06-14 09:06:42+02:00,['3f4d0cda0f9688baa7ad0718e46c4ba95653dbfa'],12,103,115,719088,3,0.049180328,1,1,1909
0fcb3f6f6c96dfc7e1842a39fa47c624b7fb1960,0,Enrico Olivelli,2019-06-14 09:10:29+02:00,['5874a0f355417024ce8ebe03ab2f6eaf5b9a228c'],0,3,3,719091,2,,,,1909
3d666f1a6c19779c73e8636bb7f65b5230d3fda0,1,Andor Molnar,2019-06-14 23:20:50+02:00,['0fcb3f6f6c96dfc7e1842a39fa47c624b7fb1960'],21,581,602,719693,3,,,,1910
48a78fa65e23ffe4b93e24b8f61f4f6ad14daaad,0,Patrick Hunt,2019-06-18 18:51:04-07:00,['3d666f1a6c19779c73e8636bb7f65b5230d3fda0'],0,3,3,719696,1,,,,1910
52dcf72b0a035116f83431e30c7acf7301982a28,0,Patrick Hunt,2019-06-18 21:07:14-07:00,['48a78fa65e23ffe4b93e24b8f61f4f6ad14daaad'],2,7,9,719705,1,0,0,1,1910
92257ef143ac94c37941600474d30fe22e1a1a6e,0,Andor Molnar,2019-06-20 20:25:44+02:00,['52dcf72b0a035116f83431e30c7acf7301982a28'],1313,63,1376,721081,11,0.235138705,0.151915456,0.042272127,1910
5627cd4a5a35b31b5b8143eec2a18940d914a7d4,0,Norbert Kalmar,2019-06-24 11:05:25+02:00,['92257ef143ac94c37941600474d30fe22e1a1a6e'],36,50,86,721167,3,1,1,0.25,1910
2711d69297ce45cb6fc5beab482e4ec36d07249f,0,Norbert Kalmar,2019-06-25 15:47:58+02:00,['5627cd4a5a35b31b5b8143eec2a18940d914a7d4'],5,5,10,721177,3,,,,1910
a81065334498c5bfd0687b7cd38eff8d14cc48af,1,Andor Molnar,2019-06-25 22:09:27+02:00,['2711d69297ce45cb6fc5beab482e4ec36d07249f'],7,7,14,721191,1,,,,1910
4c650696fc89b4492b0f14fbbb4b59f5f03775dd,0,Norbert Kalmar,2019-06-26 10:35:13+02:00,['a81065334498c5bfd0687b7cd38eff8d14cc48af'],5,23,28,721219,5,,,,1910
1b074d6a8a448e1d3d50383a7d6f2e21d5cf1dfc,0,Andor Molnar,2019-06-26 10:57:46+02:00,['4c650696fc89b4492b0f14fbbb4b59f5f03775dd'],222,721,943,722162,15,0.431884058,0.837681159,0.884057971,1911
fdd6d9b910174bf2f631127862c47ebd899872a6,0,Norbert Kalmar,2019-06-27 09:18:34+02:00,['1b074d6a8a448e1d3d50383a7d6f2e21d5cf1dfc'],62,5,67,722229,4,,,,1911
5e7d88bc27c3d1d7aa0ebb77e0609ae0a39cf309,0,Norbert Kalmar,2019-06-27 14:49:29+02:00,['fdd6d9b910174bf2f631127862c47ebd899872a6'],1,1,2,722231,1,,,,1911
02c203fa486ac24553d9584768fe97960b6dec24,0,Michael Han,2019-06-28 15:33:38-07:00,['5e7d88bc27c3d1d7aa0ebb77e0609ae0a39cf309'],1,195,196,722427,7,0.731707317,0.910569106,1,1911
1e6edc9229c418b8bea46ccc5d603ea1c4a47a9e,0,Michael Han,2019-06-28 15:38:18-07:00,['02c203fa486ac24553d9584768fe97960b6dec24'],13,18,31,722458,2,,,,1911
44c9d56f22195223250765f2138336b903e960c0,0,Andor Molnar,2019-07-01 15:16:01+02:00,['1e6edc9229c418b8bea46ccc5d603ea1c4a47a9e'],14,2,16,722474,2,0.25,0.25,0.25,1911
96eefafce7ed036d3ab4a7a6d43792ce433bbfad,0,Andor Molnar,2019-07-02 07:34:21+02:00,['44c9d56f22195223250765f2138336b903e960c0'],53,16,69,722543,5,1,1,0,1911
9bee98bd06f50a2085785406a1084f75c652ada1,1,Michael Han,2019-07-02 15:44:25-07:00,['96eefafce7ed036d3ab4a7a6d43792ce433bbfad'],53,123,176,722719,14,0.791666667,0.833333333,1,1911
4cadbb1a649b70a2243bc4c1e5f736df4d35c462,0,Michael Han,2019-07-03 11:54:12-07:00,['9bee98bd06f50a2085785406a1084f75c652ada1'],59,40,99,722818,2,1,0,0,1911
7b3de52cdb15068aa343879ae283f4e456c68f39,1,Michael Han,2019-07-08 14:26:11-07:00,['4cadbb1a649b70a2243bc4c1e5f736df4d35c462'],32,814,846,723664,12,0.587078652,0.820224719,0.991573034,1913
f9610cc80173342bbe9766889a1aab1bfd840d1e,0,Michael Han,2019-07-08 17:30:08-07:00,['7b3de52cdb15068aa343879ae283f4e456c68f39'],0,118,118,723782,2,0,0.575342466,1,1913
433cf7e2b660fce3c73eb011452814f7084ff196,0,Andor Molnar,2019-07-09 13:34:06+02:00,['f9610cc80173342bbe9766889a1aab1bfd840d1e'],12,20,32,723814,1,1,1,1,1913
fbda06ba57ae298c3f4244d1bfcec4d07ba865e3,1,Enrico Olivelli,2019-07-12 07:32:42+02:00,['433cf7e2b660fce3c73eb011452814f7084ff196'],1047,7384,8431,732245,4,0.649496081,0.66237402,0.841825308,1913
cbcfd0463a9c7e348bae9d3de6f076b29b73a229,0,Norbert Kalmar,2019-07-12 16:53:38+02:00,['fbda06ba57ae298c3f4244d1bfcec4d07ba865e3'],1,1,2,732247,1,,,,1913
43ce772db000721546fcd13dd8523002dfa97741,0,Andor Molnar,2019-07-12 17:01:44+02:00,['cbcfd0463a9c7e348bae9d3de6f076b29b73a229'],77,151,228,732475,24,0.219512195,0.731707317,0.926829268,1913
cc900a3b05bc31a237753680c8b00dc5866df4b2,1,Norbert Kalmar,2019-07-15 14:15:03+02:00,['43ce772db000721546fcd13dd8523002dfa97741'],0,106,106,732581,7,0.52173913,0.855072464,1,1913
1c83846615701e88749690f06993a6e77452b83c,0,Andor Molnar,2019-07-15 14:46:48+02:00,['cc900a3b05bc31a237753680c8b00dc5866df4b2'],88,518,606,733187,12,0.831372549,1,0.768627451,1916
f873dcf10e222e220732ab27cc6fc8c0ff0beec6,0,Norbert Kalmar,2019-07-16 09:21:14+02:00,['1c83846615701e88749690f06993a6e77452b83c'],3,3,6,733193,1,,,,1916
a6c36b69cc72d7d67e392dab5360007d6f737bef,0,Andor Molnar,2019-07-17 13:42:32+02:00,['f873dcf10e222e220732ab27cc6fc8c0ff0beec6'],238,153,391,733584,6,0.772727273,1,1,1916
4212f865d67b9c7860c1da071f3997b0a5b5387e,0,Enrico Olivelli,2019-07-19 13:08:30+02:00,['a6c36b69cc72d7d67e392dab5360007d6f737bef'],1,3,4,733588,1,,,,1916
ce33b7faed60ea0b7c6f2eb1edbf56eec20a8bc2,0,Enrico Olivelli,2019-07-23 15:55:47+02:00,['4212f865d67b9c7860c1da071f3997b0a5b5387e'],32,274,306,733894,6,0.460227273,0,1,1916
513df3da671c9937417bb7d92a55402520ba1292,0,Enrico Olivelli,2019-07-24 18:00:02+02:00,['ce33b7faed60ea0b7c6f2eb1edbf56eec20a8bc2'],22,469,491,734385,11,0.593582888,0.887700535,0.92513369,1921
f38905e58e4961ae04d876e1855d6ccb372a706b,0,Enrico Olivelli,2019-07-25 21:41:50+02:00,['513df3da671c9937417bb7d92a55402520ba1292'],517,545,1062,735447,16,1,1,0,1923
6281a8693c287fadca72321178023ee78cf9c818,0,Enrico Olivelli,2019-07-25 23:43:26+02:00,['f38905e58e4961ae04d876e1855d6ccb372a706b'],35,88,123,735570,2,0.515151515,1,1,1923
83940b18ce70016de7400f6159ce2a2db5a0bbec,0,Andor Molnar,2019-07-27 20:04:26+02:00,['6281a8693c287fadca72321178023ee78cf9c818'],9,4,13,735583,1,1,0,0,1923
05ee9413e7a31703395b81fb8d72baf1cb09a46d,1,Norbert Kalmar,2019-07-29 11:49:27+02:00,['83940b18ce70016de7400f6159ce2a2db5a0bbec'],13,74,87,735670,3,0.34375,0.90625,1,1923
fed6cdad1e7a4fb83b568e8bf3ba3cf1da492db9,0,Andor Molnar,2019-07-29 17:09:35+02:00,['05ee9413e7a31703395b81fb8d72baf1cb09a46d'],34,456,490,736160,8,0.623529412,0.976470588,0.77254902,1925
35f4aa227463ca95941b9045f9c554aa1696782f,0,Enrico Olivelli,2019-07-29 17:15:26+02:00,['fed6cdad1e7a4fb83b568e8bf3ba3cf1da492db9'],705,1291,1996,738156,37,1,1,0.842105263,1926
a6b38f83218791f8d9fabc52c865dcccf07026cc,0,Michael Han,2019-07-29 17:31:09-07:00,['35f4aa227463ca95941b9045f9c554aa1696782f'],101,422,523,738679,6,0.231527094,0.950738916,1,1926
a89c0942e45bb16e5282eee9d3a56ebbddbaae15,1,Andor Molnar,2019-07-31 11:02:00+02:00,['a6b38f83218791f8d9fabc52c865dcccf07026cc'],74,13,87,738766,3,0.65625,0.09375,0,1926
ee04684b259fe00fe3dd8d3b697ba011c71e120b,1,Michael Han,2019-07-31 10:06:04-07:00,['a89c0942e45bb16e5282eee9d3a56ebbddbaae15'],88,1535,1623,740389,26,0.446519525,0.823429542,0.898132428,1935
6d636025d1c6a10840a27caee9e8933f1dbcbaf0,0,Enrico Olivelli,2019-08-01 07:28:24+02:00,['ee04684b259fe00fe3dd8d3b697ba011c71e120b'],7,881,888,741277,5,0.201954397,0.431596091,0.964169381,1937
b2f5548bd5757edbf1887838a487a90523ed2b52,1,Enrico Olivelli,2019-08-01 07:31:29+02:00,['6d636025d1c6a10840a27caee9e8933f1dbcbaf0'],76,566,642,741919,11,0.600649351,0.587662338,1,1938
c725222d9ff93c6a50340bd4d6700e2989279049,0,Michael Han,2019-08-01 13:47:00-07:00,['b2f5548bd5757edbf1887838a487a90523ed2b52'],0,2,2,741921,1,,,,1938
6b6ff1d11009d1301eb48d7801175d6af7dbf3fe,0,Andor Molnar,2019-08-02 13:55:01+02:00,['c725222d9ff93c6a50340bd4d6700e2989279049'],2,16,18,741939,1,0.375,1,1,1938
104e78e008f84ab2d350b68db5a8a46297135faa,1,Andor Molnar,2019-08-02 14:03:25+02:00,['6b6ff1d11009d1301eb48d7801175d6af7dbf3fe'],0,96,96,742035,2,,,,1939
3882a0171f91280bf1adbbd4ffaeb17cb5131316,0,Michael Han,2019-08-02 11:08:47-07:00,['104e78e008f84ab2d350b68db5a8a46297135faa'],4,2,6,742041,2,1,1,0,1939
d84b7a682eb4601005db9fac886079b1a9a4d4b0,1,Fangmin Lyu,2019-08-02 23:42:39-07:00,['3882a0171f91280bf1adbbd4ffaeb17cb5131316'],280,207,487,742528,33,1,1,0.069767442,1939
49354f581f3b88316177492ef28823b50a5b33f7,0,Enrico Olivelli,2019-08-05 15:29:50+02:00,['d84b7a682eb4601005db9fac886079b1a9a4d4b0'],28,64,92,742620,7,0,0,0,1939
1d4aaf7ca292c565f8c77ae5dc980ef6e8e246f1,0,Michael Han,2019-08-05 16:41:44-07:00,['49354f581f3b88316177492ef28823b50a5b33f7'],0,1,1,742621,1,0,0,1,1939
53f22e19f977016dc53fffa17180bd025dc50802,0,Michael Han,2019-08-05 16:43:18-07:00,['1d4aaf7ca292c565f8c77ae5dc980ef6e8e246f1'],3,140,143,742764,2,,,,1939
8fbeec0db8010461ddeae88d15c3a0b1e59a3c64,0,Michael Han,2019-08-05 16:49:20-07:00,['53f22e19f977016dc53fffa17180bd025dc50802'],0,2,2,742766,1,1,1,1,1939
f252c769206a9ed9688998a1608bcbd2840a90f4,0,Michael Han,2019-08-05 16:51:41-07:00,['8fbeec0db8010461ddeae88d15c3a0b1e59a3c64'],2,6,8,742774,2,,,,1939
4de5f012a56e26d72bcddf782995849d7a9e7cfd,0,Michael Han,2019-08-05 16:55:55-07:00,['f252c769206a9ed9688998a1608bcbd2840a90f4'],4,16,20,742794,3,,,,1939
6692d7a5b4bc3f0dbd36677c06e782ef5240153a,0,Andor Molnar,2019-08-06 12:52:07+02:00,['4de5f012a56e26d72bcddf782995849d7a9e7cfd'],14,87,101,742895,3,0.405405405,0.918918919,1,1939
13b9125927233fd5f2378d99f403bca6d35d6145,0,Andor Molnar,2019-08-06 12:57:21+02:00,['6692d7a5b4bc3f0dbd36677c06e782ef5240153a'],5,110,115,743010,4,,,,1941
9fa18ab0e1ce07b3cc61e8758e27d393253b81fb,1,Andor Molnar,2019-08-06 17:11:26+02:00,['13b9125927233fd5f2378d99f403bca6d35d6145'],31,54,85,743095,5,1,1,1,1941
975a425ad4fca45d3c32f929771e4b716ac25c4d,0,Andor Molnar,2019-08-06 18:01:52+02:00,['9fa18ab0e1ce07b3cc61e8758e27d393253b81fb'],0,151,151,743246,1,0.107526882,1,1,1941
abf1865c3a0701beef1dddd128e9ad25712a4c33,0,Andor Molnar,2019-08-08 17:00:54+02:00,['975a425ad4fca45d3c32f929771e4b716ac25c4d'],3,3,6,743252,1,,,,1941
04cc5cae1e7d4b007490e68109a676b88ce790a3,0,Andor Molnar,2019-08-09 16:15:20+02:00,['abf1865c3a0701beef1dddd128e9ad25712a4c33'],171,375,546,743798,4,0.76744186,1,1,1942
fe940cdd8fb23ba09684cefb73233d570f4a20fa,1,Michael Han,2019-08-17 08:13:15-07:00,['04cc5cae1e7d4b007490e68109a676b88ce790a3'],24952,23496,48448,792246,633,1,0.254684512,0.058508604,1942
dec6ac782b12a80169fbff9093949e477e5075f0,0,Michael Han,2019-08-21 13:03:12-07:00,['fe940cdd8fb23ba09684cefb73233d570f4a20fa'],1,1,2,792248,1,,,,1942
942213dfe28e464f068f8a195d1424c4b29af585,0,Norbert Kalmar,2019-08-23 12:14:46+02:00,['dec6ac782b12a80169fbff9093949e477e5075f0'],0,1,1,792249,1,,,,1942
b5817fbb12b88bc28be72f109c695ebf51bebf3b,0,Enrico Olivelli,2019-08-23 19:43:02+02:00,['942213dfe28e464f068f8a195d1424c4b29af585'],2,667,669,792918,9,0.459770115,0.82183908,0.945402299,1946
b5399da61d305da2fe80dc9be6f9bba5037209cf,1,Enrico Olivelli,2019-08-25 20:42:49+02:00,['b5817fbb12b88bc28be72f109c695ebf51bebf3b'],2,2,4,792922,2,,,,1946
b8d5d9c1c163f3be4f6ec7d2eb520d37d9352c73,0,Norbert Kalmar,2019-08-27 09:23:11+02:00,['b5399da61d305da2fe80dc9be6f9bba5037209cf'],1100,1027,2127,795049,19,1,1,0,1946
151003722e4f1a30aed0b686890fb35adcaf1f2d,0,Enrico Olivelli,2019-08-28 15:31:16+02:00,['b8d5d9c1c163f3be4f6ec7d2eb520d37d9352c73'],1,1,2,795051,1,,,,1946
650aea33eddef9054c90ca47183cde0e58cabcd9,0,Michael Han,2019-08-28 14:03:12-07:00,['151003722e4f1a30aed0b686890fb35adcaf1f2d'],34,52,86,795137,1,,,,1946
ebbdfb978b759040b7cd86df05bf53b22fff7f48,0,Michael Han,2019-08-28 22:16:32-07:00,['650aea33eddef9054c90ca47183cde0e58cabcd9'],1,1,2,795139,1,,,,1946
68c21988d55c57e483370d3ee223c22da2d1bbcf,1,Enrico Olivelli,2019-09-02 08:23:06+02:00,['ebbdfb978b759040b7cd86df05bf53b22fff7f48'],7,53,60,795199,3,0.142857143,0,0.80952381,1946
47385c75e0e0d0a48e71122df989effd55f0fe59,0,Michael Han,2019-09-05 13:59:14-07:00,['68c21988d55c57e483370d3ee223c22da2d1bbcf'],163,138,301,795500,1,,,,1946
eecd9e7ce046083bd40cd6134bdb2b405d01fe67,0,Michael Han,2019-09-05 14:12:50-07:00,['47385c75e0e0d0a48e71122df989effd55f0fe59'],24,311,335,795835,9,0.469512195,0.920731707,1,1946
614224e318551a4ba332618cbd377050f19e1f3f,0,Michael Han,2019-09-05 14:48:15-07:00,['eecd9e7ce046083bd40cd6134bdb2b405d01fe67'],11,4,15,795850,1,,,,1946
1f1211653589c98e259d043affc00c90a4c54eb7,0,Michael Han,2019-09-09 15:27:26-07:00,['614224e318551a4ba332618cbd377050f19e1f3f'],2,30,32,795882,2,0,1,1,1946
a0f500bdaa04e68d60ca891b0b1f8062196df18c,0,Michael Han,2019-09-09 15:33:07-07:00,['1f1211653589c98e259d043affc00c90a4c54eb7'],0,95,95,795977,2,,,,1948
dd96bec98db2b747958f9bcd0ea9f64d43eac17e,0,Michael Han,2019-09-09 19:26:38-07:00,['a0f500bdaa04e68d60ca891b0b1f8062196df18c'],38,48,86,796063,2,1,0.555555556,1,1948
692ea8bd681d741845c77040c1d991e34d2e91fe,0,Norbert Kalmar,2019-09-10 09:53:43+02:00,['dd96bec98db2b747958f9bcd0ea9f64d43eac17e'],8,12,20,796083,1,,,,1948
f01d01ce3ba86baf9bd623f91d97a560703260e4,0,Andor Molnar,2019-09-10 15:21:05+02:00,['692ea8bd681d741845c77040c1d991e34d2e91fe'],89,83,172,796255,8,1,1,1,1948
8460f4ed48c5f9018d882bee2be748de42e965f9,0,Enrico Olivelli,2019-09-10 18:50:37+02:00,['f01d01ce3ba86baf9bd623f91d97a560703260e4'],1,75,76,796331,2,0.34375,0.34375,1,1949
42ea26b75105484ef0504396332c276952224158,0,Enrico Olivelli,2019-09-11 10:27:28+02:00,['8460f4ed48c5f9018d882bee2be748de42e965f9'],44,283,327,796658,8,0.090909091,0.719008264,0.446280992,1950
930436b65fd1e965582ab6381587b286b4491e63,0,Norbert Kalmar,2019-09-16 12:19:10+02:00,['42ea26b75105484ef0504396332c276952224158'],0,1414,1414,798072,8,,,,1957
1ca627b5a3105d80ed4d851c6e9f1a1e2ac7d64a,1,Michael Han,2019-09-16 14:26:05-07:00,['930436b65fd1e965582ab6381587b286b4491e63'],0,249,249,798321,11,0.691729323,0.917293233,1,1957
7b8b37617bd86989f94510acac32e7fa94058a6b,0,Norbert Kalmar,2019-09-18 11:20:31+02:00,['1ca627b5a3105d80ed4d851c6e9f1a1e2ac7d64a'],354,247,601,798922,17,0.967479675,0.341463415,0,1958
d6900bf253dd613f1149b3f885b78a679f11b249,0,Norbert Kalmar,2019-09-18 16:03:37+02:00,['7b8b37617bd86989f94510acac32e7fa94058a6b'],0,5,5,798927,1,0,1,1,1958
6034e293280b4742489396d5f0f1954b1123461c,0,Andor Molnar,2019-09-19 14:56:51+02:00,['d6900bf253dd613f1149b3f885b78a679f11b249'],1,1,2,798929,1,,,,1958
2c1034f8fe4e6e437f7c71478153f41180970542,0,Norbert Kalmar,2019-09-20 10:02:12+02:00,['6034e293280b4742489396d5f0f1954b1123461c'],4,7,11,798940,2,,,,1958
a179caa668882d6129ebb000ee60455de749d34f,0,Norbert Kalmar,2019-09-20 10:06:43+02:00,['2c1034f8fe4e6e437f7c71478153f41180970542'],142,85,227,799167,5,1,1,0,1958
4fd1098348ff75b1d79607aa79d89a4c93e9d4d8,1,Michael Han,2019-09-23 13:22:15-07:00,['a179caa668882d6129ebb000ee60455de749d34f'],22,386,408,799575,3,,,,1959
93dca3c2547c56cc83d94a59fe4c279ea7e77716,0,Norbert Kalmar,2019-09-24 10:33:40+02:00,['4fd1098348ff75b1d79607aa79d89a4c93e9d4d8'],11,20,31,799606,1,,,,1959
4279758ead655aff34cdff21c9f2c71d66030d14,0,Enrico Olivelli,2019-09-26 08:55:31+02:00,['93dca3c2547c56cc83d94a59fe4c279ea7e77716'],1,89,90,799696,3,1,1,0.87755102,1959
efb2c56d3ab630ef571ee2abcab6f18e08c64c79,0,Norbert Kalmar,2019-09-26 14:16:50+02:00,['4279758ead655aff34cdff21c9f2c71d66030d14'],6,1,7,799703,1,1,1,0,1959
63a825372eaa745cf117f53b0f9b263a0db05a4f,0,Norbert Kalmar,2019-09-27 13:18:24+02:00,['efb2c56d3ab630ef571ee2abcab6f18e08c64c79'],2,2,4,799707,2,,,,1959
1e7fae31af634ccfb85cde17fa634d188145b9b7,0,Andor Molnar,2019-09-27 15:43:19+02:00,['63a825372eaa745cf117f53b0f9b263a0db05a4f'],2,18,20,799727,2,0.444444444,1,0.555555556,1959
0d7be16b86830f4bacc4fea9389e0dff760d38e0,0,Mohammad Arshad,2019-10-01 01:44:26+05:18,['1e7fae31af634ccfb85cde17fa634d188145b9b7'],1,31,32,799759,5,0.5,0,0.75,1959
9f2e2f238c4bcbb0170bb6a983ffa4e92f701488,0,Michael Han,2019-09-30 14:22:31-07:00,['0d7be16b86830f4bacc4fea9389e0dff760d38e0'],2,17,19,799778,1,,,,1959
874aaf136ccda2759cc61f4c48ff9d15f6433e07,1,Norbert Kalmar,2019-10-03 15:39:30+02:00,['9f2e2f238c4bcbb0170bb6a983ffa4e92f701488'],2,2,4,799782,2,,,,1959
2dcb5e799ec02a2c6a6c7bad80c47169dc095271,0,Andor Molnar,2019-10-08 15:16:18+02:00,['874aaf136ccda2759cc61f4c48ff9d15f6433e07'],0,0,0,799782,8,,,,1959
f4c7b698bd239bcd15ee380d2ee38814dba432cd,0,Andor Molnar,2019-10-09 16:38:44+02:00,['2dcb5e799ec02a2c6a6c7bad80c47169dc095271'],12,129,141,799923,2,0,0.565789474,1,1959
4951a090d7c946f57ac5ab09b5d48a5d7831001d,0,Andor Molnar,2019-10-09 16:49:02+02:00,['f4c7b698bd239bcd15ee380d2ee38814dba432cd'],6,95,101,800024,2,0.357142857,0.642857143,1,1959
92fb05092aef6eb580e4259efc332f6f7cbdd994,0,Andor Molnar,2019-10-10 13:13:33+02:00,['4951a090d7c946f57ac5ab09b5d48a5d7831001d'],0,89,89,800113,2,,,,1959
11c07921c15e2fb7692375327b53f26a583b77ca,1,Andor Molnar,2019-10-10 14:37:45+02:00,['92fb05092aef6eb580e4259efc332f6f7cbdd994'],1263,1341,2604,802717,155,0.53030303,1,0.590909091,1959
c9eeeda3bb83ee492a29ccbdc9f9541ee676e578,0,Andor Molnar,2019-10-10 14:42:46+02:00,['11c07921c15e2fb7692375327b53f26a583b77ca'],120,177,297,803014,7,,,,1960
99be7de0c394a32d46c3f06b23f860eadfbd42b0,0,Andor Molnar,2019-10-24 08:49:42+02:00,['c9eeeda3bb83ee492a29ccbdc9f9541ee676e578'],0,91,91,803105,3,,,,1961
ef3649f599b4213a918c7a84cfe663d6cb1fa26e,0,Brian Nixon,2019-11-03 17:01:42-08:00,['99be7de0c394a32d46c3f06b23f860eadfbd42b0'],12,21,33,803138,3,,,,1961
e41cac853de416026e0c2011e0429e858e5823b8,0,Enrico Olivelli,2019-11-06 15:21:19+01:00,['ef3649f599b4213a918c7a84cfe663d6cb1fa26e'],3,62,65,803203,2,0,1,1,1962
553639378d5cf86c2488afff4586e5e4cce38061,0,Enrico Olivelli,2019-11-08 17:30:25+01:00,['e41cac853de416026e0c2011e0429e858e5823b8'],54,1699,1753,804956,27,0.562860438,0.881199539,0.797001153,1972
79f99af81842f415b97e1c3c18c953df5bd129b2,0,Enrico Olivelli,2019-11-11 13:55:55+01:00,['553639378d5cf86c2488afff4586e5e4cce38061'],3,97,100,805056,3,0.355932203,1,0.881355932,1972
794adf11220151496a1ff877df3d2627719c9505,1,Enrico Olivelli,2019-11-11 13:59:08+01:00,['79f99af81842f415b97e1c3c18c953df5bd129b2'],29,1731,1760,806816,30,0.442528736,0.755172414,0.805747126,1986
cd465947949f64d4258184d7b493a7e8747c6262,0,Andor Molnar,2019-11-13 20:41:47+01:00,['794adf11220151496a1ff877df3d2627719c9505'],90,399,489,807305,3,0.776397516,1,0.968944099,1988
df267929322c5e83bb8d57bbed65978b0159ec8b,0,Mohammad Arshad,2019-11-14 08:12:09+05:18,['cd465947949f64d4258184d7b493a7e8747c6262'],0,290,290,807595,10,0.414965986,0.414965986,0.986394558,1990
aeb9f78c454c59d5d258f0a99bb5e57ed2cbaebe,0,Andor Molnar,2019-11-14 16:44:36+01:00,['df267929322c5e83bb8d57bbed65978b0159ec8b'],5,23,28,807623,2,1,1,1,1990
9f13268567dfcc26a5f59a7449aeec21fb5e16b3,0,Andor Molnar,2019-11-15 10:56:42+01:00,['aeb9f78c454c59d5d258f0a99bb5e57ed2cbaebe'],97,3,100,807723,3,0.644067797,0,0.118644068,1990
d2bec6b097c64b7c6e5ead4335bbd8d0afaa6d12,0,Norbert Kalmar,2019-11-15 14:34:05+01:00,['9f13268567dfcc26a5f59a7449aeec21fb5e16b3'],4954,0,4954,812677,7,,,,1990
945167c338d4a26c18bdaf49fb9000186a5f7025,0,Enrico Olivelli,2019-11-18 09:05:38+01:00,['d2bec6b097c64b7c6e5ead4335bbd8d0afaa6d12'],65,230,295,812972,11,0.314814815,0.37962963,0.296296296,1990
2e39cc05713a052f738323dcb344b3615da7027a,0,Brian Nixon,2019-11-19 22:00:56-08:00,['945167c338d4a26c18bdaf49fb9000186a5f7025'],3,15,18,812990,1,0,1,1,1990
ae68c7d50e4057ef3f9b99ac0cd0200a8bd5f235,0,Brian Nixon,2019-11-20 20:58:30-08:00,['2e39cc05713a052f738323dcb344b3615da7027a'],14,25,39,813029,5,,,,1990
dded710d07892c6b42380267cd1bb896b852a7ee,0,Andor Molnar,2019-11-21 09:54:01+01:00,['ae68c7d50e4057ef3f9b99ac0cd0200a8bd5f235'],232,1561,1793,814822,29,0.310776942,0.310776942,0.28320802,1993
0b9d30faedd27dec9d03220635467fdb23de6b8b,0,Andor Molnar,2019-11-22 23:42:31+01:00,['dded710d07892c6b42380267cd1bb896b852a7ee'],0,1,1,814823,1,1,1,1,1993
b462feb5d84ba85e64625d0c16f5beb2b507b695,1,Andor Molnar,2019-11-22 23:47:03+01:00,['0b9d30faedd27dec9d03220635467fdb23de6b8b'],2,2,4,814827,1,,,,1993
804095c060e3b11c33b201a304031dc3ac18cfb6,1,Enrico Olivelli,2019-11-23 17:08:23+01:00,['b462feb5d84ba85e64625d0c16f5beb2b507b695'],2,206,208,815035,7,0.3359375,0.90625,1,1993
4132b64b36ea43909888fdaf34268a243f2c7420,1,Enrico Olivelli,2019-11-25 15:37:51+01:00,['804095c060e3b11c33b201a304031dc3ac18cfb6'],22,129,151,815186,5,0.281690141,0.85915493,0.943661972,1993
8e8905069f4bff670c0492fe9e28ced0f86bca00,1,Andor Molnar,2019-11-28 12:24:36+01:00,['4132b64b36ea43909888fdaf34268a243f2c7420'],41,139,180,815366,20,0.9,0.9,1,1994
815c8f2130b8b43e11abe52b226707f707a93581,1,Andor Molnar,2019-11-29 14:49:13+01:00,['8e8905069f4bff670c0492fe9e28ced0f86bca00'],508,2159,2667,818033,33,0.607466063,0.847285068,0.903846154,1998
01e198aec9ceae52f160ddcf2e45cd234823e505,0,Norbert Kalmar,2019-12-03 10:01:22+01:00,['815c8f2130b8b43e11abe52b226707f707a93581'],3,49,52,818085,3,0.470588235,1,1,1998
b0556c20a4331de29476faf845e8fca18e8820fe,0,Fangmin Lyu,2019-12-03 10:12:30-08:00,['01e198aec9ceae52f160ddcf2e45cd234823e505'],6,18,24,818109,3,1,1,0,1998
b2a671e6a7b7f323a2a5659222429dfcc21e17cd,0,Fangmin Lyu,2019-12-03 10:35:41-08:00,['b0556c20a4331de29476faf845e8fca18e8820fe'],1,1,2,818111,1,,,,1998
253673f30431344030509b974bd2f65d23c1cd6e,0,Norbert Kalmar,2019-12-04 12:47:52+01:00,['b2a671e6a7b7f323a2a5659222429dfcc21e17cd'],14,79,93,818204,5,1,1,0,1998
bcd6d3b7c84f6b887b9ac23b93f0653822f79d9e,0,Norbert Kalmar,2019-12-10 12:19:43+01:00,['253673f30431344030509b974bd2f65d23c1cd6e'],7,6,13,818217,3,,,,1998
1f33a71457882f9bf3b481b29d4dac2ca0b5d350,0,Norbert Kalmar,2019-12-11 16:05:32+01:00,['bcd6d3b7c84f6b887b9ac23b93f0653822f79d9e'],31,50,81,818298,1,1,0,1,1998
a5d67c8ffcc18289aa89c892d948ad7c75a317b4,0,Enrico Olivelli,2019-12-13 08:51:38+01:00,['1f33a71457882f9bf3b481b29d4dac2ca0b5d350'],16,33,49,818347,2,0,0,0.2,1998
ac9cecf2a41214d6ee2401df849a155dc877dc45,0,Enrico Olivelli,2019-12-14 09:29:51+01:00,['a5d67c8ffcc18289aa89c892d948ad7c75a317b4'],36,200,236,818583,12,,,,1998
b04758e1903b0574c6b8ae82f8ff4e735cfad6b5,0,Enrico Olivelli,2019-12-15 15:19:13+00:00,['ac9cecf2a41214d6ee2401df849a155dc877dc45'],4,4,8,818591,2,,,,1998
dba77e106bbfc65b7ac570554426cb1ea1910870,0,Enrico Olivelli,2019-12-15 15:19:31+00:00,['b04758e1903b0574c6b8ae82f8ff4e735cfad6b5'],18,18,36,818627,17,,,,1998
280bceebcedb29cf58f636931bd975d3622a6c6e,0,Enrico Olivelli,2019-12-15 16:26:57+01:00,['dba77e106bbfc65b7ac570554426cb1ea1910870'],3,3,6,818633,3,,,,1998
20daae7d5fa934629e7825ed72e66ad76a94d6aa,0,Enrico Olivelli,2019-12-16 22:09:36+01:00,['280bceebcedb29cf58f636931bd975d3622a6c6e'],36,114,150,818783,1,1,1,0.366666667,1998
19d85670a3c87565bc63a5f84169e4c6c72e2915,0,Andor Molnar,2019-12-17 13:48:25+01:00,['20daae7d5fa934629e7825ed72e66ad76a94d6aa'],5,177,182,818965,3,0.533333333,1,0.788888889,1999
48e5eaadffd8e23d2f47fe3eb0d0437b172dcd39,0,Andor Molnar,2019-12-17 13:59:09+01:00,['19d85670a3c87565bc63a5f84169e4c6c72e2915'],1,7,8,818973,1,,,,1999
a80f9b291f2852b8dbe3b83bf2b5b4f0306424f5,0,Andor Molnar,2019-12-17 20:12:52+01:00,['48e5eaadffd8e23d2f47fe3eb0d0437b172dcd39'],1,80,81,819054,1,,,,1999
7c9a1e4e9ae9e3a17c4766b34787e39ca1e42794,0,Mohammad Arshad,2019-12-19 14:09:41+05:18,['a80f9b291f2852b8dbe3b83bf2b5b4f0306424f5'],8,92,100,819154,2,1,1,1,2000
56f508f1828e4392caab1e50ed76b81b84a7357d,0,Enrico Olivelli,2019-12-23 16:49:27+01:00,['7c9a1e4e9ae9e3a17c4766b34787e39ca1e42794'],3,0,3,819157,2,,,,2000
04e91c3889b2d0a477036ae088794b6f5b3b04ba,0,Enrico Olivelli,2019-12-23 16:50:59+01:00,['56f508f1828e4392caab1e50ed76b81b84a7357d'],1,1,2,819159,1,,,,2000
2805e8982c0e8964e5f8d86f4b01a293d75d4aed,1,Enrico Olivelli,2019-12-27 22:33:26+01:00,['04e91c3889b2d0a477036ae088794b6f5b3b04ba'],174,1557,1731,820890,50,0.547270306,0.712383489,0.631158455,2003
d784e4dc8e042bd622500f861163bb315fa856fe,0,Andor Molnar,2019-12-28 16:17:54+01:00,['2805e8982c0e8964e5f8d86f4b01a293d75d4aed'],233,140,373,821263,15,1,0.626666667,0,2003
c585f4b5005e4bda825a796de6251f16f3fe4dba,1,Enrico Olivelli,2020-01-06 11:51:49+01:00,['d784e4dc8e042bd622500f861163bb315fa856fe'],2,449,451,821714,5,,,,2005
d7bc7b135f486f0b91bd7e40b150f39813ef9a9a,0,Andor Molnar,2020-01-06 13:04:35+01:00,['c585f4b5005e4bda825a796de6251f16f3fe4dba'],2,23,25,821739,1,0.5,0.5,1,2005
178e8de664bed018c339108f168ae4ae4989b3b6,0,Andor Molnar,2020-01-06 13:07:32+01:00,['d7bc7b135f486f0b91bd7e40b150f39813ef9a9a'],1,1,2,821741,1,,,,2005
7408ff43777602937a54af7e66913138c8c2a3b4,0,Fangmin Lyu,2020-01-07 11:39:06-08:00,['178e8de664bed018c339108f168ae4ae4989b3b6'],1,1,2,821743,1,,,,2005
a6ae78a96243f16022ec23f43058be878728cb6a,0,Enrico Olivelli,2020-01-08 10:41:15+01:00,['7408ff43777602937a54af7e66913138c8c2a3b4'],3,16,19,821762,1,,,,2005
591e1fdbb98a151e003066305e1cc1fd27dcfb66,0,Enrico Olivelli,2020-01-08 10:43:49+01:00,['a6ae78a96243f16022ec23f43058be878728cb6a'],1,0,1,821763,1,,,,2005
590e3cbcf1967d4de6ebc08a938584e3b4caf7c4,0,Enrico Olivelli,2020-01-09 11:27:14+01:00,['591e1fdbb98a151e003066305e1cc1fd27dcfb66'],972,10,982,822745,5,0.850515464,0.702749141,0.089347079,2005
570285af427fd69471a682a071a47483f8f7ddf8,0,Andor Molnar,2020-01-09 22:51:51+01:00,['590e3cbcf1967d4de6ebc08a938584e3b4caf7c4'],2,1,3,822748,1,1,0,0,2005
27b92caefd57a60309af06ebce29e56954ca9aac,0,Andor Molnar,2020-01-09 22:56:39+01:00,['570285af427fd69471a682a071a47483f8f7ddf8'],113,0,113,822861,5,0.5,0.022727273,0,2005
1c5d135d74f16275876c024401dc2de92909b20a,0,Norbert Kalmar,2020-01-13 14:09:29+01:00,['27b92caefd57a60309af06ebce29e56954ca9aac'],18,0,18,822879,16,,,,2005
f530ab91f1986027223bff72f01f965a24d6fd53,0,Fangmin Lyu,2020-01-16 12:46:10-08:00,['1c5d135d74f16275876c024401dc2de92909b20a'],7,1,8,822887,1,0,0,0,2005
9053f7c431bb17ed79c2be129b6ba4ba18d15ab1,0,Andor Molnar,2020-01-17 17:08:56+01:00,['f530ab91f1986027223bff72f01f965a24d6fd53'],135,40,175,823062,3,,,,2005
3bd6b1950eea1fabeac4bc477c8828939d008a4a,0,Patrick Hunt,2020-01-18 11:06:01-08:00,['9053f7c431bb17ed79c2be129b6ba4ba18d15ab1'],0,5,5,823067,1,,,,2005
49ad75b18bfe26e853050f5add6f10f567399058,0,Mohammad Arshad,2020-01-20 12:57:29+05:18,['3bd6b1950eea1fabeac4bc477c8828939d008a4a'],1,26,27,823094,2,0,1,1,2005
dcef1a6f33d8120a93f011da1870a503aafb0312,0,Mohammad Arshad,2020-01-20 13:24:59+05:18,['49ad75b18bfe26e853050f5add6f10f567399058'],1,97,98,823192,2,1,1,1,2006
517ecde9dd3cfe574118231ec242ea73b80a4e79,0,Andor Molnar,2020-01-21 17:53:18+01:00,['dcef1a6f33d8120a93f011da1870a503aafb0312'],17,17,34,823226,1,,,,2006
ee69a5565215bb95fe10d88f52dba80a7a7fb929,1,Andor Molnar,2020-01-21 18:14:37+01:00,['517ecde9dd3cfe574118231ec242ea73b80a4e79'],66,194,260,823486,2,0.012820513,0.833333333,1,2006
97f89ceb2ac22a45d886e0430e2bcbf4d337094d,0,Andor Molnar,2020-01-21 18:18:51+01:00,['ee69a5565215bb95fe10d88f52dba80a7a7fb929'],140,1,141,823627,3,0.911764706,0.911764706,0,2006
b7dd0e49c5b25fffc1be8e619a3164bc680ef8bd,0,Andor Molnar,2020-01-22 11:08:42+01:00,['97f89ceb2ac22a45d886e0430e2bcbf4d337094d'],10,468,478,824105,8,0.677130045,1,0.986547085,2008
c234848caef0cc920f19befd1b0b14251b17da92,1,Norbert Kalmar,2020-01-22 12:53:55+01:00,['b7dd0e49c5b25fffc1be8e619a3164bc680ef8bd'],155,1509,1664,825769,20,0.168356998,0.314401623,0.649087221,2012
2d29c569f2c3ca879e1d026a7086f6e376187198,0,Norbert Kalmar,2020-01-23 11:14:39+01:00,['c234848caef0cc920f19befd1b0b14251b17da92'],1,1,2,825771,1,,,,2012
b4c5a7fdd0f97aa5a9bf18a345b1cee5b0da967a,1,Andor Molnar,2020-01-23 13:43:52+01:00,['2d29c569f2c3ca879e1d026a7086f6e376187198'],13,143,156,825927,9,0.728813559,0.203389831,1,2012
689c8b2c4ed264f1dd75db7cbde1f86fe4408f50,0,Enrico Olivelli,2020-01-23 16:46:28+01:00,['b4c5a7fdd0f97aa5a9bf18a345b1cee5b0da967a'],2,2,4,825931,1,,,,2012
1fbaa26d6827263b2e9e8c18d8699f4bf799eda3,0,Enrico Olivelli,2020-01-23 16:50:58+01:00,['689c8b2c4ed264f1dd75db7cbde1f86fe4408f50'],1,1,2,825933,1,,,,2012
7c1251dbcf6a314466024f71ae5757bde34bb3fd,0,Fangmin Lyu,2020-01-25 09:48:36-08:00,['1fbaa26d6827263b2e9e8c18d8699f4bf799eda3'],4,194,198,826131,4,0.714285714,0.714285714,1,2013
e4758ba70b35dd38ff0bba9e534790391f53b050,0,Andor Molnar,2020-01-27 11:26:15+01:00,['7c1251dbcf6a314466024f71ae5757bde34bb3fd'],48,217,265,826396,14,0.386363636,0.795454545,0,2015
57be7aedd698cb824ade7373aaa4d8264e1b4eb7,0,Norbert Kalmar,2020-01-28 15:22:30+01:00,['e4758ba70b35dd38ff0bba9e534790391f53b050'],13,57,70,826466,1,,,,2015
a4bc9857e19b6fa3832813d7e47f683b582565b8,0,Norbert Kalmar,2020-01-28 17:26:14+01:00,['57be7aedd698cb824ade7373aaa4d8264e1b4eb7'],24,92,116,826582,6,0.272727273,1,0.954545455,2015
2abdfbc261d4ba2f9d17b51f2b46ab748a7d451f,1,Andor Molnar,2020-01-30 09:43:09+01:00,['a4bc9857e19b6fa3832813d7e47f683b582565b8'],27,103,130,826712,4,0.581395349,1,1,2015
111437694b67398bd83a5459b451ff78440579df,0,Enrico Olivelli,2020-01-31 12:01:23+01:00,['2abdfbc261d4ba2f9d17b51f2b46ab748a7d451f'],2,2,4,826716,1,,,,2015
d3ce1fa7e0b9804fb7752cbb3818c03341d8c87e,1,Enrico Olivelli,2020-02-01 12:08:39+01:00,['111437694b67398bd83a5459b451ff78440579df'],3,13,16,826732,1,,,,2015
68e1f7d4c54429caa74441c7444ef1fe0f75867c,0,Andor Molnar,2020-02-03 04:30:41+01:00,['d3ce1fa7e0b9804fb7752cbb3818c03341d8c87e'],4,4,8,826740,1,0,0,0,2015
13c8a35051acbc1f8c3369ed260df2ab22275f58,0,Enrico Olivelli,2020-02-04 10:35:10+01:00,['68e1f7d4c54429caa74441c7444ef1fe0f75867c'],1,1,2,826742,9,,,,2015
6763f73cb64d87145e8e642d9e4fcc1e0d509216,0,Enrico Olivelli,2020-02-04 10:39:02+01:00,['13c8a35051acbc1f8c3369ed260df2ab22275f58'],3,3,6,826748,3,,,,2015
6db92d7dfa426488b191afba319a16b96f4a36c6,0,Enrico Olivelli,2020-02-04 10:43:30+01:00,['6763f73cb64d87145e8e642d9e4fcc1e0d509216'],1,14,15,826763,1,,,,2015
d0c191b44fa539222d4a6964ccdfef45f2bee098,0,Michael Han,2020-02-10 21:50:17-08:00,['6db92d7dfa426488b191afba319a16b96f4a36c6'],1,23,24,826787,2,0,1,0,2015
ed251d43733996d72b9c57b7ba9822f49d25b4e6,0,Norbert Kalmar,2020-02-12 15:48:01+01:00,['d0c191b44fa539222d4a6964ccdfef45f2bee098'],27,1,28,826815,2,0,0,0,2015
ae1a52c75b19e15db5913ac34d34b1c6fbf75e36,0,Norbert Kalmar,2020-02-12 15:52:42+01:00,['ed251d43733996d72b9c57b7ba9822f49d25b4e6'],1,1,2,826817,1,,,,2015
9c2f2e55850cdd20778b7d4b4eae283fc6ab4d1e,0,Fangmin Lyu,2020-02-12 15:04:22-08:00,['ae1a52c75b19e15db5913ac34d34b1c6fbf75e36'],1,1,2,826819,1,,,,2015
3aa922c5737c9ef0879f290181cb281261c965e0,0,Enrico Olivelli,2020-02-16 10:25:14+01:00,['9c2f2e55850cdd20778b7d4b4eae283fc6ab4d1e'],22,169,191,827010,15,0.558823529,0.147058824,0.985294118,2015
f0c6ae5eb205d7c546483a6f1769cb58b68169a6,0,Patrick Hunt,2020-02-23 08:41:20-08:00,['3aa922c5737c9ef0879f290181cb281261c965e0'],1,1,2,827012,1,,,,2015
b2db3918cb2b681e0446cfe3247730deacc0567b,0,Patrick Hunt,2020-02-23 21:14:46-08:00,['f0c6ae5eb205d7c546483a6f1769cb58b68169a6'],1,2,3,827015,3,,,,2015
db87335fd2593cacc49bc23c1b9065256d0d3d36,0,Fangmin Lyu,2020-02-26 13:41:26-08:00,['b2db3918cb2b681e0446cfe3247730deacc0567b'],7,20,27,827042,4,0,0.142857143,1,2015
4b45ff1bda65b27d2771322d4613fccfb8a726b0,0,Norbert Kalmar,2020-02-27 14:22:06+01:00,['db87335fd2593cacc49bc23c1b9065256d0d3d36'],1,1,2,827044,1,,,,2015
f90060b83da4bfcca58ada93a57fedb40a069387,0,Enrico Olivelli,2020-02-28 10:58:24+01:00,['4b45ff1bda65b27d2771322d4613fccfb8a726b0'],0,731,731,827775,4,0.415625,0.615625,0.45625,2018
5a2332058deba04313ad37fa05cbb1515c83b8e6,0,Patrick Hunt,2020-02-29 21:42:47-08:00,['f90060b83da4bfcca58ada93a57fedb40a069387'],13,11,24,827799,1,,,,2018
050e56ae48b978a9f8c04dfe00e1647e4301f5a0,0,Norbert Kalmar,2020-03-02 17:08:47+01:00,['5a2332058deba04313ad37fa05cbb1515c83b8e6'],49,18,67,827866,3,,,,2018
d3e72c659d20e109b2ba60c1fe277e5d14ba8e6b,1,Michael Han,2020-03-02 18:12:30-08:00,['050e56ae48b978a9f8c04dfe00e1647e4301f5a0'],11,394,405,828271,2,0.747826087,0.747826087,0.856521739,2019
118dee4b8a4a69699eb00e12bef2907cbbece160,0,Norbert Kalmar,2020-03-03 10:53:43+01:00,['d3e72c659d20e109b2ba60c1fe277e5d14ba8e6b'],17,23,40,828311,1,0,0,0,2019
0287c95726e66aa6723f0f91f8d85f9973dbbb60,0,Enrico Olivelli,2020-03-12 14:47:27+01:00,['118dee4b8a4a69699eb00e12bef2907cbbece160'],14,216,230,828541,4,0.878787879,0.878787879,1,2020
222685123018f9d0d35bfd35cc4cc5924f4348bc,0,Enrico Olivelli,2020-03-14 17:45:57+01:00,['0287c95726e66aa6723f0f91f8d85f9973dbbb60'],1,1,2,828543,1,,,,2020
a5a4743733b8939464af82c1ee68a593fadbe362,0,Enrico Olivelli,2020-03-14 17:50:15+01:00,['222685123018f9d0d35bfd35cc4cc5924f4348bc'],8,8,16,828559,6,,,,2020
b1105ccc47685c64d1cca7ccb0b2bb66c194374a,0,Norbert Kalmar,2020-03-19 17:09:38+01:00,['a5a4743733b8939464af82c1ee68a593fadbe362'],1,47,48,828607,3,1,1,1,2020
8148f966947d3ecf3db0b756d93c9ffa88174af9,0,Norbert Kalmar,2020-03-20 11:00:13+01:00,['b1105ccc47685c64d1cca7ccb0b2bb66c194374a'],3,22,25,828632,2,,,,2020
bb80b813d79b0eff93d112d6d15f00c147d946c1,1,Enrico Olivelli,2020-03-22 14:47:08+01:00,['8148f966947d3ecf3db0b756d93c9ffa88174af9'],0,12,12,828644,1,1,1,1,2020
4d8caf9851f63073145996fd4a535278014d01be,0,Norbert Kalmar,2020-03-23 16:20:05+01:00,['bb80b813d79b0eff93d112d6d15f00c147d946c1'],94,188,282,828926,2,1,1,1,2021
e87bad6774e7269ef21a156aff9dad089ef54794,0,Michael Han,2020-03-24 19:38:46-07:00,['4d8caf9851f63073145996fd4a535278014d01be'],24,695,719,829645,24,0.555035129,0.526932084,1,2025
64863119bf92893f3c72350fd37005083b587327,0,Enrico Olivelli,2020-03-25 12:08:54+01:00,['e87bad6774e7269ef21a156aff9dad089ef54794'],50,53,103,829748,7,0,1,0.5,2025
2581f71dd97cfda2cf6768c3457b81c7a93b9ef7,0,Norbert Kalmar,2020-03-26 18:41:57+01:00,['64863119bf92893f3c72350fd37005083b587327'],4,4,8,829756,1,,,,2025
6c7a273bc1c553be34dc7b9e658c6c16b8a023ef,0,Enrico Olivelli,2020-03-26 22:12:18+01:00,['2581f71dd97cfda2cf6768c3457b81c7a93b9ef7'],5,4,9,829765,1,,,,2025
2bc0a932400e97c5cdb70b4eb1da4b2e0ad3375f,0,Enrico Olivelli,2020-03-26 22:16:27+01:00,['6c7a273bc1c553be34dc7b9e658c6c16b8a023ef'],40,45,85,829850,2,,,,2025
b4a3238d1d0cebe1c97ed23427bbcc69c8477c8a,0,Enrico Olivelli,2020-03-26 22:19:08+01:00,['2bc0a932400e97c5cdb70b4eb1da4b2e0ad3375f'],2,67,69,829919,3,0,0,0.578947368,2025
1ff1b779b70dd794c9e45f35f8ca305229df10e0,0,Enrico Olivelli,2020-03-26 22:20:51+01:00,['b4a3238d1d0cebe1c97ed23427bbcc69c8477c8a'],91,274,365,830284,12,,,,2028
a4c97d255ad7bb86c61a35d01415de1caebd3dac,0,Norbert Kalmar,2020-03-31 13:39:49+02:00,['1ff1b779b70dd794c9e45f35f8ca305229df10e0'],58,58,116,830400,1,,0,,2028
7e6386aa9b404dd236b6bdc3b5c714116f3986db,0,Andor Molnar,2020-04-01 17:02:20+02:00,['a4c97d255ad7bb86c61a35d01415de1caebd3dac'],51,123,174,830574,3,1,1,1,2030
a548253408384d9e943b151c942d795017dca70c,0,Enrico Olivelli,2020-04-07 09:07:50+02:00,['7e6386aa9b404dd236b6bdc3b5c714116f3986db'],51,313,364,830938,2,0.308943089,0.926829268,1,2031
d142e5a86993971a56bb2081020c085ed9ca68d7,0,Enrico Olivelli,2020-04-07 15:40:49+02:00,['a548253408384d9e943b151c942d795017dca70c'],0,13,13,830951,2,0.75,0.75,0.75,2031
a8fb880218410ec3b31374d957e5a0bd6c8cdf28,0,Enrico Olivelli,2020-04-07 17:00:35+02:00,['d142e5a86993971a56bb2081020c085ed9ca68d7'],0,1,1,830952,1,0,0,1,2031
09cb43554fb41eb651ebfb948f9a4230c2c4dfa2,0,Enrico Olivelli,2020-04-08 14:04:51+02:00,['a8fb880218410ec3b31374d957e5a0bd6c8cdf28'],3,3,6,830958,1,,,,2031
f3c969718f9f8a590474388636510cf5c097b2aa,0,Norbert Kalmar,2020-04-08 19:18:32+02:00,['09cb43554fb41eb651ebfb948f9a4230c2c4dfa2'],24,272,296,831254,9,,,,2032
f9a08032c5cdf6ca4dc4649992436207576fbe9e,0,Mate Szalay-Beko,2020-04-09 10:59:02+00:00,['f3c969718f9f8a590474388636510cf5c097b2aa'],318,79,397,831651,7,0.848275862,0.731034483,0.579310345,2034
726f6843eba75bb3673284b52d8ca3801c5431d3,0,Mate Szalay-Beko,2020-04-11 06:19:04+00:00,['f9a08032c5cdf6ca4dc4649992436207576fbe9e'],2,103,105,831756,2,0,0.516129032,1,2034
4d32f6cf39f76d606b436bd4c04a8d1bc9c60148,0,Enrico Olivelli,2020-04-12 11:14:45+02:00,['726f6843eba75bb3673284b52d8ca3801c5431d3'],1,41,42,831798,2,0.041666667,1,1,2034
8a1e0b3643d85ffa362207880095e08f1dbc47da,0,Enrico Olivelli,2020-04-15 11:44:17+02:00,['4d32f6cf39f76d606b436bd4c04a8d1bc9c60148'],1,1,2,831800,9,,,,2034
7812399f2c34033d56267d3cd2189abefbf35172,0,Mate Szalay-Beko,2020-04-16 10:50:00+00:00,['8a1e0b3643d85ffa362207880095e08f1dbc47da'],24,60,84,831884,2,0.769230769,0.769230769,0.769230769,2034
5e592d303b596961c03bff9731cfe2e202cea5f2,0,ben reed,2020-04-16 11:20:25-07:00,['7812399f2c34033d56267d3cd2189abefbf35172'],0,82,82,831966,1,,,,2034
f44937ec6a23aa5cb98e3121b4de85d3d42093ed,0,Norbert Kalmar,2020-04-27 10:58:43+02:00,['5e592d303b596961c03bff9731cfe2e202cea5f2'],15,44,59,832025,7,0,0,0,2034
2e14a29cc6e58d9561e80b737a3168fbb1f752b4,0,Mate Szalay-Beko,2020-04-30 16:53:16+00:00,['f44937ec6a23aa5cb98e3121b4de85d3d42093ed'],4,4,8,832033,2,,,,2034
b4f6e82de10e6f87836f8221970110dad2b3825c,0,Enrico Olivelli,2020-05-03 19:43:27+02:00,['2e14a29cc6e58d9561e80b737a3168fbb1f752b4'],84,120,204,832237,3,0.888888889,0.944444444,1,2034
ac4da3ebed34c536c4ea873503b0a6c036fa3910,0,Mate Szalay-Beko,2020-05-04 06:49:35+00:00,['b4f6e82de10e6f87836f8221970110dad2b3825c'],0,0,0,832237,1,,,,2034
f6b54a6cd227ac37f28803f45d7287c7fd3a8142,0,Enrico Olivelli,2020-05-04 14:13:41+02:00,['ac4da3ebed34c536c4ea873503b0a6c036fa3910'],0,5,5,832242,1,,,,2034
391cb4aa6b54e19a028215e1340232a114c23ed3,0,Enrico Olivelli,2020-05-04 14:17:33+02:00,['f6b54a6cd227ac37f28803f45d7287c7fd3a8142'],6,8,14,832256,1,,,,2034
bbe30290c2dd70bea20d3b08a0d705b10564c3b1,1,Enrico Olivelli,2020-05-04 14:19:04+02:00,['391cb4aa6b54e19a028215e1340232a114c23ed3'],1,1,2,832258,1,,,,2034
92f23ecd8159fd8d9c2fb8f34dd94f680ee6f712,0,Enrico Olivelli,2020-05-04 14:20:27+02:00,['bbe30290c2dd70bea20d3b08a0d705b10564c3b1'],84,76,160,832418,26,,,,2034
44de549657a539dcedba58d56e67b8c906c89580,0,Norbert Kalmar,2020-05-05 09:18:18+02:00,['92f23ecd8159fd8d9c2fb8f34dd94f680ee6f712'],0,42,42,832460,2,0.956521739,1,0.956521739,2034
05cd214a0cc9c870de373b54cfeb47a2a75efd28,0,Mate Szalay-Beko,2020-05-05 19:20:35+00:00,['44de549657a539dcedba58d56e67b8c906c89580'],195,249,444,832904,7,1,1,0,2036
ae7f72d31e4dc9c6e307b1c14271e74950b022dc,0,Fangmin Lyu,2020-05-07 14:54:59-07:00,['05cd214a0cc9c870de373b54cfeb47a2a75efd28'],10,0,10,832914,1,0,0,0,2036
c56506162bfde339e801743396361862cc8c5b41,0,Mate Szalay-Beko,2020-05-12 09:39:58+00:00,['ae7f72d31e4dc9c6e307b1c14271e74950b022dc'],1,1,2,832916,1,,,,2036
236e3d9183606512f0e03a1f828ad0d392eb6091,0,Mate Szalay-Beko,2020-05-12 09:53:40+00:00,['c56506162bfde339e801743396361862cc8c5b41'],35,64,99,833015,3,,,,2036
45bc3ece8964a24feb808926f18f6e53319aa683,0,Enrico Olivelli,2020-05-14 18:18:28+02:00,['236e3d9183606512f0e03a1f828ad0d392eb6091'],31,61,92,833107,2,0.684210526,1,1,2036
a14bd54f7112df96622c04fe6951bb25d6eddcf0,0,Enrico Olivelli,2020-05-15 09:10:25+02:00,['45bc3ece8964a24feb808926f18f6e53319aa683'],1,71,72,833179,4,0,1,1,2036
d99c9e8b701ebdbd3f0098d4d81696df97432262,0,Enrico Olivelli,2020-05-17 15:13:37+02:00,['a14bd54f7112df96622c04fe6951bb25d6eddcf0'],641,651,1292,834471,9,0,1,1,2037
a908001be9641d78040b1954acb0cd3a8e9e42c2,0,Enrico Olivelli,2020-05-17 15:15:54+02:00,['d99c9e8b701ebdbd3f0098d4d81696df97432262'],16,171,187,834658,4,0,1,1,2037
5e88b541dcc2fd30e60bb437efa7704bbec8f6e6,0,Norbert Kalmar,2020-05-20 19:56:26+02:00,['a908001be9641d78040b1954acb0cd3a8e9e42c2'],9,0,9,834667,3,,,,2037
9e50853da2da5aa982a4b0da790f2da51575b6f1,0,Norbert Kalmar,2020-05-21 11:19:39+02:00,['5e88b541dcc2fd30e60bb437efa7704bbec8f6e6'],5,5,10,834677,5,,,,2037
5820d10d9dc58c8e12d2e25386fdf92acb360359,1,Enrico Olivelli,2020-05-21 14:13:32+02:00,['9e50853da2da5aa982a4b0da790f2da51575b6f1'],2,740,742,835419,4,0.113402062,0.948453608,0.917525773,2039
b1e67ca2807f836592ec0106c0c38e3ce997ee8e,0,Michael Han,2020-05-27 20:43:25-07:00,['5820d10d9dc58c8e12d2e25386fdf92acb360359'],17,42,59,835478,7,0.666666667,0.833333333,0.388888889,2039
0f182ab88dac2fda7f5821b7003092428b859164,0,Michael Han,2020-05-27 20:47:09-07:00,['b1e67ca2807f836592ec0106c0c38e3ce997ee8e'],0,12,12,835490,3,0,0.75,1,2039
e91455c1e3c50405666cd8afad71d99dceb7b340,0,Norbert Kalmar,2020-05-29 14:59:47+02:00,['0f182ab88dac2fda7f5821b7003092428b859164'],54,287,341,835831,13,0.161290323,0.529032258,0.819354839,2039
db99959ef338783102f8755b4d10c1443f709425,0,Mate Szalay-Beko,2020-06-08 14:33:38+02:00,['e91455c1e3c50405666cd8afad71d99dceb7b340'],1,8,9,835840,2,0,0,1,2039
501125588052827d92a90f8a56d07cbbbdad2fa7,0,Mate Szalay-Beko,2020-06-08 12:44:38+00:00,['db99959ef338783102f8755b4d10c1443f709425'],0,13,13,835853,2,0,0.222222222,1,2039
79a99ac97cea942967a2a08e7873a0cea9a2e046,0,Mate Szalay-Beko,2020-06-08 13:07:12+00:00,['501125588052827d92a90f8a56d07cbbbdad2fa7'],0,198,198,836051,4,0.3125,1,1,2042
8c9590caeaaa9079d958eb79da77321586c76236,0,Norbert Kalmar,2020-06-10 15:21:39+02:00,['79a99ac97cea942967a2a08e7873a0cea9a2e046'],0,19,19,836070,1,,,,2042
8da9c723ac1a889c989ecefada722ed858049537,0,Enrico Olivelli,2020-06-16 11:28:10+02:00,['8c9590caeaaa9079d958eb79da77321586c76236'],20,24,44,836114,9,,,,2042
f6c9bac7d39e790171762e522fedb7b3af66d3c7,0,Enrico Olivelli,2020-06-19 09:55:12+02:00,['8da9c723ac1a889c989ecefada722ed858049537'],1,8,9,836123,1,1,1,1,2042
ac8534494c0f731e15d5a23ad099effc2d3119aa,0,Enrico Olivelli,2020-06-24 09:05:45+02:00,['f6c9bac7d39e790171762e522fedb7b3af66d3c7'],1,18,19,836142,4,0.2,0.4,1,2042
6ab1822ec431bb3309021c1ddc613a5eaa28d83b,0,Mate Szalay-Beko,2020-06-30 15:01:07+00:00,['ac8534494c0f731e15d5a23ad099effc2d3119aa'],13,13,26,836168,3,,,,2042
f362313860401024b7141489e66ee76af442eb76,0,Enrico Olivelli,2020-07-13 12:10:05+02:00,['6ab1822ec431bb3309021c1ddc613a5eaa28d83b'],7,123,130,836298,4,0.5,0.926829268,0.87804878,2042
5b58e19c85ca1dfb8b2a0eec1411b34e6ca2e47b,0,Enrico Olivelli,2020-07-17 17:31:32+02:00,['f362313860401024b7141489e66ee76af442eb76'],2,6,8,836306,2,,,,2042
d1c40dd130a232f8b8b68940db607f14d3667f6e,1,Enrico Olivelli,2020-07-24 08:46:43+02:00,['5b58e19c85ca1dfb8b2a0eec1411b34e6ca2e47b'],0,71,71,836377,1,,,,2043
281a7c30c4485c34ea11e7051e55ebf6a859b993,0,Andor Molnar,2020-07-24 11:27:47+02:00,['d1c40dd130a232f8b8b68940db607f14d3667f6e'],27,6,33,836410,2,0.944444444,0,0,2043
5de840cdfd0396341e390470c3e03c370196ce64,0,Enrico Olivelli,2020-07-24 13:27:39+02:00,['281a7c30c4485c34ea11e7051e55ebf6a859b993'],2,2,4,836414,1,,,,2043
1c41e127537f66842515ccb21fb48f1670003454,0,Enrico Olivelli,2020-07-27 15:47:20+02:00,['5de840cdfd0396341e390470c3e03c370196ce64'],1,0,1,836415,1,,,,2043
6a8728d98307f7d52cf6dbadb78149e01b1d0bf5,0,Mate Szalay-Beko,2020-07-28 08:29:28+00:00,['1c41e127537f66842515ccb21fb48f1670003454'],1,3,4,836419,1,,,,2043
2898ffddb05df4e826be34ad13478e78ad6fb321,0,Enrico Olivelli,2020-07-29 11:37:21+02:00,['6a8728d98307f7d52cf6dbadb78149e01b1d0bf5'],8,68,76,836495,2,,,,2044
8a72a6e6c30db7dd66203dc2def1ede54882856b,0,Enrico Olivelli,2020-07-29 12:00:37+02:00,['2898ffddb05df4e826be34ad13478e78ad6fb321'],5,20,25,836520,3,1,1,1,2044
c9f15213663fc9b86809adcbc27a4dbe1232c31a,0,Enrico Olivelli,2020-07-29 12:31:40+02:00,['8a72a6e6c30db7dd66203dc2def1ede54882856b'],1,6,7,836527,1,,,,2044
ce523e01938e26ad92d613bd28b59501e9a853df,0,Mate Szalay-Beko,2020-07-29 16:55:45+00:00,['c9f15213663fc9b86809adcbc27a4dbe1232c31a'],0,32,32,836559,3,0.333333333,0,0.777777778,2044
b776b2360ac282fc4eef1e86fcf185d7a6c3eae5,0,Mate Szalay-Beko,2020-07-31 13:42:18+00:00,['ce523e01938e26ad92d613bd28b59501e9a853df'],2,49,51,836610,4,1,1,1,2044
c42c8c94085ed1d94a22158fbdfe2945118a82bc,1,Norbert Kalmar,2020-08-04 15:01:52+02:00,['b776b2360ac282fc4eef1e86fcf185d7a6c3eae5'],4946,5410,10356,846966,306,1,1,0,2044
531aae3edcf88819f90a324de3171276ecfaba25,0,Norbert Kalmar,2020-08-06 16:53:00+02:00,['c42c8c94085ed1d94a22158fbdfe2945118a82bc'],15,19,34,847000,3,,,,2044
4df268b970f525d128219ec81007355d77f6417c,0,Norbert Kalmar,2020-08-06 18:46:52+02:00,['531aae3edcf88819f90a324de3171276ecfaba25'],12,2,14,847014,2,0,0,0,2044
08ae49dee4d698fb8c926f3842acdcb0f5b3c58e,0,Mate Szalay-Beko,2020-08-07 12:46:45+02:00,['4df268b970f525d128219ec81007355d77f6417c'],96,104,200,847214,5,1,1,1,2044
b86899ec9ced35c895f9c0a8a54f2396e94a76c0,0,Enrico Olivelli,2020-08-08 11:51:43+02:00,['08ae49dee4d698fb8c926f3842acdcb0f5b3c58e'],6,95,101,847315,6,0.025641026,1,0.743589744,2045
0b386e4579645761e341510b185899d060e51c82,0,Andor Molnar,2020-08-12 11:46:50+02:00,['b86899ec9ced35c895f9c0a8a54f2396e94a76c0'],11,7,18,847333,5,,,,2045
e6c089b0721aa99803d792d64a4949e057395cda,0,Enrico Olivelli,2020-08-14 16:44:01+02:00,['0b386e4579645761e341510b185899d060e51c82'],0,12,12,847345,2,,,,2045
e16361d8769eea9e834fd587c3914463b1fb62ed,0,Enrico Olivelli,2020-08-21 17:54:46+02:00,['e6c089b0721aa99803d792d64a4949e057395cda'],1,1,2,847347,1,,,,2045
fa846cbb70c031bdc126977d453dae1812b0012a,0,Mate Szalay-Beko,2020-08-24 07:47:38+00:00,['e16361d8769eea9e834fd587c3914463b1fb62ed'],2,8,10,847357,1,,,,2045
9c3281f17be8ad899a03327ccdde612ee6ef9be1,0,Mate Szalay-Beko,2020-08-27 16:57:38+00:00,['fa846cbb70c031bdc126977d453dae1812b0012a'],1,1,2,847359,1,,,,2045
d33193a968d4f1ffc5047c40b7a293af04f35a47,0,Andor Molnar,2020-09-03 11:38:47+02:00,['9c3281f17be8ad899a03327ccdde612ee6ef9be1'],41,0,41,847400,10,,,,2045
efe83baeaa6715c32383a383f33f70522c1b7614,0,Mate Szalay-Beko,2020-09-14 07:09:01+00:00,['d33193a968d4f1ffc5047c40b7a293af04f35a47'],4,6,10,847410,1,1,1,1,2045
c47ef905e077184bc5b7f555a3e2dfeb6dc046e1,1,Enrico Olivelli,2020-09-17 07:35:11+02:00,['efe83baeaa6715c32383a383f33f70522c1b7614'],18,142,160,847570,5,0.322222222,1,1,2045
63f744b2f4aef1806adfd22823984c561156e243,0,Enrico Olivelli,2020-09-17 13:42:25+02:00,['c47ef905e077184bc5b7f555a3e2dfeb6dc046e1'],1,2,3,847573,1,,,,2045
500372dc7d076617cbe2509ed8e073470f3807a8,0,Andor Molnar,2020-09-17 19:46:50+02:00,['63f744b2f4aef1806adfd22823984c561156e243'],1,0,1,847574,1,,,,2045
4a2d58219b7435c3b8cdf8f7ab04b158c1900223,0,Michael Han,2020-09-20 08:53:16-07:00,['500372dc7d076617cbe2509ed8e073470f3807a8'],0,1,1,847575,1,,,,2045
492fd79b0c7845f1b7f3717632471d79660d1363,0,Mate Szalay-Beko,2020-09-23 12:13:34+00:00,['4a2d58219b7435c3b8cdf8f7ab04b158c1900223'],101,80,181,847756,24,,,,2045
56dfde5da4e441b139e85930291729d6b77a18ac,1,Mate Szalay-Beko,2020-09-28 07:22:15+00:00,['492fd79b0c7845f1b7f3717632471d79660d1363'],1,91,92,847848,2,0.416666667,1,0.583333333,2045
38f8e1bff2502d57dd4541ddd5d7e8b4ac10bc02,0,Mate Szalay-Beko,2020-09-28 07:26:25+00:00,['56dfde5da4e441b139e85930291729d6b77a18ac'],0,1,1,847849,1,0,0,1,2045
8260e876f26b4a8953b8a60a11515aab69ad1fb6,0,Michael Han,2020-09-30 21:23:24-07:00,['38f8e1bff2502d57dd4541ddd5d7e8b4ac10bc02'],9,0,9,847858,1,,,,2045
dd01a8b2882dbd9110d9a6879afa80b01cb3f4cd,0,Michael Han,2020-09-30 21:25:30-07:00,['8260e876f26b4a8953b8a60a11515aab69ad1fb6'],0,16,16,847874,1,,,,2045
bd06861b98319e5567b9a215492b397129fa47b4,0,Michael Han,2020-09-30 21:27:18-07:00,['dd01a8b2882dbd9110d9a6879afa80b01cb3f4cd'],2,2,4,847878,1,,,,2045
e4c175fba845d7b765afc0d36db2f5b7145dec5e,0,Michael Han,2020-09-30 21:35:30-07:00,['bd06861b98319e5567b9a215492b397129fa47b4'],0,20,20,847898,2,0.615384615,0.769230769,1,2045
495906063078a477e26f4e99e14dfe8f89007625,0,Michael Han,2020-09-30 21:39:51-07:00,['e4c175fba845d7b765afc0d36db2f5b7145dec5e'],6,0,6,847904,1,,,,2045
b51b1ee6291ecfb578dcf7ec6bbbc83e900ffd15,0,Enrico Olivelli,2020-10-02 18:05:38+02:00,['495906063078a477e26f4e99e14dfe8f89007625'],17,30,47,847951,1,1,1,1,2045
908c4480ee6036bc4024309b7b16318671ae416c,0,Michael Han,2020-10-02 19:12:55-07:00,['b51b1ee6291ecfb578dcf7ec6bbbc83e900ffd15'],34,60,94,848045,2,1,1,1,2045
663081d249626d20d6a2cfa75396b2a3d4454085,0,Norbert Kalmar,2020-10-05 17:01:34+02:00,['908c4480ee6036bc4024309b7b16318671ae416c'],3,3,6,848051,2,,,,2045
ec1503bb00945471baa248f392eed51064bb48ab,0,Mate Szalay-Beko,2020-10-06 09:29:46+00:00,['663081d249626d20d6a2cfa75396b2a3d4454085'],44,356,400,848451,12,0.639784946,1,0.274193548,2047
d3282c62ddb30a8ce265dcebca0e106c51f07ca3,0,Mate Szalay-Beko,2020-10-06 10:39:37+00:00,['ec1503bb00945471baa248f392eed51064bb48ab'],32,60,92,848543,6,1,1,1,2047
391bb7e636300fba24da185b8d0c4e0b854dc8b6,0,Enrico Olivelli,2020-10-06 17:51:15+02:00,['d3282c62ddb30a8ce265dcebca0e106c51f07ca3'],0,61,61,848604,1,,,,2048
83d79d16d683dbf07a8a1b52ed97558530f92f89,0,Norbert Kalmar,2020-10-08 20:03:51+02:00,['391bb7e636300fba24da185b8d0c4e0b854dc8b6'],962,884,1846,850450,24,0.789115646,1,0.680272109,2051
c4169b6f64b8a8668f2037adcf71148752d3066d,0,Mate Szalay-Beko,2020-10-09 13:07:15+00:00,['83d79d16d683dbf07a8a1b52ed97558530f92f89'],0,10,10,850460,1,,,,2051
3ca408d05c4cc2e038dced1065df844174ac69cf,0,Mate Szalay-Beko,2020-10-09 13:27:41+00:00,['c4169b6f64b8a8668f2037adcf71148752d3066d'],0,39,39,850499,1,,,,2052
6b222fbca9da8795bbf71c7533e5da220831fe92,0,Mate Szalay-Beko,2020-10-12 06:40:18+00:00,['3ca408d05c4cc2e038dced1065df844174ac69cf'],14,14,28,850527,1,,,,2052
064d8f91ae95b05b65a0a897238d77d2ade941d2,0,Mate Szalay-Beko,2020-10-12 06:42:46+00:00,['6b222fbca9da8795bbf71c7533e5da220831fe92'],2,14,16,850543,1,1,1,1,2052
06405a8e67b2e86347f3b68b72cb9bfba0cd2b2a,0,Mate Szalay-Beko,2020-10-12 07:27:25+00:00,['064d8f91ae95b05b65a0a897238d77d2ade941d2'],1,1,2,850545,1,,,,2052
fae62f521a5cf36e2d35f5646aa34d2ed3ae3415,0,Andor Molnar,2020-10-12 12:59:11+02:00,['06405a8e67b2e86347f3b68b72cb9bfba0cd2b2a'],2,3,5,850550,1,,,,2052
697ec978104c5b6811923f544392f27df2806723,0,Enrico Olivelli,2020-10-12 15:04:12+02:00,['fae62f521a5cf36e2d35f5646aa34d2ed3ae3415'],1,0,1,850551,1,,,,2052
4432f5b44359f56007f1ea5be5de2a9829c97e5c,0,Norbert Kalmar,2020-10-13 14:43:12+02:00,['697ec978104c5b6811923f544392f27df2806723'],3,1927,1930,852481,18,0.717698154,0.918566775,0.931596091,2065
eeb1ceb6f82b67b8b46d5ff9481908f7ec943f19,0,Andor Molnar,2020-10-20 16:21:30+02:00,['4432f5b44359f56007f1ea5be5de2a9829c97e5c'],6,6,12,852493,3,,,,2065
1af3dcc633d4829864da74ca6b030428448fcc16,0,Michael Han,2020-10-20 19:41:38-07:00,['eeb1ceb6f82b67b8b46d5ff9481908f7ec943f19'],40,493,533,853026,10,0.527777778,0.94047619,0.96031746,2067
e4534976898520b5c334a55761672dc03dff5727,0,Michael Han,2020-10-20 20:13:42-07:00,['1af3dcc633d4829864da74ca6b030428448fcc16'],4,4,8,853034,2,,,,2067
f06db8c91becf812c539747a406ba84635b2c1ac,0,Michael Han,2020-10-20 20:17:34-07:00,['e4534976898520b5c334a55761672dc03dff5727'],21,2,23,853057,1,0.5,0,0,2067
ffcea5b291c5a26fd8dff66a9752b80f559394e1,0,Mate Szalay-Beko,2020-10-22 07:50:53+00:00,['f06db8c91becf812c539747a406ba84635b2c1ac'],0,5,5,853062,1,1,1,0,2067
3ff30a6427fdc2f13e60ff530800eca55ff02c9a,0,Mate Szalay-Beko,2020-10-24 13:18:10+00:00,['ffcea5b291c5a26fd8dff66a9752b80f559394e1'],2,3,5,853067,1,,,,2067
a6ca5f307e20df1e62ce5415d84235ec00f57286,1,Mate Szalay-Beko,2020-10-25 15:02:24+00:00,['3ff30a6427fdc2f13e60ff530800eca55ff02c9a'],3,193,196,853263,10,0.525252525,0.898989899,1,2068
b59bf6b40d9948e4a9034b6342b7f98a71d8d616,0,Damien Diederen,2020-10-28 10:18:26+00:00,['a6ca5f307e20df1e62ce5415d84235ec00f57286'],21,22,43,853306,7,1,1,1,2068
8853b33fa6abd132ab7d446296eca5f4445f9c2c,0,Damien Diederen,2020-10-28 15:27:44+00:00,['b59bf6b40d9948e4a9034b6342b7f98a71d8d616'],3,5,8,853314,1,0,0,1,2068
8654e7ed37717df79eb06f75de43eafe4f47b175,0,Enrico Olivelli,2020-10-30 12:03:41+01:00,['8853b33fa6abd132ab7d446296eca5f4445f9c2c'],82,101,183,853497,32,1,0,0,2068
13fe0d0ffb9fd2c379b9b430aaaf9ee75acfceba,1,Enrico Olivelli,2020-10-30 13:16:09+01:00,['8654e7ed37717df79eb06f75de43eafe4f47b175'],85,85,170,853667,32,,,,2068
392846c534c51a57aa678691d411ad7d8d68e29a,0,Mate Szalay-Beko,2020-11-02 16:58:08+00:00,['13fe0d0ffb9fd2c379b9b430aaaf9ee75acfceba'],2,343,345,854012,7,0.807453416,0.98757764,1,2070
5b034a4362e41a62da43979ad0fb6c97477c1624,0,Norbert Kalmar,2020-11-03 17:01:59+01:00,['392846c534c51a57aa678691d411ad7d8d68e29a'],10,6,16,854028,1,0,0,0,2070
7d47a1792170099276c28456eea523d4d1067a6c,0,Damien Diederen,2020-11-04 07:43:20+00:00,['5b034a4362e41a62da43979ad0fb6c97477c1624'],1,1,2,854030,1,,,,2070
3df3563173e1790d64eae3bc5509f02683d71298,0,Damien Diederen,2020-11-05 09:57:20+00:00,['7d47a1792170099276c28456eea523d4d1067a6c'],5,4,9,854039,4,0,0,0,2070
744f03938eeda4e579369773735508e61a1825ad,0,Damien Diederen,2020-11-05 12:19:54+00:00,['3df3563173e1790d64eae3bc5509f02683d71298'],8,1,9,854048,1,,,,2070
375a81391428533dac5594565c700c65b1ba2690,0,Enrico Olivelli,2020-11-06 08:52:13+01:00,['744f03938eeda4e579369773735508e61a1825ad'],0,1414,1414,855462,7,,,,2077
c9a1b595f9afd07ce6359810a5ca8e4f4088c5a2,0,Damien Diederen,2020-11-09 11:20:11+00:00,['375a81391428533dac5594565c700c65b1ba2690'],0,17,17,855479,2,1,1,0.857142857,2077
3bbf08da066c7a904ef5d3aaddd64da1a8b031da,0,Enrico Olivelli,2020-11-09 13:53:27+01:00,['c9a1b595f9afd07ce6359810a5ca8e4f4088c5a2'],25,82,107,855586,3,1,0.428571429,1,2077
7f66c7680f7b79eb1ba1cf253b4534de88ad3404,0,Norbert Kalmar,2020-11-09 15:33:15+01:00,['3bbf08da066c7a904ef5d3aaddd64da1a8b031da'],35,9,44,855630,2,0,0,0,2077
33bf36457318c1eed640bb990f2cbe6da96673b4,0,Damien Diederen,2020-11-12 13:31:55+00:00,['7f66c7680f7b79eb1ba1cf253b4534de88ad3404'],18,9,27,855657,1,0,0,0,2077
b978dfb949e4ac4d703e956c6ef811415c831bcd,0,Norbert Kalmar,2020-11-12 16:03:25+01:00,['33bf36457318c1eed640bb990f2cbe6da96673b4'],5,325,330,855987,3,0.306010929,0.306010929,1,2078
58e0a7741533ec3598c619c526208f8a90f5756c,0,Mate Szalay-Beko,2020-11-16 07:41:58+00:00,['b978dfb949e4ac4d703e956c6ef811415c831bcd'],0,1,1,855988,1,0,1,1,2078
d8561f620fa8611e9a6819d9879b0f18e5a404a9,0,Mate Szalay-Beko,2020-11-16 08:03:48+00:00,['58e0a7741533ec3598c619c526208f8a90f5756c'],28,149,177,856165,8,1,1,1,2079
b842cd4b463a7c3674963f6f66fc392293c1334c,1,Damien Diederen,2020-11-16 10:00:18+00:00,['d8561f620fa8611e9a6819d9879b0f18e5a404a9'],6,291,297,856462,12,0.66025641,0.698717949,0.948717949,2080
b2b06dca8ecffcfaa35ba5797d3c8d82045cbe08,0,Andor Molnar,2020-11-16 16:37:16+01:00,['b842cd4b463a7c3674963f6f66fc392293c1334c'],2,96,98,856560,3,0,1,1,2081
6dfdf14a637d853bd77236dfbdd347912808074f,0,Damien Diederen,2020-11-17 17:24:51+00:00,['b2b06dca8ecffcfaa35ba5797d3c8d82045cbe08'],20,50,70,856630,2,1,1,1,2081
300d7e9575496d10c92e7f0edca2bbc3746cb08d,0,Damien Diederen,2020-11-17 17:37:31+00:00,['6dfdf14a637d853bd77236dfbdd347912808074f'],6,1,7,856637,1,0,0,0,2081
12b4e6821997534e1ff58e2e29b9df0beab817d3,0,Damien Diederen,2020-11-18 18:18:12+00:00,['300d7e9575496d10c92e7f0edca2bbc3746cb08d'],12,1168,1180,857817,22,0.294214876,0.702479339,0.927272727,2092
ea3042d5c4d17b7e645d07a73d0cb9e832d0e9f0,0,Damien Diederen,2020-11-23 11:39:38+00:00,['12b4e6821997534e1ff58e2e29b9df0beab817d3'],24,22,46,857863,1,1,1,0,2092
efbd660e1c4b90a8f538f2cccb5dcb7094cf9a22,0,Enrico Olivelli,2020-11-23 12:53:14+01:00,['ea3042d5c4d17b7e645d07a73d0cb9e832d0e9f0'],1,146,147,858010,3,0,0,1,2092
ef1f12fbe8865aaa675adf8f844487e71e1b6a77,0,Norbert Kalmar,2020-11-24 15:37:33+01:00,['efbd660e1c4b90a8f538f2cccb5dcb7094cf9a22'],1415,2906,4321,862331,15,,,,2099
59c87413ddc6774a22b98ba8aabb5855e049efe9,0,Damien Diederen,2020-12-24 14:36:56+00:00,['ef1f12fbe8865aaa675adf8f844487e71e1b6a77'],1262,1669,2931,865262,12,,,,2103
a67272a0ad8b1138c61306a02563fc39a0c79101,0,Damien Diederen,2020-12-24 17:12:37+00:00,['59c87413ddc6774a22b98ba8aabb5855e049efe9'],7,5,12,865274,1,1,1,0,2103
701e134dfba721356deac1a20aa80e94ec80484a,0,Enrico Olivelli,2020-12-31 09:46:09+01:00,['a67272a0ad8b1138c61306a02563fc39a0c79101'],0,8,8,865282,1,,,,2103
b35f43627d45c9c70679b104ea24b1f8e3451789,0,Enrico Olivelli,2021-01-05 14:22:10+01:00,['701e134dfba721356deac1a20aa80e94ec80484a'],27,179,206,865488,3,0.714285714,0.714285714,0.936507937,2104
0a6b055356128483ad4166ca8cd5eff26f66fefb,0,Norbert Kalmar,2021-01-05 16:27:46+01:00,['b35f43627d45c9c70679b104ea24b1f8e3451789'],17,13,30,865518,5,1,1,1,2104
676d10b2fad97c69e4083619cb1db223ed1896a4,0,Norbert Kalmar,2021-01-06 19:50:08+01:00,['0a6b055356128483ad4166ca8cd5eff26f66fefb'],1,1,2,865520,1,,,,2104
4e82a8be889d91dde46a11b38c8a20e82f3220f2,0,Damien Diederen,2021-01-07 08:09:55+00:00,['676d10b2fad97c69e4083619cb1db223ed1896a4'],0,97,97,865617,1,,,,2104
eeb053767c9e931ae72a2d8c59c0940da3da9679,0,Damien Diederen,2021-01-10 18:50:44+00:00,['4e82a8be889d91dde46a11b38c8a20e82f3220f2'],1,12,13,865630,1,,,,2104
b995c559e6a567deaeb5b87c136aaa97d574d8de,0,Enrico Olivelli,2021-01-11 12:02:19+01:00,['eeb053767c9e931ae72a2d8c59c0940da3da9679'],6,6,12,865642,6,,,,2104
183e38308d985981a94af16663860d7649621702,0,Damien Diederen,2021-01-13 08:12:25+00:00,['b995c559e6a567deaeb5b87c136aaa97d574d8de'],1,1,2,865644,1,,,,2104
7fad7ea33365304f8c268279689a6cbeed6698bc,0,Damien Diederen,2021-01-13 08:25:51+00:00,['183e38308d985981a94af16663860d7649621702'],4,148,152,865796,4,0,1,1,2104
d7ed7f305661c08927eb954700f7141cd18d4ff9,1,Damien Diederen,2021-01-13 16:00:03+00:00,['7fad7ea33365304f8c268279689a6cbeed6698bc'],74,238,312,866108,7,,,,2106
9a9cb66d433126598afe23bc70c7146682541071,0,Damien Diederen,2021-01-14 18:26:44+00:00,['d7ed7f305661c08927eb954700f7141cd18d4ff9'],7,3,10,866118,3,,,,2106
fe86ef3b1ebba33488b3426e04b3c4c5b75e2c53,0,Damien Diederen,2021-01-14 18:26:44+00:00,['9a9cb66d433126598afe23bc70c7146682541071'],22,22,44,866162,21,,,,2106
86fcb5a00fbe2756100d78fe8bb7bb5f0a730bc9,0,Damien Diederen,2021-01-14 18:32:08+00:00,['fe86ef3b1ebba33488b3426e04b3c4c5b75e2c53'],3,3,6,866168,3,,,,2106
e8dc2b3210b001094b6179e0deacdb2cebded31f,0,Damien Diederen,2021-01-17 20:20:43+00:00,['86fcb5a00fbe2756100d78fe8bb7bb5f0a730bc9'],52,47,99,866267,7,,,,2106
190a227aa9d4655ebfe6ba9f5c2da426da8c5d98,1,Damien Diederen,2021-01-19 08:05:37+00:00,['e8dc2b3210b001094b6179e0deacdb2cebded31f'],218,1313,1531,867798,20,0.488636364,0.668831169,1,2109
4f4a7fc27996744edb79ba69a56cdd0a8d066bce,0,maoling,2021-01-22 01:43:42+08:00,['190a227aa9d4655ebfe6ba9f5c2da426da8c5d98'],4,4,8,867806,2,,,,2109
9aeaae5bb422c5a4262de84cf8704b02883e5006,0,maoling,2021-01-24 01:41:25+08:00,['4f4a7fc27996744edb79ba69a56cdd0a8d066bce'],16,17,33,867839,3,,,,2109
3b6fefc43221fb3626740618a68562ff1ba707c0,0,maoling,2021-01-24 01:58:11+08:00,['9aeaae5bb422c5a4262de84cf8704b02883e5006'],4,4,8,867847,2,,,,2109
006d9f0da6d46183995cf98c43348364bbdeed9c,0,maoling,2021-01-24 02:14:31+08:00,['3b6fefc43221fb3626740618a68562ff1ba707c0'],1,1,2,867849,1,,,,2109
7af6428fa825ae5bd3938f3a8fd21a92abd4aadb,0,maoling,2021-01-24 17:26:29+08:00,['006d9f0da6d46183995cf98c43348364bbdeed9c'],3,0,3,867852,1,1,1,0,2109
e7d67da8d49ab0bb19ff1c2a5e5ce02f23596402,0,Damien Diederen,2021-01-24 18:11:25+00:00,['7af6428fa825ae5bd3938f3a8fd21a92abd4aadb'],0,1,1,867853,1,,,,2109
62e29cc5abe1cd5b668160ae0b3287a927fc429b,0,Damien Diederen,2021-01-24 18:17:12+00:00,['e7d67da8d49ab0bb19ff1c2a5e5ce02f23596402'],40,101,141,867994,4,,,,2109
a4d7586f397290b7265b4f52ec64af5ee6fe0778,0,Damien Diederen,2021-01-24 18:24:03+00:00,['62e29cc5abe1cd5b668160ae0b3287a927fc429b'],0,12,12,868006,1,,,,2109
fc28f4ec48a674ec1e074645109e2aae87739fe5,0,maoling,2021-01-25 16:26:49+08:00,['a4d7586f397290b7265b4f52ec64af5ee6fe0778'],0,30,30,868036,1,,,,2109
a30acd2b9168042d52f593c985cbbda8622d83d7,0,maoling,2021-01-26 22:35:44+08:00,['fc28f4ec48a674ec1e074645109e2aae87739fe5'],23,5,28,868064,1,1,0.666666667,0.166666667,2109
2480c4ae232a60c8601d286831d9e88b7f3d053f,0,maoling,2021-01-28 14:40:17+08:00,['a30acd2b9168042d52f593c985cbbda8622d83d7'],1,1,2,868066,1,,,,2109
c481d3ced22ac69dc8549a4244f7dc10c2623155,0,maoling,2021-01-30 16:13:26+08:00,['2480c4ae232a60c8601d286831d9e88b7f3d053f'],13,13,26,868092,3,,,,2109
ae5443e2c5ba67fcfe3decac084f6dff9ab8a383,0,maoling,2021-02-02 15:11:39+08:00,['c481d3ced22ac69dc8549a4244f7dc10c2623155'],23,6,29,868121,1,0.333333333,0.333333333,0.333333333,2109
245ff759b0e9fe0a1815e03433306ac805bf5e95,0,Damien Diederen,2021-02-04 08:15:37+00:00,['ae5443e2c5ba67fcfe3decac084f6dff9ab8a383'],37,60,97,868218,1,1,1,1,2109
4faf507771889c7f6280d41ac4a615467680553f,0,maoling,2021-02-08 20:08:14+08:00,['245ff759b0e9fe0a1815e03433306ac805bf5e95'],1,1,2,868220,1,,,,2109
1c92a1f950d5efd2956fe85c6b9c843648b7a6e8,1,Andor Molnar,2021-02-09 12:00:07+01:00,['4faf507771889c7f6280d41ac4a615467680553f'],1,1,2,868222,1,,,,2109
8c68933226595b839ba3694dacd39cd2b2a21878,0,Enrico Olivelli,2021-02-09 16:30:54+01:00,['1c92a1f950d5efd2956fe85c6b9c843648b7a6e8'],1,0,1,868223,1,,,,2109
c26f96c089f20902a39cb0088e68a5b58e35c024,0,Damien Diederen,2021-02-17 17:12:11+00:00,['8c68933226595b839ba3694dacd39cd2b2a21878'],1,1,2,868225,1,,,,2109
884fc38db166617e03d03f793ef917febcc131be,0,Damien Diederen,2021-02-17 17:22:40+00:00,['c26f96c089f20902a39cb0088e68a5b58e35c024'],1,1,2,868227,9,,,,2109
d8ff555339b054fbcf6ea6767357e8bf8c7af2c5,0,Enrico Olivelli,2021-02-17 20:18:55+01:00,['884fc38db166617e03d03f793ef917febcc131be'],7,7,14,868241,1,,,,2109
58b4c10be5e6b992caac3b99a506e1d61bdec24d,0,Enrico Olivelli,2021-02-17 20:20:38+01:00,['d8ff555339b054fbcf6ea6767357e8bf8c7af2c5'],0,46,46,868287,4,,,,2109
37eae03080b93d63a6ba9f624b37c764511ad2dc,0,Mate Szalay-Beko,2021-02-18 08:40:55+00:00,['58b4c10be5e6b992caac3b99a506e1d61bdec24d'],0,8,8,868295,1,1,1,1,2109
94d0c4d8558e1b201665bb9dffd33dacbc7ca945,0,Mate Szalay-Beko,2021-02-26 09:35:02+00:00,['37eae03080b93d63a6ba9f624b37c764511ad2dc'],1,4,5,868300,1,0,0,1,2109
eb1569e4fbb55d12fa6211fbd997aa592fcb01af,0,Norbert Kalmar,2021-03-01 08:36:33+01:00,['94d0c4d8558e1b201665bb9dffd33dacbc7ca945'],12,59,71,868371,3,0.5,1,1,2109
b4f9aab099880ba8ef08eaff697debe6cdeae057,1,ben reed,2021-03-01 20:51:05-08:00,['eb1569e4fbb55d12fa6211fbd997aa592fcb01af'],85,1228,1313,869684,24,0.404850746,0.740671642,0.819029851,2113
425ee189dcf952fd7a2a38df375ec245dcdfbfc6,0,Mohammad Arshad,2021-03-02 11:25:47+05:18,['b4f9aab099880ba8ef08eaff697debe6cdeae057'],7,23,30,869714,2,1,1,1,2113
1214d3bf611d153ae8c3987523da01d3d6c82686,0,Damien Diederen,2021-03-06 19:40:32+00:00,['425ee189dcf952fd7a2a38df375ec245dcdfbfc6'],7,76,83,869797,5,0.109090909,0.109090909,1,2113
6022e03177b21606575152ac323205af3fbbe9d8,0,Damien Diederen,2021-03-06 20:52:24+00:00,['1214d3bf611d153ae8c3987523da01d3d6c82686'],1,1,2,869799,1,,,,2113
f39caf6fd717acced2e8eb2bbdf98e92395858c5,0,Damien Diederen,2021-03-06 21:29:38+00:00,['6022e03177b21606575152ac323205af3fbbe9d8'],5,8,13,869812,1,,,,2113
eafb93ac3edd28ff23b5b08b05e6ead7e44d85c6,0,Damien Diederen,2021-03-07 09:49:58+00:00,['f39caf6fd717acced2e8eb2bbdf98e92395858c5'],14,16,30,869842,1,,,,2113
0ab7766a8a968e03c7b3bb7c1b9d42af9eea152e,0,Mohammad Arshad,2021-03-09 19:43:27+05:18,['eafb93ac3edd28ff23b5b08b05e6ead7e44d85c6'],1,27,28,869870,2,0.846153846,1,1,2113
1944f77aab458c79de0aee91c766b3c04c0d6417,0,Damien Diederen,2021-03-09 20:29:08+00:00,['0ab7766a8a968e03c7b3bb7c1b9d42af9eea152e'],44,40,84,869954,1,,,,2113
2f98b8feb297ca0b44f6686870078f2ce8d3d303,0,Mohammad Arshad,2021-03-10 10:39:38+05:18,['1944f77aab458c79de0aee91c766b3c04c0d6417'],415,1,416,870370,9,,,,2113
f52918abd066d85a423d38917e58fc950d4e9d09,0,Enrico Olivelli,2021-03-10 12:52:24+01:00,['2f98b8feb297ca0b44f6686870078f2ce8d3d303'],1,4,5,870375,1,0,1,1,2113
04471b2e117a0cbe08c42b0482f0adca93494e7c,0,Mohammad Arshad,2021-03-11 10:24:48+05:18,['f52918abd066d85a423d38917e58fc950d4e9d09'],1,3,4,870379,1,0,1,1,2113
2e400114fdee9a870170749f6573d4499e1a850f,0,Mohammad Arshad,2021-03-11 23:53:07+05:18,['04471b2e117a0cbe08c42b0482f0adca93494e7c'],1,48,49,870428,3,0.636363636,0.636363636,1,2113
c74658d398cdc1d207aa296cb6e20de00faec03e,0,Mohammad Arshad,2021-03-17 13:50:13+05:18,['2e400114fdee9a870170749f6573d4499e1a850f'],1,3,4,870432,1,1,1,1,2113
0b6862e3aadbb8980a09a673c08c438ae5da2e81,0,Damien Diederen,2021-03-25 09:48:24+00:00,['c74658d398cdc1d207aa296cb6e20de00faec03e'],7,58,65,870497,3,0.25,1,0.78125,2113
461aada6b015078b9a14f787dd1f526488490df9,0,Damien Diederen,2021-03-25 10:21:31+00:00,['0b6862e3aadbb8980a09a673c08c438ae5da2e81'],2,2,4,870501,2,,,,2113
51be692523b65afc21cfb0edaa4a5e60ab996aa2,0,Mohammad Arshad,2021-03-27 22:29:02+05:18,['461aada6b015078b9a14f787dd1f526488490df9'],0,5,5,870506,1,,,,2113
de726d0a824582e482d4a725210fcd6051cb3bd0,0,Mohammad Arshad,2021-03-27 22:41:02+05:18,['51be692523b65afc21cfb0edaa4a5e60ab996aa2'],1,8,9,870515,2,1,1,1,2113
4edbbea5566925390b32702a97c17f7a76e32de5,0,Mohammad Arshad,2021-03-27 23:19:42+05:18,['de726d0a824582e482d4a725210fcd6051cb3bd0'],0,3,3,870518,1,1,1,1,2113
670da71f121ec532b262de39496042cefccf2120,0,maoling,2021-03-28 10:01:11+08:00,['4edbbea5566925390b32702a97c17f7a76e32de5'],0,11,11,870529,1,,,,2113
acbfb2d78996cbaa29b9dc764d4cb3463193dc45,0,Mohammad Arshad,2021-03-28 09:53:40+05:18,['670da71f121ec532b262de39496042cefccf2120'],12,96,108,870637,5,0.421052632,1,1,2113
3961bcc7d6eabfe0723c9dab653d9bb83da7f8f8,0,Mohammad Arshad,2021-03-30 16:44:40+05:18,['acbfb2d78996cbaa29b9dc764d4cb3463193dc45'],7,27,34,870671,1,0,0,1,2113
9213f7353b1e6ce4d0fdbc1dca963ace1fd32cec,1,Mohammad Arshad,2021-03-31 18:52:23+05:18,['3961bcc7d6eabfe0723c9dab653d9bb83da7f8f8'],1,1,2,870673,9,,,,2113
cdddda4c55acf29d4e0b2bc8f3de7b5c676e8ffc,0,Mohammad Arshad,2021-04-01 02:40:49+05:18,['9213f7353b1e6ce4d0fdbc1dca963ace1fd32cec'],5,132,137,870810,3,0.444444444,0.87037037,1,2114
ad5513b8dd15637c6c95585603a4e055dabad56d,0,Damien Diederen,2021-04-03 11:42:31+00:00,['cdddda4c55acf29d4e0b2bc8f3de7b5c676e8ffc'],1,1,2,870812,1,,,,2114
061438e83e61692fc9e06e057a739db5327d42b9,0,maoling,2021-04-04 14:39:26+08:00,['ad5513b8dd15637c6c95585603a4e055dabad56d'],1,1,2,870814,1,,,,2114
a10c6b4a78fa28b785d18cc973026da971bb4fe3,0,maoling,2021-04-04 14:55:50+08:00,['061438e83e61692fc9e06e057a739db5327d42b9'],17,0,17,870831,2,0.071428571,0.071428571,0.071428571,2114
b08b6bb2ea7259face0df881dcbc9f5061a35d1e,0,Mohammad Arshad,2021-04-07 22:58:01+05:18,['a10c6b4a78fa28b785d18cc973026da971bb4fe3'],1,1,2,870833,8,,,,2114
925b5b28a0aa9e7749da9672de92eab5b95578f0,0,Mohammad Arshad,2021-04-08 19:37:08+05:18,['b08b6bb2ea7259face0df881dcbc9f5061a35d1e'],1,1,2,870835,9,,,,2114
7fdadf7273f34dd0552db25a3771cf55b65e9208,0,maoling,2021-04-10 13:41:38+08:00,['925b5b28a0aa9e7749da9672de92eab5b95578f0'],8,21,29,870864,1,,,,2114
ea75e1f63572fc72fb8520ba8c793523047acb49,0,Mohammad Arshad,2021-04-14 22:10:09+05:18,['7fdadf7273f34dd0552db25a3771cf55b65e9208'],1,5,6,870870,1,0,0,1,2114
c583a6e79654359b5daad5093d1730e370d3b75b,0,Mate Szalay-Beko,2021-04-19 06:46:15+00:00,['ea75e1f63572fc72fb8520ba8c793523047acb49'],0,2,2,870872,1,0,0,1,2114
1590a424cb7a8768b0ae01f2957856b1834dd68d,0,Enrico Olivelli,2021-04-21 10:07:24+02:00,['c583a6e79654359b5daad5093d1730e370d3b75b'],1,28,29,870901,2,0,1,1,2114
f8ebf1a25281b2c7f48e08011918c72643313209,0,maoling,2021-04-25 13:12:20+08:00,['1590a424cb7a8768b0ae01f2957856b1834dd68d'],1,1,2,870903,1,,,,2114
96d87e2809f92460f182c66311d83d59f2ab96c3,0,maoling,2021-04-26 20:20:36+08:00,['f8ebf1a25281b2c7f48e08011918c72643313209'],1,1,2,870905,1,,,,2114
f5c29aab9adb49d9d3580074d4d1a805579fa20d,0,maoling,2021-05-10 19:24:24+08:00,['96d87e2809f92460f182c66311d83d59f2ab96c3'],2,2,4,870909,2,,,,2114
766e173e9d51b6354920ebc136b246d221b87ec1,0,maoling,2021-05-15 23:50:02+08:00,['f5c29aab9adb49d9d3580074d4d1a805579fa20d'],12,24,36,870945,1,0,0,1,2114
fdbba27088335c79fac4cc1751c06dcada1b8751,0,maoling,2021-05-16 12:58:38+08:00,['766e173e9d51b6354920ebc136b246d221b87ec1'],1,2,3,870948,1,,,,2114
b79abb2014db9684c00afd7d98c0a7cb69ce6c8b,0,maoling,2021-05-17 23:10:41+08:00,['fdbba27088335c79fac4cc1751c06dcada1b8751'],2,77,79,871027,5,0.96969697,1,1,2115
e41dc7dbb0541745afdc768bf757e29c938a9ab8,0,Damien Diederen,2021-05-20 09:27:40+00:00,['b79abb2014db9684c00afd7d98c0a7cb69ce6c8b'],14,77,91,871118,11,0.956521739,0.956521739,1,2115
c499202a2c470e2e365ef109c8e49784cb043367,0,maoling,2021-05-24 22:21:42+08:00,['e41dc7dbb0541745afdc768bf757e29c938a9ab8'],1,1,2,871120,1,,,,2115
016ffd9a3ec2cb669071e881d677441314aa8bfd,0,maoling,2021-05-28 15:55:03+08:00,['c499202a2c470e2e365ef109c8e49784cb043367'],2,2,4,871124,1,,,,2115
5c102298f8a160ea996be7b6d6f95189d4ff2f41,0,maoling,2021-05-29 20:53:04+08:00,['016ffd9a3ec2cb669071e881d677441314aa8bfd'],0,83,83,871207,1,,,,2115
5e787c5990091b2d1fc560eba88d3c25b04690a2,0,maoling,2021-06-05 18:01:10+08:00,['5c102298f8a160ea996be7b6d6f95189d4ff2f41'],0,120,120,871327,1,,,,2115
32e40e8cee36ddba1973875ab6637912719271fa,0,maoling,2021-06-13 15:30:41+08:00,['5e787c5990091b2d1fc560eba88d3c25b04690a2'],20,9,29,871356,1,0,0,0,2115
5e6e15ac40cfd2cadac3e718e494a3c13b934b8d,0,Damien Diederen,2021-06-13 18:53:47+00:00,['32e40e8cee36ddba1973875ab6637912719271fa'],26,133,159,871515,8,0.473684211,0,1,2115
78550453204e89a13aee87d86b6d94c458c9dd63,0,Enrico Olivelli,2021-06-14 11:45:58+02:00,['5e6e15ac40cfd2cadac3e718e494a3c13b934b8d'],2,7,9,871524,1,0,0,1,2115
525a28bd1cb864a5783593c64908cfe0ddcba65f,0,maoling,2021-06-14 18:30:46+08:00,['78550453204e89a13aee87d86b6d94c458c9dd63'],0,11,11,871535,1,,,,2115
65dba9d9ab35cdef751473345af52089abc0da6e,0,maoling,2021-06-21 19:14:37+08:00,['525a28bd1cb864a5783593c64908cfe0ddcba65f'],8,6,14,871549,1,1,0,1,2115
2f00dea17bd94bf43b2f6647f6b08b00ff8b7ece,0,maoling,2021-06-27 14:12:52+08:00,['65dba9d9ab35cdef751473345af52089abc0da6e'],6,6,12,871561,1,,,,2115
9442ce23bade5286459ff78ade1af173f7b69c30,0,maoling,2021-06-27 15:21:26+08:00,['2f00dea17bd94bf43b2f6647f6b08b00ff8b7ece'],4,3,7,871568,1,1,1,0,2115
16187c48a1d9b339866b81e69c522021b031c4c3,0,maoling,2021-06-27 15:44:14+08:00,['9442ce23bade5286459ff78ade1af173f7b69c30'],31,13,44,871612,1,1,0,0,2115
2d3065606a444c0b711c1809ce296db2ba56cb0c,0,Damien Diederen,2021-06-30 06:53:49+00:00,['16187c48a1d9b339866b81e69c522021b031c4c3'],0,20,20,871632,3,0.666666667,0.733333333,1,2115
70f70d821c2c5225edeb54a8af0bd1911a51fc89,0,Damien Diederen,2021-06-30 06:59:22+00:00,['2d3065606a444c0b711c1809ce296db2ba56cb0c'],10,7,17,871649,1,1,1,0,2115
e642a325b91ab829aefa47708c7b4b45811d2d23,0,maoling,2021-07-11 20:01:09+08:00,['70f70d821c2c5225edeb54a8af0bd1911a51fc89'],1,1,2,871651,1,,,,2115
2aa17ffe428b9ac8477cedfed293b18f12c2376e,0,maoling,2021-07-18 15:17:50+08:00,['e642a325b91ab829aefa47708c7b4b45811d2d23'],2,37,39,871690,2,1,1,1,2115
a692cbab92e9bae53c9313241d9668d9de97ed8b,0,Enrico Olivelli,2021-07-28 11:24:15+02:00,['2aa17ffe428b9ac8477cedfed293b18f12c2376e'],12,198,210,871900,3,0.276785714,0.991071429,1,2115
e7de1cf04925b7e1d06f9add83d90760e5a7a241,0,Damien Diederen,2021-07-28 13:15:22+00:00,['a692cbab92e9bae53c9313241d9668d9de97ed8b'],3,23,26,871926,1,0,0,1,2115
7a368b4b196af02190e6e57f18f56598ee32a626,0,Damien Diederen,2021-07-28 13:30:39+00:00,['e7de1cf04925b7e1d06f9add83d90760e5a7a241'],8,8,16,871942,1,,,,2115
b05ea1a8454d806394e1ecdfca550e8c709d4c21,0,Damien Diederen,2021-07-29 09:35:47+00:00,['7a368b4b196af02190e6e57f18f56598ee32a626'],73,1417,1490,873432,20,0.42032967,0.847527473,0.837912088,2121
9a5da5f9a023e53bf339748b5b7b17278ae36475,0,Norbert Kalmar,2021-08-03 11:37:43+02:00,['b05ea1a8454d806394e1ecdfca550e8c709d4c21'],1,82,83,873515,3,,,,2121
3cdc62c132846a6e5fd06782730a986b3e5ea144,0,maoling,2021-08-08 16:08:32+08:00,['9a5da5f9a023e53bf339748b5b7b17278ae36475'],0,3,3,873518,1,1,1,1,2121
5f6ec6cc7fd303702dca31edd2317b33c6e66bd1,0,Mohammad Arshad,2021-08-11 20:28:33+05:18,['3cdc62c132846a6e5fd06782730a986b3e5ea144'],1,16,17,873535,2,0,1,1,2121
f72ef97b66bc890ce8366533eac5be393558a8fb,0,maoling,2021-08-21 17:21:30+08:00,['5f6ec6cc7fd303702dca31edd2317b33c6e66bd1'],6,9,15,873550,5,,,,2121
06467dc8c20e6c7357c19904f6214bb406262ba2,0,Enrico Olivelli,2021-08-25 14:14:22+02:00,['f72ef97b66bc890ce8366533eac5be393558a8fb'],0,3,3,873553,1,,,,2121
1f5e4fe258707f9b82448a5f97c931c392d011ca,0,Norbert Kalmar,2021-08-27 10:48:40+02:00,['06467dc8c20e6c7357c19904f6214bb406262ba2'],3,3,6,873559,1,,,,2121
24808051c78f06af22014cb8055e3f7f8fe08065,0,Damien Diederen,2021-09-01 08:44:31+00:00,['1f5e4fe258707f9b82448a5f97c931c392d011ca'],1,16,17,873576,2,,,,2121
2797116b33a505c8b36b396216c26afd7f7ba28c,0,Damien Diederen,2021-09-01 08:47:18+00:00,['24808051c78f06af22014cb8055e3f7f8fe08065'],0,1,1,873577,1,,,,2121
561231f8bfe910e63dbd8c281cb25033a0e7d7a5,0,Damien Diederen,2021-09-01 16:50:38+00:00,['2797116b33a505c8b36b396216c26afd7f7ba28c'],1,1,2,873579,8,,,,2121
726ec30fdd47bccd2a2be021cf6a6b848e9ee28b,0,Damien Diederen,2021-09-01 16:56:16+00:00,['561231f8bfe910e63dbd8c281cb25033a0e7d7a5'],6,214,220,873799,3,,,,2122
4f515673464e540fa8555b7a3ac85c5d1abe41fb,0,Damien Diederen,2021-09-02 16:48:15+00:00,['726ec30fdd47bccd2a2be021cf6a6b848e9ee28b'],26,34,60,873859,1,1,1,1,2122
1e74a3395a9c3c4d67093f9a073bffb5a176916c,0,maoling,2021-09-04 17:13:55+08:00,['4f515673464e540fa8555b7a3ac85c5d1abe41fb'],35,34,69,873928,1,,,,2122
d9d20aa1db311424336a564ae55367b4e20c4c9d,0,maoling,2021-09-11 13:30:47+08:00,['1e74a3395a9c3c4d67093f9a073bffb5a176916c'],0,4,4,873932,2,,,,2122
ce4c3d52e0dfb59ee758b77450ae13b196488c95,0,maoling,2021-09-11 13:34:36+08:00,['d9d20aa1db311424336a564ae55367b4e20c4c9d'],5,1,6,873938,1,0,0,0,2122
26001aacfeff519ccd6b0991b0cc38ab10ad6564,0,maoling,2021-09-22 19:04:37+08:00,['ce4c3d52e0dfb59ee758b77450ae13b196488c95'],5,3,8,873946,2,,,,2122
c0b19e0c5c2bbf1fb24e154466b6cc0fa6b5e74a,0,Damien Diederen,2021-09-22 15:22:12+00:00,['26001aacfeff519ccd6b0991b0cc38ab10ad6564'],5,6,11,873957,1,,,,2122
531bddd5b43d2f0b3afbe0051642830c47030652,0,maoling,2021-09-25 19:40:59+08:00,['c0b19e0c5c2bbf1fb24e154466b6cc0fa6b5e74a'],1,1,2,873959,1,,,,2122
d6b50ad739a49226e97ff28d68be605e1fa36fe5,0,Enrico Olivelli,2021-09-27 17:48:29+02:00,['531bddd5b43d2f0b3afbe0051642830c47030652'],12,27,39,873998,5,0.1,0.7,1,2122
2dcc64d9411e7b24402222437215ab2fe1e59c2e,0,maoling,2021-10-02 13:58:31+08:00,['d6b50ad739a49226e97ff28d68be605e1fa36fe5'],2,10,12,874010,2,0.428571429,1,1,2122
156e682e3d4bb27338418602c1c3c530da6ff7bd,0,Damien Diederen,2021-10-06 06:41:29+00:00,['2dcc64d9411e7b24402222437215ab2fe1e59c2e'],1,1,2,874012,1,,,,2122
cb899167421d7a24f1e6c3f06aa4a621391df15f,0,maoling,2021-10-10 23:09:56+08:00,['156e682e3d4bb27338418602c1c3c530da6ff7bd'],55,77,132,874144,4,0,0.6,1,2122
9f355f5a57f35d3760f8e669696622135c457938,0,maoling,2021-10-17 15:07:58+08:00,['cb899167421d7a24f1e6c3f06aa4a621391df15f'],3,20,23,874167,2,1,1,1,2122
4f015139e73986c13d6ecfc8dd18a00e6f8a3485,0,maoling,2021-10-24 21:10:54+08:00,['9f355f5a57f35d3760f8e669696622135c457938'],1,6,7,874174,1,,,,2122
e5dd8a57cddb6e3958a53b8228f94b74da7ca7ce,0,maoling,2021-10-31 14:07:10+08:00,['4f015139e73986c13d6ecfc8dd18a00e6f8a3485'],2,2,4,874178,1,,,,2122
864b8a7c8044349b29b0e67952323a8cb2bc2dd4,0,maoling,2021-11-06 16:14:48+08:00,['e5dd8a57cddb6e3958a53b8228f94b74da7ca7ce'],1,1,2,874180,1,,,,2122
eb63dd9757e7234515e81799d82cc0af4a0ae7f9,0,maoling,2021-11-13 15:15:01+08:00,['864b8a7c8044349b29b0e67952323a8cb2bc2dd4'],2,79,81,874261,2,1,1,1,2123
f4f0bed00dd254e34aedfe408799f557d60fd0e7,0,maoling,2021-11-21 12:39:22+08:00,['eb63dd9757e7234515e81799d82cc0af4a0ae7f9'],1,1,2,874263,1,,,,2123
01f935cdebd582211e6d4eef9f81da4228412911,0,maoling,2021-11-27 14:50:35+08:00,['f4f0bed00dd254e34aedfe408799f557d60fd0e7'],1,1,2,874265,9,,,,2123
8d82be71dfce6b6752717ca0a68a77ec3c03032b,0,maoling,2021-12-05 10:54:20+08:00,['01f935cdebd582211e6d4eef9f81da4228412911'],466,434,900,875165,2,,,,2123
3b0603f526fda4715904bfe2d1bba8a79458f00c,0,maoling,2021-12-18 22:05:11+08:00,['8d82be71dfce6b6752717ca0a68a77ec3c03032b'],4,4,8,875173,2,,,,2123
04f3d183de5543bcde7ad2f8b99ca847677f847d,0,maoling,2021-12-26 14:47:08+08:00,['3b0603f526fda4715904bfe2d1bba8a79458f00c'],1,1,2,875175,1,,,,2123
be3c3954e6bd940baf4b8d21b4b6a87a71f76ee6,0,maoling,2022-01-04 11:26:27+08:00,['04f3d183de5543bcde7ad2f8b99ca847677f847d'],2,1,3,875178,1,,,,2123
a43b9ef0cb2147d6a27f9285f9db02de54a0174f,0,maoling,2022-01-08 15:42:31+08:00,['be3c3954e6bd940baf4b8d21b4b6a87a71f76ee6'],1,1,2,875180,1,,,,2123
f1da215e2ac008dc1a691f635278f9ceaa568ab9,0,Shoothzj,2022-01-08 17:02:43+08:00,['a43b9ef0cb2147d6a27f9285f9db02de54a0174f'],1,1,2,875182,1,,,,2123
1104deeaa589b01548bfa6c411e090e345f132f8,0,GitHub,2022-01-08 11:31:35+01:00,"['a43b9ef0cb2147d6a27f9285f9db02de54a0174f', 'f1da215e2ac008dc1a691f635278f9ceaa568ab9']",1,1,2,875184,1,,,,2123
7b75017bbb70c9f159b35f7399e29dc53bdc3d97,1,maoling,2022-01-22 15:05:07+08:00,['1104deeaa589b01548bfa6c411e090e345f132f8'],3,3,6,875190,2,,,,2123
957f8fc0afbeca638f13f6fb739e49a921da2b9d,0,Mate Szalay-Beko,2022-01-25 12:48:34+00:00,['7b75017bbb70c9f159b35f7399e29dc53bdc3d97'],16,30,46,875236,2,0.769230769,0.615384615,1,2123
85551f9be5b054fa4aee0636597b12bda2ecb2e8,0,Enrico Olivelli,2022-01-27 10:06:29+01:00,['957f8fc0afbeca638f13f6fb739e49a921da2b9d'],814,1381,2195,877431,35,1,0.204081633,0,2129
1cc1eb6a2be7323a5c326652d59a070473bb8779,0,Mate Szalay-Beko,2022-01-27 10:09:46+00:00,['85551f9be5b054fa4aee0636597b12bda2ecb2e8'],35,83,118,877549,4,0.321428571,0.75,0,2129
d45d5df963cc3f7641d6dec2920bb22cfe8d0a76,0,Andor Molnar,2022-01-27 15:34:36+01:00,['1cc1eb6a2be7323a5c326652d59a070473bb8779'],1,1,2,877551,9,,,,2129
b2c1b5af36a196ca2e9080750d212aa1a0550f7c,0,Mate Szalay-Beko,2022-01-28 08:27:11+00:00,['d45d5df963cc3f7641d6dec2920bb22cfe8d0a76'],8,352,360,877911,14,0.839506173,1,0.666666667,2131
1bdba023c19dd9616bf3cd27ce68c140a286f558,0,Mate Szalay-Beko,2022-01-31 16:16:43+00:00,['b2c1b5af36a196ca2e9080750d212aa1a0550f7c'],0,218,218,878129,3,,,,2132
04c7ad115e298387e4a75dfe14013f6c6aa68a6d,1,Enrico Olivelli,2022-02-01 11:39:04+01:00,['1bdba023c19dd9616bf3cd27ce68c140a286f558'],149,196,345,878474,14,,,,2135
d32ec677f8fd00a367b305e1ae8abf127700511c,1,Mate Szalay-Beko,2022-02-02 07:39:31+00:00,['04c7ad115e298387e4a75dfe14013f6c6aa68a6d'],847,808,1655,880129,25,1,1,0.885245902,2142
4b967902d64fea0b1b75c89df90eccee80a8c1b7,0,Enrico Olivelli,2022-02-03 07:55:00+00:00,['d32ec677f8fd00a367b305e1ae8abf127700511c'],1,1,2,880131,1,,,,2142
a88eed897187e2b5e008fca766fdebb216289917,0,Enrico Olivelli,2022-02-03 07:55:04+00:00,['4b967902d64fea0b1b75c89df90eccee80a8c1b7'],22,22,44,880175,21,,,,2142
ebcf18e52fa095773429348ce495d59c896f4a26,0,Enrico Olivelli,2022-02-04 08:00:53+01:00,['a88eed897187e2b5e008fca766fdebb216289917'],0,24,24,880199,1,,,,2142
0b0dfe521f374bb473aebc858bdde8fc4c491f7a,0,Mate Szalay-Beko,2022-02-11 13:53:30+00:00,['ebcf18e52fa095773429348ce495d59c896f4a26'],2,2,4,880203,1,,,,2142
428e6f92132e19390c81e19f67d5380451acdbe4,0,Mate Szalay-Beko,2022-02-14 07:50:43+00:00,['0b0dfe521f374bb473aebc858bdde8fc4c491f7a'],1,13,14,880217,2,,,,2142
48191b63dfaa4d6d71572608a31338e15f02f0fa,0,Mate Szalay-Beko,2022-02-15 11:29:09+00:00,['428e6f92132e19390c81e19f67d5380451acdbe4'],1,49,50,880267,2,1,1,1,2143
bce2bf42361163a2c026fb0d629edc22f2fb1c73,0,maoling,2022-02-17 17:31:54+08:00,['48191b63dfaa4d6d71572608a31338e15f02f0fa'],3,3,6,880273,2,,,,2143
3004c909b78b3056985c8e39925e14bde3baa430,0,Enrico Olivelli,2022-02-25 07:59:07+01:00,['bce2bf42361163a2c026fb0d629edc22f2fb1c73'],0,9,9,880282,1,,,,2143
609afd1281ace4d29aabfb48628aa9eead56c4bf,0,Mate Szalay-Beko,2022-02-28 15:31:28+00:00,['3004c909b78b3056985c8e39925e14bde3baa430'],0,122,122,880404,2,1,1,0.714285714,2145
a5b6c38edd74b263638817f7b65d057c91d5a888,0,Enrico Olivelli,2022-03-01 14:30:23+01:00,['609afd1281ace4d29aabfb48628aa9eead56c4bf'],66,372,438,880842,5,0.842465753,0.97260274,1,2146
640b6dd65fd302ada1ac46c9b8c32f17dadb0d32,0,Enrico Olivelli,2022-03-01 17:13:50+01:00,['a5b6c38edd74b263638817f7b65d057c91d5a888'],15,20,35,880877,3,1,1,1,2146
99cb20e82743ef73db7257a3f9a4c55bc8acf037,0,Mate Szalay-Beko,2022-03-04 13:56:43+00:00,['640b6dd65fd302ada1ac46c9b8c32f17dadb0d32'],11,160,171,881048,4,0.393442623,0.524590164,1,2147
aa1d22d92dc26a587f9d55562c34ed4751e1d1bc,0,maoling,2022-03-08 10:35:33+08:00,['99cb20e82743ef73db7257a3f9a4c55bc8acf037'],0,203,203,881251,2,,,,2148
09117f8ed850cc12eba0d6f0ed7615e7983039aa,0,maoling,2022-03-12 15:10:28+08:00,['aa1d22d92dc26a587f9d55562c34ed4751e1d1bc'],2,0,2,881253,1,,,,2148
7c864336d221d7f76f18f62ab84c3e98f0a77104,0,maoling,2022-03-21 13:59:16+08:00,['09117f8ed850cc12eba0d6f0ed7615e7983039aa'],2,1,3,881256,1,,,,2148
a160981e37d2907717284ec9f6eab5e17e8aecfa,0,maoling,2022-03-28 10:34:06+08:00,['7c864336d221d7f76f18f62ab84c3e98f0a77104'],1,1,2,881258,1,,,,2148
d7cb4e8b7b14ea94e7ea8cd2a8e43fa7e8668132,0,Mate Szalay-Beko,2022-03-29 09:52:54+00:00,['a160981e37d2907717284ec9f6eab5e17e8aecfa'],1,16,17,881275,1,0,0,1,2148
91e0520133b82acb87ab60962fce5eae992d87e8,0,Mohammad Arshad,2022-03-30 23:42:55+05:18,['d7cb4e8b7b14ea94e7ea8cd2a8e43fa7e8668132'],2,4,6,881281,1,,,,2148
78bbb123cfcbdd8da9d118f08b49d1d00c43f53d,0,Mohammad Arshad,2022-03-31 00:15:23+05:18,['91e0520133b82acb87ab60962fce5eae992d87e8'],1,1,2,881283,1,,,,2148
2173c92a2b054e2fa55fd69d0d9ea892b7cc7e66,0,Mate Szalay-Beko,2022-04-01 07:20:45+00:00,['78bbb123cfcbdd8da9d118f08b49d1d00c43f53d'],24,164,188,881471,2,,,,2149
5b12b0e4eb010dca9b46047f559c6847d7e0b5f7,0,maoling,2022-04-05 12:14:20+08:00,['2173c92a2b054e2fa55fd69d0d9ea892b7cc7e66'],1,21,22,881493,2,0.833333333,0.833333333,1,2149
54cb5c39a445c63967ec7c3a46724fe87908440b,0,Mohammad Arshad,2022-04-06 13:15:16+05:18,['5b12b0e4eb010dca9b46047f559c6847d7e0b5f7'],3,69,72,881565,2,0,1,0.833333333,2149
d5876e88d6bab3cc1cee04f996b9804ff21581cb,0,Mohammad Arshad,2022-04-08 21:56:55+05:18,['54cb5c39a445c63967ec7c3a46724fe87908440b'],8,8,16,881581,1,,,,2149
e5f84f46283d70b618ce00f2df51f4bfe31d9a44,0,Mohammad Arshad,2022-04-09 23:00:14+05:18,['d5876e88d6bab3cc1cee04f996b9804ff21581cb'],6,18,24,881605,2,0.875,0.875,1,2149
86690ff40cb5c9f5782f0971db16e8fd1c3528e6,0,Mohammad Arshad,2022-04-16 15:25:42+05:18,['e5f84f46283d70b618ce00f2df51f4bfe31d9a44'],13,92,105,881710,4,0.04,1,0.92,2149
eefae2b7127d055f6eb9b4565790cd57d6d39957,0,Mate Szalay-Beko,2022-05-04 14:48:38+00:00,['86690ff40cb5c9f5782f0971db16e8fd1c3528e6'],19,120,139,881849,8,0.210526316,0.394736842,0.947368421,2149
24073884e114c6d6a14d559dd74d219bc259792b,0,Enrico Olivelli,2022-05-05 08:25:19+02:00,['eefae2b7127d055f6eb9b4565790cd57d6d39957'],1,1,2,881851,1,,,,2149
aab3ff65c4daecbbf8fc3fc5369a2e456603fbb0,0,Mohammad Arshad,2022-05-06 00:09:05+05:18,['24073884e114c6d6a14d559dd74d219bc259792b'],1,1,2,881853,9,,,,2149
5b6823aea4389aa04b0a51f0c4d376002a77af9a,0,Mohammad Arshad,2022-05-06 23:01:16+05:18,['aab3ff65c4daecbbf8fc3fc5369a2e456603fbb0'],230,0,230,882083,4,,,,2149
724864487457d6f2eb7c331ef338936e1375072b,0,Mate Szalay-Beko,2022-05-06 17:52:40+00:00,['5b6823aea4389aa04b0a51f0c4d376002a77af9a'],10,274,284,882367,5,0.26056338,0.450704225,1,2150
6f0052d841b268a576f49c08425b49417cb2527f,0,maoling,2022-05-16 12:07:38+08:00,['724864487457d6f2eb7c331ef338936e1375072b'],0,14,14,882381,2,1,1,1,2150
f770467d3b1a3b088208601b14dfc3f375a4dcc0,0,Mate Szalay-Beko,2022-05-17 13:44:12+02:00,['6f0052d841b268a576f49c08425b49417cb2527f'],6,5,11,882392,1,,,,2150
4b1b33e72ca819258b8675948b9a80dd6290edb0,0,maoling,2022-05-24 15:31:52+08:00,['f770467d3b1a3b088208601b14dfc3f375a4dcc0'],26,34,60,882452,1,1,0,0,2150
7a515fee0124eea389c599995915927e49cf4c57,0,Mate Szalay-Beko,2022-06-01 17:33:57+02:00,['4b1b33e72ca819258b8675948b9a80dd6290edb0'],1,9,10,882462,1,0,0,1,2150
02e481cdbf1f0393d60b9f359f69b1fbe8fa84ce,0,maoling,2022-06-17 19:25:12+08:00,['7a515fee0124eea389c599995915927e49cf4c57'],2,0,2,882464,1,,,,2150
3fd25d4ebc854328ccc3f8d1c42f6e4c63a84fac,0,maoling,2022-06-17 19:30:01+08:00,['02e481cdbf1f0393d60b9f359f69b1fbe8fa84ce'],0,3,3,882467,1,0,1,1,2150
eb725a0d8ab4430c6ea96d1b4fedc41739aeb62b,0,maoling,2022-06-20 12:51:17+08:00,['3fd25d4ebc854328ccc3f8d1c42f6e4c63a84fac'],3,0,3,882470,1,1,0,0,2150
794790c9f6cbacf158493867f3058a6de748b54e,0,Mate Szalay-Beko,2022-06-24 15:30:51+02:00,['eb725a0d8ab4430c6ea96d1b4fedc41739aeb62b'],31,82,113,882583,3,0.444444444,1,0.805555556,2150
b34e1716e8fa430690252288f2e15c38fe65f325,0,Mate Szalay-Beko,2022-06-24 15:41:41+02:00,['794790c9f6cbacf158493867f3058a6de748b54e'],27,38,65,882648,2,0.833333333,1,1,2150
de7c5869d372e46af43979134d0e30b49d2319b1,0,Mate Szalay-Beko,2022-06-27 08:19:39+02:00,['b34e1716e8fa430690252288f2e15c38fe65f325'],97,155,252,882900,13,0.571428571,1,1,2151
a7e4dea7abccff018d123d54dd5d3ccc1544484e,0,Mate Szalay-Beko,2022-07-12 13:03:07+02:00,['de7c5869d372e46af43979134d0e30b49d2319b1'],166,156,322,883222,18,1,1,0.5,2151
05b215994f5e145c2758c4089828b57ba471b329,0,Mate Szalay-Beko,2022-07-13 13:08:53+02:00,['a7e4dea7abccff018d123d54dd5d3ccc1544484e'],0,238,238,883460,4,0.584415584,0.584415584,0.376623377,2154
2cd0c23454071faf0a16c58edb2414591ae5c5c3,0,Mate Szalay-Beko,2022-07-26 09:39:20+02:00,['05b215994f5e145c2758c4089828b57ba471b329'],8,36,44,883504,2,1,1,1,2154
